MSOA11CD,MSOA,All Ages,0-9,10-17,18-29,30-39,40-49,50-59,60-69,70-79,80-89,90+,Children,Adults,60+,%Children,%Adults,%60+
E02002483,Hartlepool 001,10261,1310,980,1437,1473,1349,1378,1025,825,436,48,2290,7971,2334,22.32,77.68,22.75
E02002484,Hartlepool 002,10449,1348,1044,1572,1352,1145,1465,1209,811,396,107,2392,8057,2523,22.89,77.11,24.15
E02002485,Hartlepool 003,8185,1173,820,1241,1060,895,1123,828,697,319,29,1993,6192,1873,24.35,75.65,22.88
E02002487,Hartlepool 005,5277,586,389,1106,819,683,725,507,295,150,17,975,4302,969,18.48,81.52,18.36
E02002488,Hartlepool 006,5848,548,590,685,624,735,959,818,551,278,60,1138,4710,1707,19.46,80.54,29.19
E02002489,Hartlepool 007,7730,897,826,1254,1082,879,990,849,523,342,88,1723,6007,1802,22.29,77.71,23.31
E02002490,Hartlepool 008,6214,755,567,999,834,766,945,728,414,180,26,1322,4892,1348,21.27,78.73,21.69
E02002491,Hartlepool 009,6454,847,688,821,841,645,898,724,530,388,72,1535,4919,1714,23.78,76.22,26.56
E02002492,Hartlepool 010,6887,843,646,875,831,765,997,860,608,377,85,1489,5398,1930,21.62,78.38,28.02
E02002493,Hartlepool 011,6702,699,530,867,727,721,1031,952,723,381,71,1229,5473,2127,18.34,81.66,31.74
E02002494,Hartlepool 012,7750,1196,834,1192,1028,787,1024,815,500,288,86,2030,5720,1689,26.19,73.81,21.79
E02006909,Hartlepool 014,11906,950,988,1307,1016,1464,2065,1786,1543,646,141,1938,9968,4116,16.28,83.72,34.57
E02002496,Middlesbrough 001,13252,1610,1166,4912,2124,1312,855,699,359,185,30,2776,10476,1273,20.95,79.05,9.61
E02002497,Middlesbrough 002,5944,974,549,1091,826,664,728,588,351,157,16,1523,4421,1112,25.62,74.38,18.71
E02002498,Middlesbrough 003,9664,1402,963,2716,1638,1035,827,578,343,135,27,2365,7299,1083,24.47,75.53,11.21
E02002499,Middlesbrough 004,7406,1303,847,1289,943,702,898,743,382,241,58,2150,5256,1424,29.03,70.97,19.23
E02002500,Middlesbrough 005,5919,876,523,1099,865,694,711,602,346,163,40,1399,4520,1151,23.64,76.36,19.45
E02002501,Middlesbrough 006,5562,877,522,917,744,665,777,560,328,144,28,1399,4163,1060,25.15,74.85,19.06
E02002502,Middlesbrough 007,9221,1371,922,1490,1001,964,1345,1087,655,335,51,2293,6928,2128,24.87,75.13,23.08
E02002503,Middlesbrough 008,6733,1100,769,1099,930,779,824,653,350,195,34,1869,4864,1232,27.76,72.24,18.3
E02002504,Middlesbrough 009,9788,1315,1098,1653,1380,1156,1267,935,627,303,54,2413,7375,1919,24.65,75.35,19.61
E02002505,Middlesbrough 010,6104,1117,673,1036,775,607,763,620,293,188,32,1790,4314,1133,29.33,70.67,18.56
E02002506,Middlesbrough 011,5686,922,614,983,714,585,727,493,385,235,28,1536,4150,1141,27.01,72.99,20.07
E02002507,Middlesbrough 012,5992,690,520,922,732,715,885,600,601,288,39,1210,4782,1528,20.19,79.81,25.5
E02002508,Middlesbrough 013,5067,562,468,705,466,556,693,646,547,367,57,1030,4037,1617,20.33,79.67,31.91
E02002509,Middlesbrough 014,5395,803,511,802,653,448,753,719,378,290,38,1314,4081,1425,24.36,75.64,26.41
E02002510,Middlesbrough 015,5928,599,417,804,657,613,777,847,820,335,59,1016,4912,2061,17.14,82.86,34.77
E02002512,Middlesbrough 017,5298,514,419,638,509,617,866,704,648,336,47,933,4365,1735,17.61,82.39,32.75
E02002513,Middlesbrough 018,9261,1234,823,1288,1082,1079,1158,1248,834,423,92,2057,7204,2597,22.21,77.79,28.04
E02002514,Middlesbrough 019,8528,918,767,1105,928,1009,1406,1139,745,426,85,1685,6843,2395,19.76,80.24,28.08
E02006811,Middlesbrough 020,10232,1173,863,1236,1106,1235,1429,1299,1194,587,110,2036,8196,3190,19.9,80.1,31.18
E02002515,Redcar and Cleveland 001,6903,755,558,1133,925,813,1051,730,530,308,100,1313,5590,1668,19.02,80.98,24.16
E02002516,Redcar and Cleveland 002,5853,788,574,827,791,548,860,650,503,263,49,1362,4491,1465,23.27,76.73,25.03
E02002517,Redcar and Cleveland 003,5344,674,513,777,628,587,787,585,485,272,36,1187,4157,1378,22.21,77.79,25.79
E02002518,Redcar and Cleveland 004,10837,1192,891,1361,1212,1252,1811,1439,1065,511,103,2083,8754,3118,19.22,80.78,28.77
E02002519,Redcar and Cleveland 005,7455,909,716,945,891,803,941,937,810,420,83,1625,5830,2250,21.8,78.2,30.18
E02002520,Redcar and Cleveland 006,12946,1210,1105,1480,1280,1554,1958,1694,1744,821,100,2315,10631,4359,17.88,82.12,33.67
E02002521,Redcar and Cleveland 007,6112,446,481,622,611,720,961,867,843,433,128,927,5185,2271,15.17,84.83,37.16
E02002523,Redcar and Cleveland 009,6623,1276,785,1162,995,659,724,560,323,117,22,2061,4562,1022,31.12,68.88,15.43
E02002524,Redcar and Cleveland 010,5506,618,521,726,623,656,775,674,649,223,41,1139,4367,1587,20.69,79.31,28.82
E02002525,Redcar and Cleveland 011,8212,821,638,1093,954,868,1329,1119,854,454,82,1459,6753,2509,17.77,82.23,30.55
E02002526,Redcar and Cleveland 012,7735,879,739,1005,887,989,1143,1043,743,258,49,1618,6117,2093,20.92,79.08,27.06
E02002527,Redcar and Cleveland 013,5078,669,467,802,629,527,709,573,484,159,59,1136,3942,1275,22.37,77.63,25.11
E02002529,Redcar and Cleveland 015,5879,610,531,800,633,667,953,777,617,249,42,1141,4738,1685,19.41,80.59,28.66
E02002530,Redcar and Cleveland 016,6332,631,507,776,643,728,992,866,816,338,35,1138,5194,2055,17.97,82.03,32.45
E02002532,Redcar and Cleveland 018,6655,691,546,1040,728,778,970,810,655,342,95,1237,5418,1902,18.59,81.41,28.58
E02002533,Redcar and Cleveland 019,6239,685,568,662,660,691,876,922,742,362,71,1253,4986,2097,20.08,79.92,33.61
E02002534,Redcar and Cleveland 020,5693,431,436,534,524,622,824,863,967,407,85,867,4826,2322,15.23,84.77,40.79
E02006812,Redcar and Cleveland 021,7548,829,705,953,861,776,1096,990,824,444,70,1534,6014,2328,20.32,79.68,30.84
E02006910,Redcar and Cleveland 022,10200,1287,926,1390,1320,1041,1549,1211,929,476,71,2213,7987,2687,21.7,78.3,26.34
E02002535,Stockton-on-Tees 001,9336,862,789,1113,1018,1177,1636,1385,870,416,70,1651,7685,2741,17.68,82.32,29.36
E02002536,Stockton-on-Tees 002,9771,1194,962,1198,1350,984,1416,1132,891,540,104,2156,7615,2667,22.07,77.93,27.3
E02002537,Stockton-on-Tees 003,8641,1331,981,1129,1234,903,1251,836,545,386,45,2312,6329,1812,26.76,73.24,20.97
E02002538,Stockton-on-Tees 004,5780,752,585,718,711,703,814,697,523,236,41,1337,4443,1497,23.13,76.87,25.9
E02002539,Stockton-on-Tees 005,9414,946,848,904,938,1239,1639,1338,1070,436,56,1794,7620,2900,19.06,80.94,30.81
E02002540,Stockton-on-Tees 006,6035,579,441,530,607,733,856,948,845,425,71,1020,5015,2289,16.9,83.1,37.93
E02002541,Stockton-on-Tees 007,6146,612,561,808,854,734,909,753,573,298,44,1173,4973,1668,19.09,80.91,27.14
E02002542,Stockton-on-Tees 008,8242,1272,936,1188,1078,908,1131,845,561,262,61,2208,6034,1729,26.79,73.21,20.98
E02002543,Stockton-on-Tees 009,9065,1586,973,1295,1372,953,1186,845,498,304,53,2559,6506,1700,28.23,71.77,18.75
E02002544,Stockton-on-Tees 010,8694,998,740,1548,1483,1094,1113,843,539,296,40,1738,6956,1718,19.99,80.01,19.76
E02002545,Stockton-on-Tees 011,5191,488,376,588,568,582,772,788,660,318,51,864,4327,1817,16.64,83.36,35.0
E02002546,Stockton-on-Tees 012,7503,1066,829,1197,1005,884,1058,713,454,244,53,1895,5608,1464,25.26,74.74,19.51
E02002547,Stockton-on-Tees 013,6193,555,498,622,596,661,951,928,855,449,78,1053,5140,2310,17.0,83.0,37.3
E02002548,Stockton-on-Tees 014,13843,1938,1245,2953,2471,1615,1591,1074,615,269,72,3183,10660,2030,22.99,77.01,14.66
E02002549,Stockton-on-Tees 015,7396,688,600,694,744,869,1092,1043,1036,526,104,1288,6108,2709,17.41,82.59,36.63
E02002550,Stockton-on-Tees 016,6184,701,531,735,780,746,989,740,570,320,72,1232,4952,1702,19.92,80.08,27.52
E02002551,Stockton-on-Tees 017,7153,756,597,2219,1052,728,695,541,318,185,62,1353,5800,1106,18.92,81.08,15.46
E02002552,Stockton-on-Tees 018,7246,1134,759,957,1129,798,931,814,457,219,48,1893,5353,1538,26.12,73.88,21.23
E02002553,Stockton-on-Tees 019,5949,829,581,751,833,674,726,677,527,303,48,1410,4539,1555,23.7,76.3,26.14
E02002554,Stockton-on-Tees 020,5280,702,521,667,641,531,693,674,550,266,35,1223,4057,1525,23.16,76.84,28.88
E02002555,Stockton-on-Tees 021,10131,1133,1103,996,1164,1412,1404,1245,1054,519,101,2236,7895,2919,22.07,77.93,28.81
E02002556,Stockton-on-Tees 022,6979,733,705,829,826,870,1181,1047,580,184,24,1438,5541,1835,20.6,79.4,26.29
E02002557,Stockton-on-Tees 023,16385,2525,2248,2086,2423,2941,2348,1056,520,176,62,4773,11612,1814,29.13,70.87,11.07
E02002558,Stockton-on-Tees 024,10791,1126,933,1100,1362,1386,1536,1530,1169,553,96,2059,8732,3348,19.08,80.92,31.03
E02002559,Darlington 001,9157,1001,940,968,1011,1343,1440,1155,928,324,47,1941,7216,2454,21.2,78.8,26.8
E02002560,Darlington 002,6087,680,672,730,742,826,927,669,565,248,28,1352,4735,1510,22.21,77.79,24.81
E02002561,Darlington 003,5305,471,467,591,535,629,827,893,597,250,45,938,4367,1785,17.68,82.32,33.65
E02002562,Darlington 004,5840,644,469,932,740,721,906,633,476,268,51,1113,4727,1428,19.06,80.94,24.45
E02002563,Darlington 005,5446,539,472,633,567,623,765,799,573,362,113,1011,4435,1847,18.56,81.44,33.91
E02002564,Darlington 006,9729,1304,1000,1186,1200,1296,1396,1023,827,420,77,2304,7425,2347,23.68,76.32,24.12
E02002565,Darlington 007,5074,591,361,807,774,650,740,581,366,181,23,952,4122,1151,18.76,81.24,22.68
E02002566,Darlington 008,6942,760,569,1310,1190,976,931,572,392,208,34,1329,5613,1206,19.14,80.86,17.37
E02002567,Darlington 009,8725,1340,847,1368,1188,947,1031,881,712,358,53,2187,6538,2004,25.07,74.93,22.97
E02002568,Darlington 010,6000,520,621,547,575,867,958,764,650,387,111,1141,4859,1912,19.02,80.98,31.87
E02002569,Darlington 011,9014,769,808,640,728,1049,1356,1298,1295,868,203,1577,7437,3664,17.5,82.5,40.65
E02002570,Darlington 012,7771,948,729,1185,1021,947,1004,864,617,353,103,1677,6094,1937,21.58,78.42,24.93
E02002571,Darlington 013,6507,982,649,863,973,779,858,614,480,269,40,1631,4876,1403,25.07,74.93,21.56
E02002572,Darlington 014,6413,908,703,994,974,769,882,577,421,165,20,1611,4802,1183,25.12,74.88,18.45
E02002573,Darlington 015,8793,925,840,894,961,1157,1308,1142,1012,438,116,1765,7028,2708,20.07,79.93,30.8
E02002574,Halton 001,8641,1055,753,1029,1148,1197,1269,925,845,370,50,1808,6833,2190,20.92,79.08,25.34
E02002575,Halton 002,9752,977,1000,1281,1104,1434,1616,1272,736,289,43,1977,7775,2340,20.27,79.73,24.0
E02002576,Halton 003,7341,811,633,986,948,888,1021,964,666,362,62,1444,5897,2054,19.67,80.33,27.98
E02002577,Halton 004,7631,1074,762,1090,1014,894,971,841,594,316,75,1836,5795,1826,24.06,75.94,23.93
E02002578,Halton 005,8401,1053,890,1101,1104,1031,1243,959,623,358,39,1943,6458,1979,23.13,76.87,23.56
E02002579,Halton 006,7938,1122,814,1119,1065,885,1130,873,598,287,45,1936,6002,1803,24.39,75.61,22.71
E02002580,Halton 007,8046,1147,734,1460,1286,934,1006,760,448,232,39,1881,6165,1479,23.38,76.62,18.38
E02002581,Halton 008,7322,819,549,964,875,810,1021,1026,828,375,55,1368,5954,2284,18.68,81.32,31.19
E02002582,Halton 009,8786,985,915,964,1003,1323,1559,1126,621,232,58,1900,6886,2037,21.63,78.37,23.18
E02002583,Halton 010,7599,1074,859,1077,1053,942,886,846,645,184,33,1933,5666,1708,25.44,74.56,22.48
E02002584,Halton 011,7403,917,757,1014,901,941,1018,832,633,322,68,1674,5729,1855,22.61,77.39,25.06
E02002585,Halton 012,10580,1248,851,1676,1598,1374,1468,1162,788,349,66,2099,8481,2365,19.84,80.16,22.35
E02002586,Halton 013,10026,1414,1197,1573,1246,1242,1267,965,758,315,49,2611,7415,2087,26.04,73.96,20.82
E02002587,Halton 014,6532,911,741,854,818,845,768,923,531,122,19,1652,4880,1595,25.29,74.71,24.42
E02002588,Halton 015,7252,931,754,977,879,891,847,1038,707,192,36,1685,5567,1973,23.23,76.77,27.21
E02002589,Halton 016,6160,525,498,607,607,788,777,1120,893,301,44,1023,5137,2358,16.61,83.39,38.28
E02002590,Warrington 001,7310,612,594,1046,809,955,1270,835,740,382,67,1206,6104,2024,16.5,83.5,27.69
E02002591,Warrington 002,6451,648,621,616,616,803,1076,834,749,406,82,1269,5182,2071,19.67,80.33,32.1
E02002592,Warrington 003,6344,613,551,737,638,839,1024,660,814,405,63,1164,5180,1942,18.35,81.65,30.61
E02002593,Warrington 004,4959,590,367,551,610,576,704,785,561,188,27,957,4002,1561,19.3,80.7,31.48
E02002594,Warrington 005,5302,611,477,721,713,685,841,715,409,111,19,1088,4214,1254,20.52,79.48,23.65
E02002595,Warrington 006,8322,1366,870,1291,1356,931,1167,685,418,196,42,2236,6086,1341,26.87,73.13,16.11
E02002596,Warrington 007,8013,751,669,947,896,941,1162,1273,1000,327,47,1420,6593,2647,17.72,82.28,33.03
E02002597,Warrington 008,9280,1350,1171,1309,1376,1102,1147,928,642,229,26,2521,6759,1825,27.17,72.83,19.67
E02002598,Warrington 009,10272,1486,1106,1509,1593,1641,1482,840,428,157,30,2592,7680,1455,25.23,74.77,14.16
E02002599,Warrington 010,11165,1361,1158,1333,1380,1655,1860,1273,789,287,69,2519,8646,2418,22.56,77.44,21.66
E02002600,Warrington 011,8949,1038,788,1389,1344,1100,1321,898,653,342,76,1826,7123,1969,20.4,79.6,22.0
E02002601,Warrington 012,8754,1065,734,977,1183,1124,1335,917,872,489,58,1799,6955,2336,20.55,79.45,26.68
E02002602,Warrington 013,8339,1335,833,1546,1416,1151,928,606,383,117,24,2168,6171,1130,26.0,74.0,13.55
E02002603,Warrington 014,6912,644,617,748,638,886,1140,972,887,333,47,1261,5651,2239,18.24,81.76,32.39
E02002604,Warrington 015,7377,720,639,797,700,993,1175,932,964,388,69,1359,6018,2353,18.42,81.58,31.9
E02002605,Warrington 016,9035,1047,922,1191,1143,1292,1278,1043,771,320,28,1969,7066,2162,21.79,78.21,23.93
E02002606,Warrington 017,11981,1475,934,2295,2380,1624,1380,858,603,328,104,2409,9572,1893,20.11,79.89,15.8
E02002607,Warrington 018,11621,1298,874,2057,2097,1504,1352,997,930,434,78,2172,9449,2439,18.69,81.31,20.99
E02002608,Warrington 019,8236,716,647,844,824,1005,1256,962,1182,692,108,1363,6873,2944,16.55,83.45,35.75
E02002609,Warrington 020,9700,1486,929,1702,1635,1210,1161,745,533,242,57,2415,7285,1577,24.9,75.1,16.26
E02002610,Warrington 021,12709,1532,1446,1114,1237,1938,1986,1394,1351,602,109,2978,9731,3456,23.43,76.57,27.19
E02002611,Warrington 022,7782,841,761,715,813,1108,1300,873,782,472,117,1602,6180,2244,20.59,79.41,28.84
E02002612,Warrington 023,9130,1023,877,939,909,1300,1430,1075,891,526,160,1900,7230,2652,20.81,79.19,29.05
E02002613,Warrington 024,6455,585,605,649,630,938,1267,792,639,286,64,1190,5265,1781,18.44,81.56,27.59
E02002614,Warrington 025,5616,423,585,449,326,736,1099,878,736,331,53,1008,4608,1998,17.95,82.05,35.58
E02002615,Blackburn with Darwen 001,10277,1677,1113,1440,1453,1182,1217,855,808,459,73,2790,7487,2195,27.15,72.85,21.36
E02002616,Blackburn with Darwen 002,8891,1523,1122,1203,1317,1089,941,787,569,274,66,2645,6246,1696,29.75,70.25,19.08
E02002617,Blackburn with Darwen 003,9261,1609,1313,1553,1426,1270,864,664,349,189,24,2922,6339,1226,31.55,68.45,13.24
E02002618,Blackburn with Darwen 004,7490,1181,1080,1308,1180,1033,682,576,250,162,38,2261,5229,1026,30.19,69.81,13.7
E02002619,Blackburn with Darwen 005,8997,1454,1107,1548,1457,1120,938,716,400,194,63,2561,6436,1373,28.47,71.53,15.26
E02002620,Blackburn with Darwen 006,8904,1234,1017,1634,1386,1312,948,776,388,184,25,2251,6653,1373,25.28,74.72,15.42
E02002621,Blackburn with Darwen 007,8614,1400,1283,1535,1303,1182,809,654,316,118,14,2683,5931,1102,31.15,68.85,12.79
E02002622,Blackburn with Darwen 008,10714,1926,1499,1741,1609,1208,1120,855,514,183,59,3425,7289,1611,31.97,68.03,15.04
E02002623,Blackburn with Darwen 009,10463,1646,1082,1733,1611,1311,1262,861,611,293,53,2728,7735,1818,26.07,73.93,17.38
E02002624,Blackburn with Darwen 010,8220,789,687,1059,798,944,1271,1108,951,524,89,1476,6744,2672,17.96,82.04,32.51
E02002625,Blackburn with Darwen 011,9735,1439,1176,1514,1328,1261,1334,871,561,223,28,2615,7120,1683,26.86,73.14,17.29
E02002626,Blackburn with Darwen 012,7121,889,769,981,784,800,1020,813,671,332,62,1658,5463,1878,23.28,76.72,26.37
E02002627,Blackburn with Darwen 013,7687,963,918,1055,984,1194,1231,669,464,188,21,1881,5806,1342,24.47,75.53,17.46
E02002628,Blackburn with Darwen 014,6676,822,573,916,908,763,1011,759,618,257,49,1395,5281,1683,20.9,79.1,25.21
E02002629,Blackburn with Darwen 015,5712,805,580,846,802,671,793,613,406,184,12,1385,4327,1215,24.25,75.75,21.27
E02002630,Blackburn with Darwen 016,6353,850,597,967,859,772,934,648,448,237,41,1447,4906,1374,22.78,77.22,21.63
E02002631,Blackburn with Darwen 017,8408,822,706,1135,1032,1059,1382,1023,890,320,39,1528,6880,2272,18.17,81.83,27.02
E02002632,Blackburn with Darwen 018,6173,584,507,605,570,802,1241,924,695,215,30,1091,5082,1864,17.67,82.33,30.2
E02002633,Blackpool 001,7711,741,638,822,730,853,1135,966,1101,592,133,1379,6332,2792,17.88,82.12,36.21
E02002634,Blackpool 002,7954,777,598,977,789,946,1203,1002,1034,523,105,1375,6579,2664,17.29,82.71,33.49
E02002635,Blackpool 003,7943,747,638,981,735,842,1237,1039,1041,540,143,1385,6558,2763,17.44,82.56,34.79
E02002636,Blackpool 004,8289,1085,738,1131,972,974,1215,999,800,322,53,1823,6466,2174,21.99,78.01,26.23
E02002637,Blackpool 005,6046,778,498,766,700,695,967,647,597,342,56,1276,4770,1642,21.1,78.9,27.16
E02002638,Blackpool 006,5998,530,535,827,727,847,1042,769,463,211,47,1065,4933,1490,17.76,82.24,24.84
E02002639,Blackpool 007,6110,919,734,955,718,806,795,604,425,128,26,1653,4457,1183,27.05,72.95,19.36
E02002640,Blackpool 008,6877,1231,639,1063,886,785,993,697,386,161,36,1870,5007,1280,27.19,72.81,18.61
E02002641,Blackpool 009,8088,922,722,1318,1012,995,1226,846,603,378,66,1644,6444,1893,20.33,79.67,23.41
E02002642,Blackpool 010,7119,776,610,1158,952,922,1151,779,492,219,60,1386,5733,1550,19.47,80.53,21.77
E02002643,Blackpool 011,7586,1135,820,1189,1034,862,1086,731,490,194,45,1955,5631,1460,25.77,74.23,19.25
E02002644,Blackpool 012,7664,909,680,1114,898,893,1137,873,732,358,70,1589,6075,2033,20.73,79.27,26.53
E02002645,Blackpool 013,6047,610,586,911,755,869,968,775,429,113,31,1196,4851,1348,19.78,80.22,22.29
E02002646,Blackpool 014,6804,772,656,881,732,779,1000,856,740,339,49,1428,5376,1984,20.99,79.01,29.16
E02002647,Blackpool 015,7937,1138,726,1209,1010,944,1079,861,651,284,35,1864,6073,1831,23.48,76.52,23.07
E02002648,Blackpool 016,7180,1077,652,1075,878,764,979,811,629,259,56,1729,5451,1755,24.08,75.92,24.44
E02002649,Blackpool 017,8133,888,774,1091,906,961,1282,909,805,406,111,1662,6471,2231,20.44,79.56,27.43
E02002650,Blackpool 018,8083,875,575,1061,800,848,1246,1073,1028,484,93,1450,6633,2678,17.94,82.06,33.13
E02002651,Blackpool 019,7877,811,675,960,831,874,1201,942,922,524,137,1486,6391,2525,18.87,81.13,32.06
E02002652,Kingston upon Hull 001,14948,2683,1554,2831,2753,1904,1630,999,435,140,19,4237,10711,1593,28.34,71.66,10.66
E02002653,Kingston upon Hull 002,8007,1232,967,1351,1049,881,996,688,554,254,35,2199,5808,1531,27.46,72.54,19.12
E02002654,Kingston upon Hull 003,8097,1665,1116,1330,1158,826,864,567,333,201,37,2781,5316,1138,34.35,65.65,14.05
E02002655,Kingston upon Hull 004,8710,1351,1026,1420,1210,1007,1118,730,610,212,26,2377,6333,1578,27.29,72.71,18.12
E02002656,Kingston upon Hull 005,4953,359,320,571,476,529,751,729,739,425,54,679,4274,1947,13.71,86.29,39.31
E02002657,Kingston upon Hull 006,7176,886,561,938,919,814,922,986,816,310,24,1447,5729,2136,20.16,79.84,29.77
E02002658,Kingston upon Hull 007,6356,623,438,929,741,744,969,916,613,318,65,1061,5295,1912,16.69,83.31,30.08
E02002659,Kingston upon Hull 008,10864,1797,1220,1861,1496,1167,1318,987,593,373,52,3017,7847,2005,27.77,72.23,18.46
E02002660,Kingston upon Hull 009,6709,913,616,1040,843,702,888,831,577,251,48,1529,5180,1707,22.79,77.21,25.44
E02002661,Kingston upon Hull 010,8230,1197,832,1216,1029,878,1011,908,616,429,114,2029,6201,2067,24.65,75.35,25.12
E02002662,Kingston upon Hull 011,6815,775,583,957,770,691,996,864,687,428,64,1358,5457,2043,19.93,80.07,29.98
E02002663,Kingston upon Hull 012,6966,499,419,3314,680,516,561,513,334,115,15,918,6048,977,13.18,86.82,14.03
E02002664,Kingston upon Hull 013,7019,731,699,937,765,865,1121,865,724,283,29,1430,5589,1901,20.37,79.63,27.08
E02002665,Kingston upon Hull 014,8008,1005,761,1161,959,1032,1091,917,692,295,95,1766,6242,1999,22.05,77.95,24.96
E02002666,Kingston upon Hull 015,9022,738,477,3968,1257,841,724,494,304,170,49,1215,7807,1017,13.47,86.53,11.27
E02002667,Kingston upon Hull 016,7099,877,512,1186,1135,897,964,767,511,207,43,1389,5710,1528,19.57,80.43,21.52
E02002668,Kingston upon Hull 017,8424,1418,871,1214,1192,830,1043,840,638,307,71,2289,6135,1856,27.17,72.83,22.03
E02002669,Kingston upon Hull 018,8116,751,543,2440,1219,1060,1005,612,327,139,20,1294,6822,1098,15.94,84.06,13.53
E02002670,Kingston upon Hull 019,7800,935,737,1098,1019,881,1168,815,673,395,79,1672,6128,1962,21.44,78.56,25.15
E02002671,Kingston upon Hull 020,8819,1057,759,1488,1440,1134,1244,863,523,259,52,1816,7003,1697,20.59,79.41,19.24
E02002672,Kingston upon Hull 021,7365,1404,885,1281,1010,664,816,630,399,232,44,2289,5076,1305,31.08,68.92,17.72
E02002673,Kingston upon Hull 022,7397,899,610,1331,1072,910,1007,736,550,241,41,1509,5888,1568,20.4,79.6,21.2
E02002674,Kingston upon Hull 023,6469,801,442,1144,918,710,938,692,549,247,28,1243,5226,1516,19.21,80.79,23.43
E02002675,Kingston upon Hull 024,9207,1167,851,1835,1638,1289,1033,769,425,165,35,2018,7189,1394,21.92,78.08,15.14
E02002676,Kingston upon Hull 025,7320,815,539,1519,1276,925,928,624,445,214,35,1354,5966,1318,18.5,81.5,18.01
E02002677,Kingston upon Hull 026,8353,868,694,1572,1321,1174,1127,790,529,236,42,1562,6791,1597,18.7,81.3,19.12
E02002678,Kingston upon Hull 027,8029,1118,668,1541,1204,983,1118,720,445,209,23,1786,6243,1397,22.24,77.76,17.4
E02002679,Kingston upon Hull 028,7438,921,612,982,927,814,1068,982,690,387,55,1533,5905,2114,20.61,79.39,28.42
E02002680,Kingston upon Hull 029,9792,1010,458,2457,1935,1388,1006,717,505,263,53,1468,8324,1538,14.99,85.01,15.71
E02002681,Kingston upon Hull 030,8968,1278,870,1781,1528,1105,1083,676,417,184,46,2148,6820,1323,23.95,76.05,14.75
E02002682,Kingston upon Hull 031,9473,1449,862,1550,1478,1082,1205,984,595,228,40,2311,7162,1847,24.4,75.6,19.5
E02006813,Kingston upon Hull 033,7829,917,729,1127,945,819,1069,925,729,477,92,1646,6183,2223,21.02,78.98,28.39
E02002684,East Riding of Yorkshire 001,9944,774,631,719,727,893,1383,1789,1996,886,146,1405,8539,4817,14.13,85.87,48.44
E02002685,East Riding of Yorkshire 002,7851,680,493,727,557,651,1153,1380,1484,634,92,1173,6678,3590,14.94,85.06,45.73
E02002686,East Riding of Yorkshire 003,8145,1142,817,971,862,848,1028,999,931,448,99,1959,6186,2477,24.05,75.95,30.41
E02002687,East Riding of Yorkshire 004,5979,596,503,663,577,619,912,909,784,344,72,1099,4880,2109,18.38,81.62,35.27
E02002688,East Riding of Yorkshire 005,5533,482,492,653,552,659,944,809,611,247,84,974,4559,1751,17.6,82.4,31.65
E02002689,East Riding of Yorkshire 006,5668,447,426,494,417,636,971,1009,810,386,72,873,4795,2277,15.4,84.6,40.17
E02002691,East Riding of Yorkshire 008,8190,822,687,756,720,943,1255,1251,1166,499,91,1509,6681,3007,18.42,81.58,36.72
E02002692,East Riding of Yorkshire 009,9079,855,761,880,933,1263,1490,1303,1090,396,108,1616,7463,2897,17.8,82.2,31.91
E02002693,East Riding of Yorkshire 010,7156,632,532,666,574,843,1271,1167,1040,372,59,1164,5992,2638,16.27,83.73,36.86
E02002694,East Riding of Yorkshire 011,12124,1132,1153,1357,1117,1546,1925,1585,1479,694,136,2285,9839,3894,18.85,81.15,32.12
E02002695,East Riding of Yorkshire 012,8305,689,633,799,604,906,1197,1366,1367,628,116,1322,6983,3477,15.92,84.08,41.87
E02002696,East Riding of Yorkshire 013,5907,490,564,582,538,740,1019,897,703,312,62,1054,4853,1974,17.84,82.16,33.42
E02002697,East Riding of Yorkshire 014,7678,655,702,654,586,1013,1304,1176,1077,459,52,1357,6321,2764,17.67,82.33,36.0
E02002698,East Riding of Yorkshire 015,8505,966,771,909,939,1121,1176,1126,997,428,72,1737,6768,2623,20.42,79.58,30.84
E02002699,East Riding of Yorkshire 016,9734,1006,852,838,982,1301,1517,1299,1208,604,127,1858,7876,3238,19.09,80.91,33.26
E02002700,East Riding of Yorkshire 017,6312,914,607,819,767,788,874,667,544,293,39,1521,4791,1543,24.1,75.9,24.45
E02002701,East Riding of Yorkshire 018,8424,778,743,816,737,1076,1506,1364,962,365,77,1521,6903,2768,18.06,81.94,32.86
E02002702,East Riding of Yorkshire 019,10060,817,671,1261,1100,1226,1605,1425,1151,653,151,1488,8572,3380,14.79,85.21,33.6
E02002703,East Riding of Yorkshire 020,8964,766,991,859,688,1187,1642,1281,967,496,87,1757,7207,2831,19.6,80.4,31.58
E02002704,East Riding of Yorkshire 021,7127,561,531,691,599,770,1197,1264,1073,391,50,1092,6035,2778,15.32,84.68,38.98
E02002705,East Riding of Yorkshire 022,6420,526,385,610,561,768,1012,1003,935,529,91,911,5509,2558,14.19,85.81,39.84
E02002706,East Riding of Yorkshire 023,7163,748,553,681,837,865,1165,988,787,448,91,1301,5862,2314,18.16,81.84,32.3
E02002707,East Riding of Yorkshire 024,7331,552,592,917,646,962,1289,1016,888,406,63,1144,6187,2373,15.6,84.4,32.37
E02002708,East Riding of Yorkshire 025,6618,499,794,820,521,616,850,919,841,612,146,1293,5325,2518,19.54,80.46,38.05
E02002709,East Riding of Yorkshire 026,7920,729,682,818,861,1079,1319,1086,870,402,74,1411,6509,2432,17.82,82.18,30.71
E02002710,East Riding of Yorkshire 027,7447,790,650,726,751,973,1195,925,834,506,97,1440,6007,2362,19.34,80.66,31.72
E02002711,East Riding of Yorkshire 028,7630,636,647,606,591,966,1201,1107,1084,669,123,1283,6347,2983,16.82,83.18,39.1
E02002712,East Riding of Yorkshire 029,7610,672,542,772,730,942,1147,1163,1067,486,89,1214,6396,2805,15.95,84.05,36.86
E02002714,East Riding of Yorkshire 031,7823,722,607,735,708,874,1300,1354,1076,387,60,1329,6494,2877,16.99,83.01,36.78
E02002715,East Riding of Yorkshire 032,13503,1609,1519,1506,1582,2145,2058,1301,1124,565,94,3128,10375,3084,23.17,76.83,22.84
E02002716,East Riding of Yorkshire 033,8561,819,823,910,857,1091,1293,1171,1074,463,60,1642,6919,2768,19.18,80.82,32.33
E02002717,East Riding of Yorkshire 034,7956,944,666,1093,1034,975,1096,927,718,417,86,1610,6346,2148,20.24,79.76,27.0
E02002718,East Riding of Yorkshire 035,7959,766,763,563,626,1109,1246,1135,1083,589,79,1529,6430,2886,19.21,80.79,36.26
E02002719,East Riding of Yorkshire 036,6335,640,543,674,694,785,1063,795,610,424,107,1183,5152,1936,18.67,81.33,30.56
E02002720,East Riding of Yorkshire 037,7566,736,627,883,810,979,1198,1063,784,402,84,1363,6203,2333,18.01,81.99,30.84
E02002721,East Riding of Yorkshire 038,6417,548,541,694,650,814,1128,936,686,329,91,1089,5328,2042,16.97,83.03,31.82
E02002722,East Riding of Yorkshire 039,8699,923,763,832,845,896,1272,1414,1185,481,88,1686,7013,3168,19.38,80.62,36.42
E02002723,East Riding of Yorkshire 040,8844,1058,734,1196,1298,1109,1190,935,789,425,110,1792,7052,2259,20.26,79.74,25.54
E02002724,East Riding of Yorkshire 041,9758,1527,953,1482,1544,1157,1226,947,626,261,35,2480,7278,1869,25.42,74.58,19.15
E02002725,East Riding of Yorkshire 042,6709,634,605,678,672,931,1131,927,773,311,47,1239,5470,2058,18.47,81.53,30.68
E02006814,East Riding of Yorkshire 043,8136,931,706,961,901,1002,1180,1102,886,395,72,1637,6499,2455,20.12,79.88,30.17
E02006891,East Riding of Yorkshire 044,7702,695,695,783,714,958,1283,1119,938,435,82,1390,6312,2574,18.05,81.95,33.42
E02006892,East Riding of Yorkshire 045,6381,693,493,798,695,723,949,778,765,362,125,1186,5195,2030,18.59,81.41,31.81
E02002726,North East Lincolnshire 001,10488,1264,1014,1306,1243,1252,1464,1324,1077,441,103,2278,8210,2945,21.72,78.28,28.08
E02002727,North East Lincolnshire 002,5516,724,477,882,783,691,804,564,336,210,45,1201,4315,1155,21.77,78.23,20.94
E02002728,North East Lincolnshire 003,7690,1137,675,1404,1133,975,1003,674,444,205,40,1812,5878,1363,23.56,76.44,17.72
E02002729,North East Lincolnshire 004,5803,649,527,758,666,656,911,762,623,221,30,1176,4627,1636,20.27,79.73,28.19
E02002730,North East Lincolnshire 005,7549,1259,922,1237,1091,902,951,625,366,154,42,2181,5368,1187,28.89,71.11,15.72
E02002731,North East Lincolnshire 006,6064,1006,739,1064,946,727,732,480,244,109,17,1745,4319,850,28.78,71.22,14.02
E02002732,North East Lincolnshire 007,7894,812,813,833,854,1032,1247,1025,781,417,80,1625,6269,2303,20.59,79.41,29.17
E02002733,North East Lincolnshire 008,5748,602,481,876,773,664,856,675,500,276,45,1083,4665,1496,18.84,81.16,26.03
E02002734,North East Lincolnshire 009,5514,705,524,756,802,623,693,575,519,265,52,1229,4285,1411,22.29,77.71,25.59
E02002735,North East Lincolnshire 010,5045,633,419,785,697,608,747,566,340,210,40,1052,3993,1156,20.85,79.15,22.91
E02002736,North East Lincolnshire 011,5994,940,658,1184,937,751,739,431,226,113,15,1598,4396,785,26.66,73.34,13.1
E02002737,North East Lincolnshire 012,7154,891,610,911,943,786,1110,864,585,356,98,1501,5653,1903,20.98,79.02,26.6
E02002738,North East Lincolnshire 013,6981,910,645,870,922,751,1015,916,669,242,41,1555,5426,1868,22.27,77.73,26.76
E02002739,North East Lincolnshire 014,5828,740,451,715,808,635,823,727,531,347,51,1191,4637,1656,20.44,79.56,28.41
E02002740,North East Lincolnshire 015,5544,790,533,708,771,650,728,626,429,254,55,1323,4221,1364,23.86,76.14,24.6
E02002741,North East Lincolnshire 016,9007,1079,878,1269,1144,1115,1212,990,727,469,124,1957,7050,2310,21.73,78.27,25.65
E02002742,North East Lincolnshire 017,5592,530,455,578,575,705,792,804,732,373,48,985,4607,1957,17.61,82.39,35.0
E02002743,North East Lincolnshire 018,5541,426,420,461,519,530,781,791,935,534,144,846,4695,2404,15.27,84.73,43.39
E02002744,North East Lincolnshire 019,7234,1257,950,1124,946,777,852,735,390,169,34,2207,5027,1328,30.51,69.49,18.36
E02002745,North East Lincolnshire 020,7217,510,548,632,527,795,1276,1035,1219,559,116,1058,6159,2929,14.66,85.34,40.58
E02002746,North East Lincolnshire 021,9763,1143,928,1122,1241,1147,1351,1123,1020,564,124,2071,7692,2831,21.21,78.79,29.0
E02002747,North East Lincolnshire 022,8547,776,792,881,818,1120,1371,1049,1102,538,100,1568,6979,2789,18.35,81.65,32.63
E02002748,North East Lincolnshire 023,7850,643,633,723,719,813,1302,1235,1056,571,155,1276,6574,3017,16.25,83.75,38.43
E02002749,North Lincolnshire 001,11670,1244,1032,1449,1392,1467,1720,1589,1196,489,92,2276,9394,3366,19.5,80.5,28.84
E02002750,North Lincolnshire 002,6308,615,580,633,601,866,1104,899,692,265,53,1195,5113,1909,18.94,81.06,30.26
E02002751,North Lincolnshire 003,6475,702,626,758,675,744,974,850,815,286,45,1328,5147,1996,20.51,79.49,30.83
E02002752,North Lincolnshire 004,7097,789,610,699,767,863,1227,1076,719,304,43,1399,5698,2142,19.71,80.29,30.18
E02002753,North Lincolnshire 005,8660,810,594,928,913,991,1289,1328,1117,585,105,1404,7256,3135,16.21,83.79,36.2
E02002754,North Lincolnshire 006,8412,863,783,944,958,1019,1398,1158,834,386,69,1646,6766,2447,19.57,80.43,29.09
E02002755,North Lincolnshire 007,7899,983,669,1250,1494,1005,1018,732,464,216,68,1652,6247,1480,20.91,79.09,18.74
E02002756,North Lincolnshire 008,9618,1325,1120,1756,1878,1252,1027,665,358,189,48,2445,7173,1260,25.42,74.58,13.1
E02002757,North Lincolnshire 009,6470,861,645,867,974,786,836,637,500,288,76,1506,4964,1501,23.28,76.72,23.2
E02002758,North Lincolnshire 010,6280,839,626,981,933,752,872,678,387,180,32,1465,4815,1277,23.33,76.67,20.33
E02002759,North Lincolnshire 011,9545,857,830,953,955,1127,1576,1432,1162,528,125,1687,7858,3247,17.67,82.33,34.02
E02002760,North Lincolnshire 012,5933,654,509,741,687,682,968,781,568,261,82,1163,4770,1692,19.6,80.4,28.52
E02002761,North Lincolnshire 013,6589,614,567,775,684,738,1165,890,739,353,64,1181,5408,2046,17.92,82.08,31.05
E02002762,North Lincolnshire 014,6701,783,750,881,860,784,976,723,508,318,118,1533,5168,1667,22.88,77.12,24.88
E02002763,North Lincolnshire 015,8819,1438,957,1369,1357,1010,1096,764,500,245,83,2395,6424,1592,27.16,72.84,18.05
E02002764,North Lincolnshire 016,6037,936,823,923,761,669,735,554,410,189,37,1759,4278,1190,29.14,70.86,19.71
E02002765,North Lincolnshire 017,6369,854,654,823,835,680,862,717,568,313,63,1508,4861,1661,23.68,76.32,26.08
E02002766,North Lincolnshire 018,9049,1083,930,1087,1169,1081,1147,1066,919,443,124,2013,7036,2552,22.25,77.75,28.2
E02002767,North Lincolnshire 019,6602,578,497,728,656,785,1031,994,861,389,83,1075,5527,2327,16.28,83.72,35.25
E02002768,North Lincolnshire 020,7686,735,732,816,679,999,1262,1177,832,391,63,1467,6219,2463,19.09,80.91,32.05
E02002769,North Lincolnshire 021,5724,498,457,490,474,607,1035,870,847,383,63,955,4769,2163,16.68,83.32,37.79
E02002770,North Lincolnshire 022,7057,687,626,789,796,835,1078,1035,815,330,66,1313,5744,2246,18.61,81.39,31.83
E02002771,North Lincolnshire 023,7292,617,656,730,584,851,1270,1112,1000,399,73,1273,6019,2584,17.46,82.54,35.44
E02002772,York 001,6971,814,767,761,752,995,1128,807,622,253,72,1581,5390,1754,22.68,77.32,25.16
E02002773,York 002,5744,527,452,520,550,640,718,891,902,443,101,979,4765,2337,17.04,82.96,40.69
E02002774,York 003,6099,572,511,523,614,720,835,934,794,441,155,1083,5016,2324,17.76,82.24,38.1
E02002775,York 004,5752,529,486,683,557,651,788,715,759,468,116,1015,4737,2058,17.65,82.35,35.78
E02002776,York 005,6872,660,559,1061,864,806,966,726,748,418,64,1219,5653,1956,17.74,82.26,28.46
E02002777,York 006,8508,993,755,1343,1216,1203,1295,907,570,198,28,1748,6760,1703,20.55,79.45,20.02
E02002778,York 007,8407,752,736,1262,901,1103,1304,915,809,495,130,1488,6919,2349,17.7,82.3,27.94
E02002779,York 008,9723,937,720,1530,1001,1099,1423,1174,1085,638,116,1657,8066,3013,17.04,82.96,30.99
E02002780,York 009,8669,859,736,2518,1379,926,917,619,462,227,26,1595,7074,1334,18.4,81.6,15.39
E02002781,York 010,11444,998,660,4488,1719,1042,1019,672,487,289,70,1658,9786,1518,14.49,85.51,13.26
E02002782,York 011,6374,652,624,715,522,838,936,731,748,498,110,1276,5098,2087,20.02,79.98,32.74
E02002783,York 012,10469,1176,1014,1429,1348,1365,1478,1179,895,508,77,2190,8279,2659,20.92,79.08,25.4
E02002784,York 013,13475,784,462,5751,1888,1276,1235,1011,674,326,68,1246,12229,2079,9.25,90.75,15.43
E02002785,York 014,8405,779,689,2032,923,899,1037,781,687,497,81,1468,6937,2046,17.47,82.53,24.34
E02002786,York 015,11344,933,812,5023,1424,984,933,586,435,188,26,1745,9599,1235,15.38,84.62,10.89
E02002787,York 016,9369,1101,710,1565,1370,1226,1203,929,710,455,100,1811,7558,2194,19.33,80.67,23.42
E02002788,York 017,9089,1035,648,1918,1499,1211,1171,791,554,214,48,1683,7406,1607,18.52,81.48,17.68
E02002789,York 018,9229,1345,865,1505,1466,1102,1106,832,605,319,84,2210,7019,1840,23.95,76.05,19.94
E02002790,York 019,13167,1070,782,5143,1873,1269,1146,823,634,326,101,1852,11315,1884,14.07,85.93,14.31
E02002791,York 020,6479,661,718,592,495,865,974,795,855,405,119,1379,5100,2174,21.28,78.72,33.55
E02002792,York 021,7801,833,610,1262,1081,1023,1069,835,625,362,101,1443,6358,1923,18.5,81.5,24.65
E02002793,York 022,9342,982,694,1364,1104,1083,1290,1181,1066,460,118,1676,7666,2825,17.94,82.06,30.24
E02002794,York 023,9590,526,462,4963,568,664,735,624,616,329,103,988,8602,1672,10.3,89.7,17.43
E02002795,York 024,8296,833,802,674,646,1106,1233,1246,1193,463,100,1635,6661,3002,19.71,80.29,36.19
E02002796,Derby 001,6047,673,626,575,584,759,886,739,778,357,70,1299,4748,1944,21.48,78.52,32.15
E02002797,Derby 002,7338,674,588,731,678,825,1022,905,1003,763,149,1262,6076,2820,17.2,82.8,38.43
E02002798,Derby 003,9567,1022,725,1459,1194,1210,1663,1179,728,305,82,1747,7820,2294,18.26,81.74,23.98
E02002799,Derby 004,5957,896,639,869,919,743,815,455,374,222,25,1535,4422,1076,25.77,74.23,18.06
E02002800,Derby 005,7076,783,632,1006,836,918,962,708,672,419,140,1415,5661,1939,20.0,80.0,27.4
E02002801,Derby 006,7473,930,756,1012,924,837,1065,754,698,427,70,1686,5787,1949,22.56,77.44,26.08
E02002802,Derby 007,7982,1244,989,1242,1183,882,1024,680,455,241,42,2233,5749,1418,27.98,72.02,17.76
E02002803,Derby 008,8472,564,373,3499,1163,866,768,616,388,200,35,937,7535,1239,11.06,88.94,14.62
E02002804,Derby 009,8723,1356,925,1316,1217,906,1122,768,594,356,163,2281,6442,1881,26.15,73.85,21.56
E02002805,Derby 010,5480,488,431,523,536,611,844,701,881,412,53,919,4561,2047,16.77,83.23,37.35
E02002806,Derby 011,6345,624,423,2399,896,644,590,387,242,116,24,1047,5298,769,16.5,83.5,12.12
E02002807,Derby 012,8675,1093,892,1219,1021,1051,1226,879,868,345,81,1985,6690,2173,22.88,77.12,25.05
E02002808,Derby 013,13056,1420,663,4743,2305,1477,1100,666,395,242,45,2083,10973,1348,15.95,84.05,10.32
E02002809,Derby 014,6681,817,639,897,878,780,917,674,663,305,111,1456,5225,1753,21.79,78.21,26.24
E02002810,Derby 015,8432,993,715,884,988,1006,1225,1070,920,540,91,1708,6724,2621,20.26,79.74,31.08
E02002811,Derby 016,11333,1838,1343,2382,1779,1504,1197,753,299,195,43,3181,8152,1290,28.07,71.93,11.38
E02002812,Derby 017,7575,901,673,1146,967,987,1011,773,613,385,119,1574,6001,1890,20.78,79.22,24.95
E02002813,Derby 018,11851,2133,1433,2251,1999,1582,1106,686,355,244,62,3566,8285,1347,30.09,69.91,11.37
E02002814,Derby 019,7000,650,570,694,689,828,1041,1054,857,489,128,1220,5780,2528,17.43,82.57,36.11
E02002815,Derby 020,8789,1578,1238,1507,1403,1114,874,482,315,216,62,2816,5973,1075,32.04,67.96,12.23
E02002816,Derby 021,9503,1229,1283,1123,1044,1444,1419,958,619,319,65,2512,6991,1961,26.43,73.57,20.64
E02002817,Derby 022,6232,751,643,709,744,732,845,752,600,380,76,1394,4838,1808,22.37,77.63,29.01
E02002818,Derby 023,8694,1539,1120,1314,1274,1076,907,610,430,332,92,2659,6035,1464,30.58,69.42,16.84
E02002819,Derby 024,7926,888,612,1513,1223,858,1125,754,580,303,70,1500,6426,1707,18.93,81.07,21.54
E02002820,Derby 025,9692,1507,995,1564,1492,1136,1268,802,597,278,53,2502,7190,1730,25.82,74.18,17.85
E02002821,Derby 026,12152,2168,1734,1923,1888,1476,1333,765,512,289,64,3902,8250,1630,32.11,67.89,13.41
E02002822,Derby 027,6620,858,635,967,783,788,908,678,541,397,65,1493,5127,1681,22.55,77.45,25.39
E02002823,Derby 028,7339,905,658,1004,846,775,1061,777,858,397,58,1563,5776,2090,21.3,78.7,28.48
E02002824,Derby 029,9791,1557,1155,1438,1421,1237,1145,947,615,223,53,2712,7079,1838,27.7,72.3,18.77
E02002825,Derby 030,8580,1107,938,1031,1055,1174,1103,852,803,385,132,2045,6535,2172,23.83,76.17,25.31
E02002826,Derby 031,6921,857,789,939,778,994,1129,681,473,246,35,1646,5275,1435,23.78,76.22,20.73
E02002827,Leicester 001,6308,978,654,1053,916,747,839,628,339,111,43,1632,4676,1121,25.87,74.13,17.77
E02002828,Leicester 002,7727,937,698,1148,1041,924,965,1050,628,295,41,1635,6092,2014,21.16,78.84,26.06
E02002829,Leicester 003,11286,2028,1291,1861,1599,1343,1314,853,536,346,115,3319,7967,1850,29.41,70.59,16.39
E02002830,Leicester 004,10079,1734,1188,1767,1486,1272,1056,908,447,177,44,2922,7157,1576,28.99,71.01,15.64
E02002831,Leicester 005,6809,832,750,1035,825,860,834,822,517,278,56,1582,5227,1673,23.23,76.77,24.57
E02002832,Leicester 006,9159,1097,922,1503,1275,1137,1086,1113,608,337,81,2019,7140,2139,22.04,77.96,23.35
E02002833,Leicester 007,8340,1059,857,1514,1198,995,1075,932,468,213,29,1916,6424,1642,22.97,77.03,19.69
E02002834,Leicester 008,11256,1397,912,2437,1879,1239,1177,1004,736,386,89,2309,8947,2215,20.51,79.49,19.68
E02002835,Leicester 009,14393,2359,1670,2495,2352,1848,1530,1170,597,313,59,4029,10364,2139,27.99,72.01,14.86
E02002836,Leicester 010,9547,1147,879,1617,1298,1270,1206,1150,621,316,43,2026,7521,2130,21.22,78.78,22.31
E02002837,Leicester 011,8477,1386,1124,1574,1232,1140,946,624,316,123,12,2510,5967,1075,29.61,70.39,12.68
E02002838,Leicester 012,8049,1516,1061,1266,1015,891,889,621,499,242,49,2577,5472,1411,32.02,67.98,17.53
E02002839,Leicester 013,7863,1182,845,1091,1077,905,990,817,569,295,92,2027,5836,1773,25.78,74.22,22.55
E02002842,Leicester 016,8585,1470,687,2177,1661,980,846,460,198,88,18,2157,6428,764,25.13,74.87,8.9
E02002843,Leicester 017,14185,2359,1720,2739,2032,1881,1418,1183,555,266,32,4079,10106,2036,28.76,71.24,14.35
E02002844,Leicester 018,11626,2057,1645,1961,1687,1488,1185,817,501,230,55,3702,7924,1603,31.84,68.16,13.79
E02002845,Leicester 019,10862,1799,1181,1840,1548,1282,1258,996,562,304,92,2980,7882,1954,27.44,72.56,17.99
E02002846,Leicester 020,7153,874,582,1034,918,888,1092,822,587,279,77,1456,5697,1765,20.36,79.64,24.67
E02002847,Leicester 021,10009,1501,1295,1833,1350,1274,1098,925,442,247,44,2796,7213,1658,27.93,72.07,16.57
E02002848,Leicester 022,11276,1750,1448,2746,1513,1333,999,816,449,195,27,3198,8078,1487,28.36,71.64,13.19
E02002849,Leicester 023,14738,1351,690,6663,2264,1401,1020,643,423,217,66,2041,12697,1349,13.85,86.15,9.15
E02002851,Leicester 025,8318,1007,775,1293,955,865,1049,1064,701,477,132,1782,6536,2374,21.42,78.58,28.54
E02002852,Leicester 026,7007,1243,1161,1104,906,804,800,543,285,139,22,2404,4603,989,34.31,65.69,14.11
E02002853,Leicester 027,13220,1949,1498,3218,1625,1481,1371,1094,584,337,63,3447,9773,2078,26.07,73.93,15.72
E02002854,Leicester 028,8267,1294,889,1471,1217,962,1011,653,423,281,66,2183,6084,1423,26.41,73.59,17.21
E02002855,Leicester 029,8079,1001,485,2498,1445,904,737,532,318,141,18,1486,6593,1009,18.39,81.61,12.49
E02002856,Leicester 030,11791,1009,710,4198,1631,1126,1107,851,653,374,132,1719,10072,2010,14.58,85.42,17.05
E02002857,Leicester 031,6613,929,493,1503,1230,803,754,469,254,143,35,1422,5191,901,21.5,78.5,13.62
E02002858,Leicester 032,7031,845,706,829,723,923,1046,808,663,397,91,1551,5480,1959,22.06,77.94,27.86
E02002860,Leicester 034,7892,1016,726,1121,987,944,1041,839,693,405,120,1742,6150,2057,22.07,77.93,26.06
E02002861,Leicester 035,7547,1277,1080,1221,1028,832,892,643,360,177,37,2357,5190,1217,31.23,68.77,16.13
E02002862,Leicester 036,8030,1297,879,1251,1126,878,939,715,575,303,67,2176,5854,1660,27.1,72.9,20.67
E02006815,Leicester 037,10593,1878,1145,1578,1400,1067,1238,996,668,466,157,3023,7570,2287,28.54,71.46,21.59
E02006817,Leicester 038,8828,1084,728,2564,1105,933,937,677,466,261,73,1812,7016,1477,20.53,79.47,16.73
E02006819,Leicester 039,8103,1469,1034,1257,1121,955,938,638,436,201,54,2503,5600,1329,30.89,69.11,16.4
E02006850,Leicester 040,13603,522,369,9630,1291,682,530,299,153,110,17,891,12712,579,6.55,93.45,4.26
E02006851,Leicester 041,11575,517,155,8173,1509,629,311,195,62,20,4,672,10903,281,5.81,94.19,2.43
E02002863,Rutland 001,7830,676,441,1322,1183,1002,1049,944,828,323,62,1117,6713,2157,14.27,85.73,27.55
E02002864,Rutland 002,8011,1002,731,760,987,1038,1126,1011,840,423,93,1733,6278,2367,21.63,78.37,29.55
E02002865,Rutland 003,7875,717,852,816,735,937,1089,1024,1056,530,119,1569,6306,2729,19.92,80.08,34.65
E02002866,Rutland 004,7634,796,704,632,647,1035,1224,1032,981,476,107,1500,6134,2596,19.65,80.35,34.01
E02002867,Rutland 005,8577,681,1254,841,648,918,1365,1143,1032,546,149,1935,6642,2870,22.56,77.44,33.46
E02002868,Nottingham 001,5744,709,504,761,625,614,794,675,725,307,30,1213,4531,1737,21.12,78.88,30.24
E02002869,Nottingham 002,7526,1264,759,1202,971,827,950,703,510,280,60,2023,5503,1553,26.88,73.12,20.64
E02002871,Nottingham 004,7723,941,696,1202,854,944,1166,839,663,354,64,1637,6086,1920,21.2,78.8,24.86
E02002872,Nottingham 005,8790,1306,909,1536,1044,1068,1192,839,623,232,41,2215,6575,1735,25.2,74.8,19.74
E02002873,Nottingham 006,9513,1633,1048,1704,1495,1131,1127,687,393,254,41,2681,6832,1375,28.18,71.82,14.45
E02002874,Nottingham 007,8238,1097,828,1502,1135,1071,1043,762,466,247,87,1925,6313,1562,23.37,76.63,18.96
E02002875,Nottingham 008,8603,1386,888,1516,1274,990,1097,674,498,227,53,2274,6329,1452,26.43,73.57,16.88
E02002876,Nottingham 009,8176,1004,670,1607,969,1067,1171,821,555,265,47,1674,6502,1688,20.47,79.53,20.65
E02002877,Nottingham 010,7730,846,498,1334,1111,1072,984,825,612,332,116,1344,6386,1885,17.39,82.61,24.39
E02002878,Nottingham 011,9723,2084,1569,1569,1356,1227,947,548,292,113,18,3653,6070,971,37.57,62.43,9.99
E02002879,Nottingham 012,9741,1456,902,2049,1682,1259,1135,688,405,140,25,2358,7383,1258,24.21,75.79,12.91
E02002880,Nottingham 013,9058,1691,1266,1604,1253,1084,1029,548,419,139,25,2957,6101,1131,32.65,67.35,12.49
E02002881,Nottingham 014,6863,1201,786,1150,913,774,884,555,361,176,63,1987,4876,1155,28.95,71.05,16.83
E02002882,Nottingham 015,8589,784,763,2234,1163,1092,1050,739,413,256,95,1547,7042,1503,18.01,81.99,17.5
E02002883,Nottingham 016,7951,1109,796,1407,1285,1026,1022,694,399,186,27,1905,6046,1306,23.96,76.04,16.43
E02002884,Nottingham 017,6968,963,666,1864,1184,887,676,374,192,121,41,1629,5339,728,23.38,76.62,10.45
E02002885,Nottingham 018,9200,1568,1023,2308,1468,1281,787,455,240,55,15,2591,6609,765,28.16,71.84,8.32
E02002886,Nottingham 019,9769,1576,1073,1622,1435,1168,1018,878,574,354,71,2649,7120,1877,27.12,72.88,19.21
E02002887,Nottingham 020,6583,803,640,958,669,767,879,751,670,340,106,1443,5140,1867,21.92,78.08,28.36
E02002888,Nottingham 021,7577,1244,784,1301,1124,1071,884,634,329,185,21,2028,5549,1169,26.77,73.23,15.43
E02002889,Nottingham 022,13020,428,282,9642,977,565,569,339,132,69,17,710,12310,557,5.45,94.55,4.28
E02002890,Nottingham 023,13912,927,661,7775,1574,851,938,607,359,180,40,1588,12324,1186,11.41,88.59,8.53
E02002891,Nottingham 024,8190,1256,784,1313,1076,1001,1013,829,535,324,59,2040,6150,1747,24.91,75.09,21.33
E02002892,Nottingham 025,6074,843,745,970,688,715,849,563,394,248,59,1588,4486,1264,26.14,73.86,20.81
E02002893,Nottingham 026,16101,1376,917,8742,2084,1119,875,579,274,113,22,2293,13808,988,14.24,85.76,6.14
E02002894,Nottingham 027,7034,984,707,904,913,908,878,777,546,328,89,1691,5343,1740,24.04,75.96,24.74
E02002895,Nottingham 028,8438,334,296,5077,937,538,530,371,249,92,14,630,7808,726,7.47,92.53,8.6
E02002896,Nottingham 029,10663,1749,1085,2315,1847,1407,1011,657,372,175,45,2834,7829,1249,26.58,73.42,11.71
E02002897,Nottingham 030,8173,1107,816,856,812,1055,1107,891,854,551,124,1923,6250,2420,23.53,76.47,29.61
E02002898,Nottingham 031,10914,494,315,7646,1006,419,381,329,172,128,24,809,10105,653,7.41,92.59,5.98
E02002899,Nottingham 032,11019,539,345,7072,962,599,493,467,320,179,43,884,10135,1009,8.02,91.98,9.16
E02002901,Nottingham 034,6167,780,451,961,757,752,855,723,519,299,70,1231,4936,1611,19.96,80.04,26.12
E02002902,Nottingham 035,9266,1024,764,2681,1004,827,1066,965,458,339,138,1788,7478,1900,19.3,80.7,20.51
E02002903,Nottingham 036,6232,864,550,888,756,664,739,790,477,416,88,1414,4818,1771,22.69,77.31,28.42
E02002904,Nottingham 037,6035,882,612,1040,725,675,805,614,341,249,92,1494,4541,1296,24.76,75.24,21.47
E02006834,Nottingham 038,7543,1013,744,1240,938,759,1023,744,606,423,53,1757,5786,1826,23.29,76.71,24.21
E02006904,Nottingham 039,12272,474,376,7978,1676,758,510,324,138,17,21,850,11422,500,6.93,93.07,4.07
E02006905,Nottingham 040,7782,1041,773,1918,1245,842,840,582,343,164,34,1814,5968,1123,23.31,76.69,14.43
E02002905,Herefordshire 001,6464,576,511,570,519,715,1101,1094,986,336,56,1087,5377,2472,16.82,83.18,38.24
E02002906,Herefordshire 002,6105,791,476,761,737,632,745,722,668,416,157,1267,4838,1963,20.75,79.25,32.15
E02002907,Herefordshire 003,6296,660,521,815,819,753,835,846,695,300,52,1181,5115,1893,18.76,81.24,30.07
E02002908,Herefordshire 004,8929,779,753,871,710,920,1448,1512,1308,540,88,1532,7397,3448,17.16,82.84,38.62
E02002909,Herefordshire 005,10768,971,813,1124,1079,1159,1670,1799,1364,623,166,1784,8984,3952,16.57,83.43,36.7
E02002910,Herefordshire 006,8227,748,632,790,715,876,1312,1351,1154,539,110,1380,6847,3154,16.77,83.23,38.34
E02002911,Herefordshire 007,9610,1027,856,988,1057,1132,1352,1340,1145,599,114,1883,7727,3198,19.59,80.41,33.28
E02002912,Herefordshire 008,7671,790,645,942,811,1014,1205,1036,811,355,62,1435,6236,2264,18.71,81.29,29.51
E02002913,Herefordshire 009,5828,448,478,438,474,604,952,1039,926,374,95,926,4902,2434,15.89,84.11,41.76
E02002914,Herefordshire 010,9294,993,794,1224,1330,1067,1347,1089,889,485,76,1787,7507,2539,19.23,80.77,27.32
E02002915,Herefordshire 011,7750,795,644,1079,874,839,1142,895,791,521,170,1439,6311,2377,18.57,81.43,30.67
E02002916,Herefordshire 012,10068,1088,781,1785,1711,1184,1378,993,699,372,77,1869,8199,2141,18.56,81.44,21.27
E02002917,Herefordshire 013,7174,746,563,1204,1072,870,998,710,601,332,78,1309,5865,1721,18.25,81.75,23.99
E02002918,Herefordshire 014,5991,595,620,645,561,707,873,808,671,419,92,1215,4776,1990,20.28,79.72,33.22
E02002919,Herefordshire 015,9779,1394,875,1395,1648,1178,1203,935,734,333,84,2269,7510,2086,23.2,76.8,21.33
E02002920,Herefordshire 016,6779,742,526,864,875,850,1027,842,702,278,73,1268,5511,1895,18.7,81.3,27.95
E02002921,Herefordshire 017,8270,1400,896,1206,1298,1005,1027,740,452,210,36,2296,5974,1438,27.76,72.24,17.39
E02002922,Herefordshire 018,6860,561,660,650,662,838,1090,1060,880,389,70,1221,5639,2399,17.8,82.2,34.97
E02002923,Herefordshire 019,10054,914,831,1106,1109,1164,1478,1190,1327,732,203,1745,8309,3452,17.36,82.64,34.33
E02002924,Herefordshire 020,6246,610,577,565,497,667,1066,946,847,393,78,1187,5059,2264,19.0,81.0,36.25
E02002925,Herefordshire 021,11269,1170,952,1319,1222,1376,1824,1568,1212,531,95,2122,9147,3406,18.83,81.17,30.22
E02002926,Herefordshire 022,11309,1136,899,1304,1272,1268,1542,1555,1373,772,188,2035,9274,3888,17.99,82.01,34.38
E02002927,Herefordshire 023,12060,939,872,1156,1052,1316,2151,2014,1698,710,152,1811,10249,4574,15.02,84.98,37.93
E02002928,Telford and Wrekin 001,5982,583,564,1009,577,675,896,740,647,235,56,1147,4835,1678,19.17,80.83,28.05
E02002929,Telford and Wrekin 002,6358,471,533,1342,447,701,943,811,735,302,73,1004,5354,1921,15.79,84.21,30.21
E02002930,Telford and Wrekin 003,6372,653,575,1044,720,779,757,697,711,364,72,1228,5144,1844,19.27,80.73,28.94
E02002931,Telford and Wrekin 004,6762,709,762,764,715,926,1120,766,695,284,21,1471,5291,1766,21.75,78.25,26.12
E02002932,Telford and Wrekin 005,9219,1347,962,1370,1440,1296,1101,792,615,249,47,2309,6910,1703,25.05,74.95,18.47
E02002933,Telford and Wrekin 006,7870,775,715,1019,777,997,1371,908,814,423,71,1490,6380,2216,18.93,81.07,28.16
E02002934,Telford and Wrekin 007,6028,660,626,752,748,796,937,844,450,186,29,1286,4742,1509,21.33,78.67,25.03
E02002935,Telford and Wrekin 008,6534,758,548,852,795,817,899,798,720,309,38,1306,5228,1865,19.99,80.01,28.54
E02002936,Telford and Wrekin 009,10465,1710,1149,1796,1756,1418,1203,735,482,179,37,2859,7606,1433,27.32,72.68,13.69
E02002937,Telford and Wrekin 010,10060,939,893,1102,965,1305,1820,1394,1128,437,77,1832,8228,3036,18.21,81.79,30.18
E02002938,Telford and Wrekin 011,7237,1009,876,1139,988,885,900,711,482,207,40,1885,5352,1440,26.05,73.95,19.9
E02002939,Telford and Wrekin 012,6964,733,572,892,812,917,1017,829,699,404,89,1305,5659,2021,18.74,81.26,29.02
E02002940,Telford and Wrekin 013,5856,595,476,860,739,754,902,677,552,265,36,1071,4785,1530,18.29,81.71,26.13
E02002941,Telford and Wrekin 014,10484,1330,908,1413,1434,1406,1449,1118,950,394,82,2238,8246,2544,21.35,78.65,24.27
E02002942,Telford and Wrekin 015,7353,1022,750,946,1076,960,1062,837,440,216,44,1772,5581,1537,24.1,75.9,20.9
E02002943,Telford and Wrekin 016,14858,2541,1534,2310,2647,2147,1662,1062,625,254,76,4075,10783,2017,27.43,72.57,13.58
E02002944,Telford and Wrekin 017,8214,1266,844,1330,1141,1002,1048,789,539,224,31,2110,6104,1583,25.69,74.31,19.27
E02002945,Telford and Wrekin 018,9690,1290,1071,1426,1447,1330,1287,969,623,223,24,2361,7329,1839,24.37,75.63,18.98
E02002946,Telford and Wrekin 019,7692,868,620,1112,999,1004,1233,909,621,289,37,1488,6204,1856,19.34,80.66,24.13
E02002947,Telford and Wrekin 020,7163,1173,784,1070,1016,852,856,690,526,163,33,1957,5206,1412,27.32,72.68,19.71
E02002948,Telford and Wrekin 021,7560,1411,1047,1258,1069,909,802,530,386,134,14,2458,5102,1064,32.51,67.49,14.07
E02002949,Telford and Wrekin 022,5365,529,450,678,602,655,845,718,594,257,37,979,4386,1606,18.25,81.75,29.93
E02002950,Telford and Wrekin 023,5768,869,620,806,707,614,707,627,564,220,34,1489,4279,1445,25.81,74.19,25.05
E02002951,Stoke-on-Trent 001,7615,843,682,930,836,881,1136,1072,799,346,90,1525,6090,2307,20.03,79.97,30.3
E02002952,Stoke-on-Trent 002,7495,1147,711,1154,1085,941,923,659,536,295,44,1858,5637,1534,24.79,75.21,20.47
E02002953,Stoke-on-Trent 003,7373,940,742,976,852,854,929,844,852,322,62,1682,5691,2080,22.81,77.19,28.21
E02002954,Stoke-on-Trent 004,8193,1160,736,1157,1007,888,1178,936,733,351,47,1896,6297,2067,23.14,76.86,25.23
E02002955,Stoke-on-Trent 005,7701,1346,827,1325,1178,1003,820,569,405,191,37,2173,5528,1202,28.22,71.78,15.61
E02002956,Stoke-on-Trent 006,9251,1330,984,1547,1162,1067,1247,914,642,299,59,2314,6937,1914,25.01,74.99,20.69
E02002957,Stoke-on-Trent 007,9566,1068,822,1123,1095,1143,1400,1166,1093,579,77,1890,7676,2915,19.76,80.24,30.47
E02002958,Stoke-on-Trent 008,8240,1141,751,1217,1237,939,1049,848,682,322,54,1892,6348,1906,22.96,77.04,23.13
E02002959,Stoke-on-Trent 009,9433,1475,881,1628,1571,1230,1033,734,544,290,47,2356,7077,1615,24.98,75.02,17.12
E02002960,Stoke-on-Trent 010,5766,623,526,828,650,656,907,822,516,210,28,1149,4617,1576,19.93,80.07,27.33
E02002961,Stoke-on-Trent 011,7016,1022,720,1231,1162,962,767,525,426,175,26,1742,5274,1152,24.83,75.17,16.42
E02002962,Stoke-on-Trent 012,7273,1079,732,1073,925,778,961,759,614,303,49,1811,5462,1725,24.9,75.1,23.72
E02002963,Stoke-on-Trent 013,7247,953,532,1278,1262,936,957,648,435,218,28,1485,5762,1329,20.49,79.51,18.34
E02002964,Stoke-on-Trent 014,8494,985,723,1051,956,891,1198,1100,1036,489,65,1708,6786,2690,20.11,79.89,31.67
E02002965,Stoke-on-Trent 015,8469,1216,902,2183,1495,987,786,482,266,132,20,2118,6351,900,25.01,74.99,10.63
E02002966,Stoke-on-Trent 016,10120,1043,743,3833,1644,909,664,629,431,185,39,1786,8334,1284,17.65,82.35,12.69
E02002967,Stoke-on-Trent 017,10339,1797,1190,1540,1527,1195,1238,937,528,325,62,2987,7352,1852,28.89,71.11,17.91
E02002968,Stoke-on-Trent 018,9244,1047,720,1777,1368,1218,1221,863,633,325,72,1767,7477,1893,19.12,80.88,20.48
E02002969,Stoke-on-Trent 019,9456,1114,689,2277,1519,1142,1068,764,585,262,36,1803,7653,1647,19.07,80.93,17.42
E02002970,Stoke-on-Trent 020,8143,1102,682,1530,1107,1004,1133,730,618,199,38,1784,6359,1585,21.91,78.09,19.46
E02002971,Stoke-on-Trent 021,4854,624,354,718,609,595,741,697,399,108,9,978,3876,1213,20.15,79.85,24.99
E02002972,Stoke-on-Trent 022,6292,815,597,964,915,695,824,688,566,192,36,1412,4880,1482,22.44,77.56,23.55
E02002973,Stoke-on-Trent 023,8390,1141,827,1477,1116,1100,1108,804,522,259,36,1968,6422,1621,23.46,76.54,19.32
E02002974,Stoke-on-Trent 024,5978,749,461,697,699,554,827,791,743,369,88,1210,4768,1991,20.24,79.76,33.31
E02002975,Stoke-on-Trent 025,7072,752,561,981,845,877,1140,938,726,220,32,1313,5759,1916,18.57,81.43,27.09
E02002976,Stoke-on-Trent 026,6016,763,635,865,712,719,856,636,559,252,19,1398,4618,1466,23.24,76.76,24.37
E02002977,Stoke-on-Trent 027,5702,532,383,724,581,566,799,826,828,395,68,915,4787,2117,16.05,83.95,37.13
E02002978,Stoke-on-Trent 028,6773,1140,713,1105,973,736,762,621,455,231,37,1853,4920,1344,27.36,72.64,19.84
E02002979,Stoke-on-Trent 029,6017,1067,680,1036,908,638,582,523,364,188,31,1747,4270,1106,29.03,70.97,18.38
E02002980,Stoke-on-Trent 030,5993,674,469,605,630,636,811,810,828,433,97,1143,4850,2168,19.07,80.93,36.18
E02002981,Stoke-on-Trent 031,8429,1248,1022,1237,1095,1086,1189,770,545,215,22,2270,6159,1552,26.93,73.07,18.41
E02002982,Stoke-on-Trent 032,7975,1176,929,1259,1094,1098,933,795,432,208,51,2105,5870,1486,26.39,73.61,18.63
E02002983,Stoke-on-Trent 033,5083,488,467,599,530,596,818,690,657,208,30,955,4128,1585,18.79,81.21,31.18
E02002984,Stoke-on-Trent 034,5367,522,397,519,606,640,810,871,679,268,55,919,4448,1873,17.12,82.88,34.9
E02002985,Bath and North East Somerset 001,6409,742,498,1008,899,734,755,641,635,384,113,1240,5169,1773,19.35,80.65,27.66
E02002986,Bath and North East Somerset 002,6305,907,489,925,976,707,698,582,603,332,86,1396,4909,1603,22.14,77.86,25.42
E02002987,Bath and North East Somerset 003,5647,591,464,690,532,718,745,690,699,435,83,1055,4592,1907,18.68,81.32,33.77
E02002988,Bath and North East Somerset 004,5697,645,573,687,629,776,806,645,536,311,89,1218,4479,1581,21.38,78.62,27.75
E02002989,Bath and North East Somerset 005,5741,694,535,760,686,758,772,545,488,412,91,1229,4512,1536,21.41,78.59,26.75
E02002990,Bath and North East Somerset 006,6098,540,441,1531,771,817,792,585,447,156,18,981,5117,1206,16.09,83.91,19.78
E02002991,Bath and North East Somerset 007,11318,628,864,3588,1406,1070,1279,972,874,508,129,1492,9826,2483,13.18,86.82,21.94
E02002992,Bath and North East Somerset 008,5980,651,573,1167,595,791,790,576,481,291,65,1224,4756,1413,20.47,79.53,23.63
E02002993,Bath and North East Somerset 009,6697,377,248,3058,738,593,660,500,305,164,54,625,6072,1023,9.33,90.67,15.28
E02002994,Bath and North East Somerset 010,10545,1075,1226,1077,861,1340,1688,1326,1169,651,132,2301,8244,3278,21.82,78.18,31.09
E02002995,Bath and North East Somerset 011,5782,845,464,1356,870,649,706,402,323,138,29,1309,4473,892,22.64,77.36,15.43
E02002996,Bath and North East Somerset 012,13369,595,839,7324,711,794,988,929,743,351,95,1434,11935,2118,10.73,89.27,15.84
E02002997,Bath and North East Somerset 013,7807,474,359,3993,756,580,559,461,386,199,40,833,6974,1086,10.67,89.33,13.91
E02002998,Bath and North East Somerset 014,5919,517,386,2260,571,529,640,396,347,214,59,903,5016,1016,15.26,84.74,17.17
E02002999,Bath and North East Somerset 015,5577,619,512,1009,676,685,658,578,507,279,54,1131,4446,1418,20.28,79.72,25.43
E02003000,Bath and North East Somerset 016,9659,971,816,1025,867,1116,1454,1452,1240,591,127,1787,7872,3410,18.5,81.5,35.3
E02003001,Bath and North East Somerset 017,5561,496,641,848,447,711,842,690,491,298,97,1137,4424,1576,20.45,79.55,28.34
E02003002,Bath and North East Somerset 018,5937,798,580,1055,621,700,739,637,480,238,89,1378,4559,1444,23.21,76.79,24.32
E02003003,Bath and North East Somerset 019,6040,734,510,1183,851,735,704,547,446,244,86,1244,4796,1323,20.6,79.4,21.9
E02003004,Bath and North East Somerset 020,6781,754,589,891,706,834,1090,860,689,312,56,1343,5438,1917,19.81,80.19,28.27
E02003005,Bath and North East Somerset 021,6502,721,617,686,548,850,1033,884,796,303,64,1338,5164,2047,20.58,79.42,31.48
E02003006,Bath and North East Somerset 022,9765,1067,904,2008,1038,1171,1378,976,788,349,86,1971,7794,2199,20.18,79.82,22.52
E02003007,Bath and North East Somerset 023,9290,1245,832,1335,1184,1028,1269,1050,859,403,85,2077,7213,2397,22.36,77.64,25.8
E02003008,Bath and North East Somerset 024,6151,868,607,975,850,726,840,583,429,239,34,1475,4676,1285,23.98,76.02,20.89
E02003009,Bath and North East Somerset 025,6238,699,573,896,726,784,913,652,574,351,70,1272,4966,1647,20.39,79.61,26.4
E02003010,Bath and North East Somerset 026,6769,927,670,1117,877,831,898,690,478,231,50,1597,5172,1449,23.59,76.41,21.41
E02003011,Bath and North East Somerset 027,5698,696,561,698,587,665,764,608,707,350,62,1257,4441,1727,22.06,77.94,30.31
E02003012,Bristol 001,11473,1712,1047,1758,1797,1400,1297,1060,890,392,120,2759,8714,2462,24.05,75.95,21.46
E02003013,Bristol 002,11978,1619,1386,2036,1758,1502,1323,989,864,395,106,3005,8973,2354,25.09,74.91,19.65
E02003014,Bristol 003,8296,1461,962,1396,1408,884,818,630,445,245,47,2423,5873,1367,29.21,70.79,16.48
E02003015,Bristol 004,6693,893,557,1444,1055,754,717,558,425,246,44,1450,5243,1273,21.66,78.34,19.02
E02003016,Bristol 005,8216,899,760,2491,1360,881,732,534,340,178,41,1659,6557,1093,20.19,79.81,13.3
E02003017,Bristol 006,6080,776,522,587,775,864,710,622,664,384,176,1298,4782,1846,21.35,78.65,30.36
E02003018,Bristol 007,5910,814,575,710,832,731,772,680,518,211,67,1389,4521,1476,23.5,76.5,24.97
E02003019,Bristol 008,9868,1285,839,1589,1520,1175,1307,943,747,362,101,2124,7744,2153,21.52,78.48,21.82
E02003020,Bristol 009,6510,787,804,739,538,855,748,683,678,444,234,1591,4919,2039,24.44,75.56,31.32
E02003021,Bristol 010,7554,953,482,2353,1298,813,603,451,327,204,70,1435,6119,1052,19.0,81.0,13.93
E02003022,Bristol 011,5903,900,553,529,599,791,762,703,587,398,81,1453,4450,1769,24.61,75.39,29.97
E02003023,Bristol 012,6664,692,496,1647,742,719,773,717,510,271,97,1188,5476,1595,17.83,82.17,23.93
E02003024,Bristol 013,9700,1255,780,2214,1438,1040,1018,769,619,387,180,2035,7665,1955,20.98,79.02,20.15
E02003025,Bristol 014,7601,1080,891,1342,1211,884,829,598,440,251,75,1971,5630,1364,25.93,74.07,17.95
E02003026,Bristol 015,9335,780,686,2652,673,940,1004,1007,899,546,148,1466,7869,2600,15.7,84.3,27.85
E02003027,Bristol 016,12743,1676,961,3382,2147,1618,1288,907,519,190,55,2637,10106,1671,20.69,79.31,13.11
E02003028,Bristol 017,8531,899,969,1862,1030,1098,1068,715,513,289,88,1868,6663,1605,21.9,78.1,18.81
E02003029,Bristol 018,6373,933,811,1014,964,842,753,504,337,167,48,1744,4629,1056,27.37,72.63,16.57
E02003030,Bristol 019,7791,971,626,1656,1395,1040,887,666,366,157,27,1597,6194,1216,20.5,79.5,15.61
E02003031,Bristol 020,10649,1015,977,3478,1548,1192,1140,734,388,138,39,1992,8657,1299,18.71,81.29,12.2
E02003032,Bristol 021,8127,1209,727,1574,1446,981,815,641,444,238,52,1936,6191,1375,23.82,76.18,16.92
E02003033,Bristol 022,8973,466,398,4735,1163,625,633,420,366,112,55,864,8109,953,9.63,90.37,10.62
E02003034,Bristol 023,13466,1528,1115,4005,2944,1467,1177,713,336,159,22,2643,10823,1230,19.63,80.37,9.13
E02003036,Bristol 025,10306,557,398,5367,1758,750,618,431,240,135,52,955,9351,858,9.27,90.73,8.33
E02003037,Bristol 026,9013,462,326,4433,1506,688,593,469,317,177,42,788,8225,1005,8.74,91.26,11.15
E02003038,Bristol 027,6512,862,513,1132,1148,797,802,553,426,232,47,1375,5137,1258,21.11,78.89,19.32
E02003039,Bristol 028,8750,1157,704,1678,1576,1098,1030,679,536,226,66,1861,6889,1507,21.27,78.73,17.22
E02003040,Bristol 029,9888,1224,513,1994,2553,1332,938,559,404,279,92,1737,8151,1334,17.57,82.43,13.49
E02003041,Bristol 030,6152,358,433,2302,854,531,528,473,434,210,29,791,5361,1146,12.86,87.14,18.63
E02003043,Bristol 032,18949,572,357,13030,2434,894,649,456,409,131,17,929,18020,1013,4.9,95.1,5.35
E02003044,Bristol 033,5773,740,447,912,925,745,726,533,491,236,18,1187,4586,1278,20.56,79.44,22.14
E02003045,Bristol 034,7427,335,340,3768,854,561,549,498,389,118,15,675,6752,1020,9.09,90.91,13.73
E02003046,Bristol 035,9838,1333,694,1730,2168,1332,1096,709,490,219,67,2027,7811,1485,20.6,79.4,15.09
E02003047,Bristol 036,11101,1273,674,2944,2105,1398,1105,753,465,299,85,1947,9154,1602,17.54,82.46,14.43
E02003048,Bristol 037,7102,808,389,1640,1766,990,677,469,247,96,20,1197,5905,832,16.85,83.15,11.72
E02003049,Bristol 038,7618,1048,584,1194,1242,975,909,665,655,285,61,1632,5986,1666,21.42,78.58,21.87
E02003050,Bristol 039,9949,835,411,2836,2454,1049,874,679,447,290,74,1246,8703,1490,12.52,87.48,14.98
E02003051,Bristol 040,7415,1172,594,1641,1558,943,690,420,273,108,16,1766,5649,817,23.82,76.18,11.02
E02003052,Bristol 041,6843,860,489,1225,1368,910,697,563,457,215,59,1349,5494,1294,19.71,80.29,18.91
E02003053,Bristol 042,8195,1058,737,1203,1273,1174,1032,801,546,283,88,1795,6400,1718,21.9,78.1,20.96
E02003054,Bristol 043,6576,865,517,1091,1063,847,867,623,471,187,45,1382,5194,1326,21.02,78.98,20.16
E02003055,Bristol 044,8418,1334,1114,1391,1308,983,956,660,420,226,26,2448,5970,1332,29.08,70.92,15.82
E02003056,Bristol 045,7536,1227,914,1252,1028,874,840,730,443,202,26,2141,5395,1401,28.41,71.59,18.59
E02003057,Bristol 046,5932,740,483,911,923,690,708,606,514,281,76,1223,4709,1477,20.62,79.38,24.9
E02003058,Bristol 047,9051,1281,807,1478,1338,900,1069,925,741,398,114,2088,6963,2178,23.07,76.93,24.06
E02003059,Bristol 048,6144,933,567,1012,877,671,724,602,378,314,66,1500,4644,1360,24.41,75.59,22.14
E02003060,Bristol 049,10559,1269,900,1562,1345,1167,1355,1163,1030,621,147,2169,8390,2961,20.54,79.46,28.04
E02003061,Bristol 050,6054,1058,675,983,850,572,702,578,367,221,48,1733,4321,1214,28.63,71.37,20.05
E02003062,Bristol 051,5889,938,661,950,857,605,701,511,329,285,52,1599,4290,1177,27.15,72.85,19.99
E02003063,Bristol 052,6807,766,534,863,863,682,868,929,843,402,57,1300,5507,2231,19.1,80.9,32.78
E02003064,Bristol 053,7133,1429,836,1257,978,647,850,530,316,256,34,2265,4868,1136,31.75,68.25,15.93
E02006887,Bristol 054,9713,935,493,4144,2052,786,639,364,200,73,27,1428,8285,664,14.7,85.3,6.84
E02006888,Bristol 055,7242,1314,776,1351,1382,964,663,398,199,149,46,2090,5152,792,28.86,71.14,10.94
E02006889,Bristol 056,8202,1829,1033,1454,1370,939,650,451,275,175,26,2862,5340,927,34.89,65.11,11.3
E02006890,Bristol 057,8856,1351,773,1672,1882,1236,936,486,312,182,26,2124,6732,1006,23.98,76.02,11.36
E02003065,North Somerset 001,9886,1072,761,1097,1263,1373,1348,1115,1149,572,136,1833,8053,2972,18.54,81.46,30.06
E02003066,North Somerset 002,6175,600,539,483,513,749,993,952,918,343,85,1139,5036,2298,18.45,81.55,37.21
E02003067,North Somerset 003,7938,1110,861,756,934,1322,1003,786,732,348,86,1971,5967,1952,24.83,75.17,24.59
E02003068,North Somerset 004,6289,600,578,720,670,804,931,776,785,330,95,1178,5111,1986,18.73,81.27,31.58
E02003069,North Somerset 005,5611,465,465,473,447,673,886,801,776,490,135,930,4681,2202,16.57,83.43,39.24
E02003070,North Somerset 006,13631,1953,1376,968,1563,2262,1821,1485,1385,689,129,3329,10302,3688,24.42,75.58,27.06
E02003071,North Somerset 007,8103,808,669,835,898,1030,1198,1014,891,585,175,1477,6626,2665,18.23,81.77,32.89
E02003072,North Somerset 008,9125,879,731,901,866,1008,1314,1193,1324,785,124,1610,7515,3426,17.64,82.36,37.55
E02003073,North Somerset 009,6421,607,622,604,579,812,994,902,906,313,82,1229,5192,2203,19.14,80.86,34.31
E02003074,North Somerset 010,7728,931,638,927,1081,913,1110,984,727,342,75,1569,6159,2128,20.3,79.7,27.54
E02003075,North Somerset 011,6049,730,696,516,478,865,986,723,700,303,52,1426,4623,1778,23.57,76.43,29.39
E02003076,North Somerset 012,9434,1056,924,906,960,1254,1484,1199,1083,478,90,1980,7454,2850,20.99,79.01,30.21
E02003077,North Somerset 013,6182,660,570,601,605,844,954,798,737,381,32,1230,4952,1948,19.9,80.1,31.51
E02003078,North Somerset 014,7195,726,680,773,673,888,1102,961,966,360,66,1406,5789,2353,19.54,80.46,32.7
E02003079,North Somerset 015,9339,1167,919,1147,1121,1218,1368,1181,845,316,57,2086,7253,2399,22.34,77.66,25.69
E02003080,North Somerset 016,8750,874,808,879,897,936,1137,1123,1330,628,138,1682,7068,3219,19.22,80.78,36.79
E02003081,North Somerset 017,9463,938,785,938,932,1127,1429,1227,1351,604,132,1723,7740,3314,18.21,81.79,35.02
E02003082,North Somerset 018,9229,662,413,1295,1134,1091,1474,1163,1088,671,238,1075,8154,3160,11.65,88.35,34.24
E02003084,North Somerset 020,10643,1131,753,1657,1525,1368,1521,1090,877,554,167,1884,8759,2688,17.7,82.3,25.26
E02003085,North Somerset 021,7930,1181,888,1193,1073,964,1154,716,480,244,37,2069,5861,1477,26.09,73.91,18.63
E02003086,North Somerset 022,6178,497,416,787,604,776,949,764,686,508,191,913,5265,2149,14.78,85.22,34.78
E02003087,North Somerset 023,10220,1071,861,853,1105,1189,1442,1498,1499,618,84,1932,8288,3699,18.9,81.1,36.19
E02003088,North Somerset 024,8444,769,828,833,621,956,1257,1230,1194,577,179,1597,6847,3180,18.91,81.09,37.66
E02003089,North Somerset 025,5943,644,563,640,592,616,854,780,821,360,73,1207,4736,2034,20.31,79.69,34.23
E02006845,North Somerset 026,9897,1477,990,1293,1592,1420,1147,884,672,320,102,2467,7430,1978,24.93,75.07,19.99
E02006846,North Somerset 027,9249,1739,1030,1628,1685,1284,955,506,288,117,17,2769,6480,928,29.94,70.06,10.03
E02003090,South Gloucestershire 001,8162,927,794,899,1074,1083,1058,882,905,445,95,1721,6441,2327,21.09,78.91,28.51
E02003091,South Gloucestershire 002,6658,678,620,706,746,790,1023,772,835,415,73,1298,5360,2095,19.5,80.5,31.47
E02003092,South Gloucestershire 003,8220,827,813,866,837,1215,1570,1020,739,295,38,1640,6580,2092,19.95,80.05,25.45
E02003093,South Gloucestershire 004,6461,577,538,587,528,704,1033,923,948,515,108,1115,5346,2494,17.26,82.74,38.6
E02003094,South Gloucestershire 005,8934,1086,917,1055,1060,1160,1352,1013,843,357,91,2003,6931,2304,22.42,77.58,25.79
E02003095,South Gloucestershire 006,7536,799,700,982,901,1015,1214,898,704,278,45,1499,6037,1925,19.89,80.11,25.54
E02003096,South Gloucestershire 007,6294,710,556,968,914,718,945,630,596,212,45,1266,5028,1483,20.11,79.89,23.56
E02003097,South Gloucestershire 008,6443,621,549,634,675,735,899,812,954,453,111,1170,5273,2330,18.16,81.84,36.16
E02003098,South Gloucestershire 009,10306,1357,1052,1642,1907,1648,1441,740,385,117,17,2409,7897,1259,23.37,76.63,12.22
E02003099,South Gloucestershire 010,7466,950,658,920,991,864,987,808,803,424,61,1608,5858,2096,21.54,78.46,28.07
E02003100,South Gloucestershire 011,14077,2060,1132,2134,2523,1707,1706,1175,1040,503,97,3192,10885,2815,22.68,77.32,20.0
E02003101,South Gloucestershire 012,11287,1506,1124,1862,1970,1730,1621,801,435,159,79,2630,8657,1474,23.3,76.7,13.06
E02003102,South Gloucestershire 013,7021,914,732,744,713,936,1082,706,742,398,54,1646,5375,1900,23.44,76.56,27.06
E02003103,South Gloucestershire 014,7271,1087,728,1133,1201,895,932,646,512,118,19,1815,5456,1295,24.96,75.04,17.81
E02003104,South Gloucestershire 015,7600,897,604,1057,1052,981,1143,908,634,278,46,1501,6099,1866,19.75,80.25,24.55
E02003105,South Gloucestershire 016,6352,675,586,672,530,820,995,696,793,475,110,1261,5091,2074,19.85,80.15,32.65
E02003106,South Gloucestershire 017,15933,1548,1197,6215,1928,1637,1472,791,643,358,144,2745,13188,1936,17.23,82.77,12.15
E02003107,South Gloucestershire 018,11328,1139,761,2873,1700,1363,1186,860,863,470,113,1900,9428,2306,16.77,83.23,20.36
E02003108,South Gloucestershire 019,11249,1384,890,1553,1530,1328,1709,1215,1028,518,94,2274,8975,2855,20.22,79.78,25.38
E02003109,South Gloucestershire 020,6163,810,605,557,656,885,877,638,662,384,89,1415,4748,1773,22.96,77.04,28.77
E02003110,South Gloucestershire 021,12144,1783,1399,1559,1819,2056,1641,883,668,295,41,3182,8962,1887,26.2,73.8,15.54
E02003111,South Gloucestershire 022,6639,720,552,678,835,942,916,729,678,451,138,1272,5367,1996,19.16,80.84,30.06
E02003112,South Gloucestershire 023,6679,872,686,944,969,755,820,675,548,329,81,1558,5121,1633,23.33,76.67,24.45
E02003113,South Gloucestershire 024,10691,1078,1122,1016,1021,1254,1900,1483,1166,534,117,2200,8491,3300,20.58,79.42,30.87
E02003114,South Gloucestershire 025,7179,805,507,964,976,831,982,747,730,552,85,1312,5867,2114,18.28,81.72,29.45
E02003115,South Gloucestershire 026,9965,1206,836,1551,1639,1336,1164,952,742,415,124,2042,7923,2233,20.49,79.51,22.41
E02003116,South Gloucestershire 027,7786,965,649,1217,1120,887,939,760,705,465,79,1614,6172,2009,20.73,79.27,25.8
E02003117,South Gloucestershire 028,9408,1330,804,1378,1477,1178,1205,867,739,358,72,2134,7274,2036,22.68,77.32,21.64
E02003118,South Gloucestershire 029,10115,1120,840,1511,1524,1297,1609,1099,732,335,48,1960,8155,2214,19.38,80.62,21.89
E02003119,South Gloucestershire 030,10489,1256,1058,1426,1424,1251,1533,1166,867,421,87,2314,8175,2541,22.06,77.94,24.23
E02003120,South Gloucestershire 031,9220,1052,757,1099,1066,1154,1407,1008,962,610,105,1809,7411,2685,19.62,80.38,29.12
E02003121,South Gloucestershire 032,10017,1004,734,1099,1150,1171,1443,1454,1175,624,163,1738,8279,3416,17.35,82.65,34.1
E02003122,Plymouth 001,7043,740,533,700,746,743,996,1010,1042,443,90,1273,5770,2585,18.07,81.93,36.7
E02003123,Plymouth 002,8701,1270,792,1253,1099,930,1185,917,767,427,61,2062,6639,2172,23.7,76.3,24.96
E02003124,Plymouth 003,8059,1198,775,1202,1156,966,1054,750,578,322,58,1973,6086,1708,24.48,75.52,21.19
E02003125,Plymouth 004,6078,672,519,886,682,685,926,773,621,256,58,1191,4887,1708,19.6,80.4,28.1
E02003126,Plymouth 005,7912,912,663,1268,985,862,835,1244,789,267,87,1575,6337,2387,19.91,80.09,30.17
E02003127,Plymouth 006,7414,1015,828,1079,958,814,1005,744,648,284,39,1843,5571,1715,24.86,75.14,23.13
E02003128,Plymouth 007,8808,1177,781,1276,1177,1031,1210,947,773,362,74,1958,6850,2156,22.23,77.77,24.48
E02003129,Plymouth 008,6172,773,557,719,682,707,856,757,695,378,48,1330,4842,1878,21.55,78.45,30.43
E02003130,Plymouth 009,10417,1369,1044,1434,1382,1227,1433,1233,843,390,62,2413,8004,2528,23.16,76.84,24.27
E02003131,Plymouth 010,7327,887,673,1054,886,863,933,835,827,320,49,1560,5767,2031,21.29,78.71,27.72
E02003132,Plymouth 011,8956,1225,861,1148,1221,1120,1194,945,787,378,77,2086,6870,2187,23.29,76.71,24.42
E02003133,Plymouth 012,7165,832,625,950,833,768,1105,854,822,321,55,1457,5708,2052,20.33,79.67,28.64
E02003134,Plymouth 013,6776,932,681,949,1018,749,967,692,492,252,44,1613,5163,1480,23.8,76.2,21.84
E02003135,Plymouth 014,7670,1249,675,1375,1312,933,934,600,411,164,17,1924,5746,1192,25.08,74.92,15.54
E02003136,Plymouth 015,7728,732,682,734,706,960,1081,951,1090,642,150,1414,6314,2833,18.3,81.7,36.66
E02003137,Plymouth 016,7810,741,789,820,700,1022,1235,916,836,547,204,1530,6280,2503,19.59,80.41,32.05
E02003138,Plymouth 017,7536,935,675,1126,1199,1064,1100,679,467,238,53,1610,5926,1437,21.36,78.64,19.07
E02003139,Plymouth 018,6568,983,618,955,918,850,942,647,493,145,17,1601,4967,1302,24.38,75.62,19.82
E02003140,Plymouth 019,7667,845,781,857,896,1032,1129,798,766,469,94,1626,6041,2127,21.21,78.79,27.74
E02003141,Plymouth 020,7934,920,549,1392,1307,1030,1184,751,510,240,51,1469,6465,1552,18.52,81.48,19.56
E02003142,Plymouth 021,9105,1088,883,1344,1294,1123,1263,986,703,350,71,1971,7134,2110,21.65,78.35,23.17
E02003143,Plymouth 022,7346,876,637,924,988,808,990,974,745,308,96,1513,5833,2123,20.6,79.4,28.9
E02003144,Plymouth 023,8862,418,401,5079,832,600,523,426,313,200,70,819,8043,1009,9.24,90.76,11.39
E02003145,Plymouth 024,6827,652,549,1346,873,785,978,715,546,293,90,1201,5626,1644,17.59,82.41,24.08
E02003146,Plymouth 025,8754,890,618,3120,1184,987,792,537,407,185,34,1508,7246,1163,17.23,82.77,13.29
E02003147,Plymouth 026,9340,1482,889,1772,1487,1034,1125,821,527,175,28,2371,6969,1551,25.39,74.61,16.61
E02003148,Plymouth 027,10604,634,384,5289,1077,854,803,765,514,238,46,1018,9586,1563,9.6,90.4,14.74
E02003149,Plymouth 028,9506,1087,701,3007,1493,971,886,708,446,168,39,1788,7718,1361,18.81,81.19,14.32
E02003150,Plymouth 029,12363,1171,881,2861,1937,1403,1531,1235,812,430,102,2052,10311,2579,16.6,83.4,20.86
E02003151,Plymouth 030,7764,764,635,733,683,817,1100,992,1149,712,179,1399,6365,3032,18.02,81.98,39.05
E02003152,Plymouth 031,10420,1256,987,1052,1153,1336,1548,1242,1187,546,113,2243,8177,3088,21.53,78.47,29.64
E02003153,Plymouth 032,7468,901,606,944,854,820,1020,873,869,494,87,1507,5961,2323,20.18,79.82,31.11
E02003154,Torbay 001,7224,961,658,879,763,731,1051,848,849,438,46,1619,5605,2181,22.41,77.59,30.19
E02003155,Torbay 002,5780,527,514,636,534,709,814,750,758,426,112,1041,4739,2046,18.01,81.99,35.4
E02003156,Torbay 003,10570,1427,1016,1381,1381,1376,1460,1177,930,354,68,2443,8127,2529,23.11,76.89,23.93
E02003157,Torbay 004,6413,795,570,884,845,739,982,810,559,197,32,1365,5048,1598,21.28,78.72,24.92
E02003158,Torbay 005,5620,558,437,579,566,653,733,756,784,423,131,995,4625,2094,17.7,82.3,37.26
E02003159,Torbay 006,5833,832,506,837,740,753,847,579,470,214,55,1338,4495,1318,22.94,77.06,22.6
E02003161,Torbay 008,7609,813,622,1306,990,841,1143,982,557,288,67,1435,6174,1894,18.86,81.14,24.89
E02003163,Torbay 010,7844,377,319,627,527,786,1336,1417,1437,767,251,696,7148,3872,8.87,91.13,49.36
E02003164,Torbay 011,8822,801,678,827,860,991,1326,1269,1259,641,170,1479,7343,3339,16.76,83.24,37.85
E02003165,Torbay 012,7110,845,655,685,761,907,1069,892,818,382,96,1500,5610,2188,21.1,78.9,30.77
E02003166,Torbay 013,12052,1780,1314,1474,1459,1382,1654,1351,1123,439,76,3094,8958,2989,25.67,74.33,24.8
E02003167,Torbay 014,9545,888,559,1140,962,996,1518,1322,1168,774,218,1447,8098,3482,15.16,84.84,36.48
E02003168,Torbay 015,7147,614,575,731,593,746,1151,1069,1075,501,92,1189,5958,2737,16.64,83.36,38.3
E02003169,Torbay 016,6768,492,433,465,453,629,984,1251,1276,644,141,925,5843,3312,13.67,86.33,48.94
E02003170,Torbay 017,9459,691,653,830,662,916,1455,1625,1748,737,142,1344,8115,4252,14.21,85.79,44.95
E02003171,Torbay 018,7523,744,587,752,646,730,1173,1158,1078,511,144,1331,6192,2891,17.69,82.31,38.43
E02006840,Torbay 019,10945,1257,1061,1222,1147,1285,1584,1448,1291,512,138,2318,8627,3389,21.18,78.82,30.96
E02003212,Swindon 001,8119,788,659,824,708,1055,1213,1190,1091,504,87,1447,6672,2872,17.82,82.18,35.37
E02003214,Swindon 003,6215,1138,670,929,807,661,778,598,378,214,42,1808,4407,1232,29.09,70.91,19.82
E02003215,Swindon 004,6650,606,436,664,663,852,1086,934,967,384,58,1042,5608,2343,15.67,84.33,35.23
E02003216,Swindon 005,9257,980,815,1041,1087,1171,1444,1124,1040,473,82,1795,7462,2719,19.39,80.61,29.37
E02003217,Swindon 006,7125,1025,721,882,949,936,991,729,587,239,66,1746,5379,1621,24.51,75.49,22.75
E02003218,Swindon 007,6356,875,768,833,750,819,883,703,467,215,43,1643,4713,1428,25.85,74.15,22.47
E02003219,Swindon 008,9236,1369,895,929,1071,1323,1400,1107,731,324,87,2264,6972,2249,24.51,75.49,24.35
E02003220,Swindon 009,9999,1063,835,1116,1109,1201,1750,1167,907,711,140,1898,8101,2925,18.98,81.02,29.25
E02003221,Swindon 010,7094,924,606,1060,1184,1013,968,682,423,198,36,1530,5564,1339,21.57,78.43,18.88
E02003222,Swindon 011,5811,759,541,735,801,859,1067,644,289,111,5,1300,4511,1049,22.37,77.63,18.05
E02003223,Swindon 012,10550,1488,909,1560,1919,1577,1332,897,545,261,62,2397,8153,1765,22.72,77.28,16.73
E02003224,Swindon 013,8323,845,643,886,895,1007,1350,1102,958,543,94,1488,6835,2697,17.88,82.12,32.4
E02003225,Swindon 014,5951,767,512,762,851,784,1000,765,352,135,23,1279,4672,1275,21.49,78.51,21.42
E02003226,Swindon 015,10563,1476,972,1894,2020,1734,1245,689,366,148,19,2448,8115,1222,23.18,76.82,11.57
E02003227,Swindon 016,6713,1017,782,964,984,893,954,589,322,176,32,1799,4914,1119,26.8,73.2,16.67
E02003228,Swindon 017,7622,1047,757,984,1118,1126,1059,704,458,294,75,1804,5818,1531,23.67,76.33,20.09
E02003229,Swindon 018,5379,705,504,655,766,717,995,682,283,61,11,1209,4170,1037,22.48,77.52,19.28
E02003230,Swindon 019,8721,1146,577,1663,2151,1230,875,552,313,170,44,1723,6998,1079,19.76,80.24,12.37
E02003231,Swindon 020,8720,1345,1006,1214,1171,1097,1179,751,577,332,48,2351,6369,1708,26.96,73.04,19.59
E02003232,Swindon 021,8657,1048,811,1234,1433,1316,1226,768,506,242,73,1859,6798,1589,21.47,78.53,18.36
E02003233,Swindon 022,8598,1084,814,1038,1186,1085,1211,1128,704,283,65,1898,6700,2180,22.07,77.93,25.35
E02003234,Swindon 023,8125,885,723,943,917,1014,1286,1117,826,356,58,1608,6517,2357,19.79,80.21,29.01
E02003235,Swindon 024,9155,1170,711,1067,1396,1184,1205,984,810,494,134,1881,7274,2422,20.55,79.45,26.46
E02003236,Swindon 025,11866,1475,1065,1133,1272,1564,1730,1395,1333,711,188,2540,9326,3627,21.41,78.59,30.57
E02006847,Swindon 026,9628,1581,1205,1238,1498,1919,1197,537,292,122,39,2786,6842,990,28.94,71.06,10.28
E02006848,Swindon 027,8154,1423,927,1251,1629,1490,814,374,193,36,17,2350,5804,620,28.82,71.18,7.6
E02006849,Swindon 028,9606,1352,1112,1173,1304,1794,1453,758,445,172,43,2464,7142,1418,25.65,74.35,14.76
E02003237,Peterborough 001,5768,560,522,537,505,683,1021,829,701,348,62,1082,4686,1940,18.76,81.24,33.63
E02003238,Peterborough 002,5567,764,525,697,743,739,936,649,332,144,38,1289,4278,1163,23.15,76.85,20.89
E02003239,Peterborough 003,7374,814,595,751,772,892,1208,1031,839,381,91,1409,5965,2342,19.11,80.89,31.76
E02003240,Peterborough 004,6788,1172,626,900,899,856,946,650,502,208,29,1798,4990,1389,26.49,73.51,20.46
E02003241,Peterborough 005,6575,922,622,737,782,845,983,748,665,231,40,1544,5031,1684,23.48,76.52,25.61
E02003242,Peterborough 006,7953,991,585,801,994,863,1168,994,924,512,121,1576,6377,2551,19.82,80.18,32.08
E02003243,Peterborough 007,10631,2015,1139,1464,1754,1378,1181,876,491,279,54,3154,7477,1700,29.67,70.33,15.99
E02003244,Peterborough 008,9463,1605,951,1234,1477,1137,1149,777,629,430,74,2556,6907,1910,27.01,72.99,20.18
E02003245,Peterborough 009,7836,1358,921,1147,1319,1064,785,655,394,155,38,2279,5557,1242,29.08,70.92,15.85
E02003246,Peterborough 010,10050,1535,1149,1788,1864,1438,1072,616,368,196,24,2684,7366,1204,26.71,73.29,11.98
E02003247,Peterborough 011,8370,1264,878,1105,1275,1083,1024,809,645,256,31,2142,6228,1741,25.59,74.41,20.8
E02003248,Peterborough 012,11222,1721,1434,1908,1648,1571,1214,819,465,332,110,3155,8067,1726,28.11,71.89,15.38
E02003249,Peterborough 013,12090,2133,1283,1670,2094,1467,1389,961,687,353,53,3416,8674,2054,28.25,71.75,16.99
E02003250,Peterborough 014,12470,1768,1230,2364,2534,1680,1217,845,415,300,117,2998,9472,1677,24.04,75.96,13.45
E02003251,Peterborough 015,7245,854,578,710,757,817,976,1032,910,479,132,1432,5813,2553,19.77,80.23,35.24
E02003252,Peterborough 016,12688,2312,1225,1969,2503,1808,1289,777,459,283,63,3537,9151,1582,27.88,72.12,12.47
E02003253,Peterborough 017,9839,1631,835,1494,1742,1245,1148,802,576,289,77,2466,7373,1744,25.06,74.94,17.73
E02003254,Peterborough 018,8600,1035,669,755,1055,1018,1351,1225,941,461,90,1704,6896,2717,19.81,80.19,31.59
E02003255,Peterborough 019,11673,1949,1017,1372,1858,1502,1389,1104,886,500,96,2966,8707,2586,25.41,74.59,22.15
E02003257,Peterborough 021,8933,1563,956,1274,1372,1140,1041,846,491,209,41,2519,6414,1587,28.2,71.8,17.77
E02006877,Peterborough 022,9725,1584,948,1392,1603,1360,1109,757,623,293,56,2532,7193,1729,26.04,73.96,17.78
E02006878,Peterborough 023,11399,2072,1523,1720,2050,1912,1199,480,230,147,66,3595,7804,923,31.54,68.46,8.1
E02003258,Luton 001,8257,1001,698,865,1063,981,1299,1055,855,358,82,1699,6558,2350,20.58,79.42,28.46
E02003259,Luton 002,6171,932,652,763,884,698,862,615,459,260,46,1584,4587,1380,25.67,74.33,22.36
E02003260,Luton 003,8314,1469,1059,1089,1233,1060,1031,703,483,164,23,2528,5786,1373,30.41,69.59,16.51
E02003261,Luton 004,5987,740,530,676,719,672,836,628,671,426,89,1270,4717,1814,21.21,78.79,30.3
E02003262,Luton 005,10128,1574,1116,1233,1422,1288,1343,959,700,396,97,2690,7438,2152,26.56,73.44,21.25
E02003263,Luton 006,12032,2065,1198,1692,1746,1450,1438,934,808,589,112,3263,8769,2443,27.12,72.88,20.3
E02003264,Luton 007,9248,1349,1044,1138,1236,1304,1236,886,568,394,93,2393,6855,1941,25.88,74.12,20.99
E02003265,Luton 008,7800,959,593,923,1146,855,1169,940,764,390,61,1552,6248,2155,19.9,80.1,27.63
E02003266,Luton 009,9173,1502,1166,1062,1302,1183,1310,770,462,343,73,2668,6505,1648,29.09,70.91,17.97
E02003267,Luton 010,13728,2590,1975,2166,2239,1916,1223,804,475,280,60,4565,9163,1619,33.25,66.75,11.79
E02003268,Luton 011,11834,2218,1567,1657,1956,1629,1164,754,484,327,78,3785,8049,1643,31.98,68.02,13.88
E02003269,Luton 012,10304,1423,906,1505,1604,1303,1368,939,720,446,90,2329,7975,2195,22.6,77.4,21.3
E02003270,Luton 013,8154,1150,838,1111,1124,1027,1095,702,574,463,70,1988,6166,1809,24.38,75.62,22.19
E02003271,Luton 014,9621,1325,840,1264,1583,1308,1487,1013,529,223,49,2165,7456,1814,22.5,77.5,18.85
E02003272,Luton 015,10251,1947,1442,1607,1817,1345,853,665,314,229,32,3389,6862,1240,33.06,66.94,12.1
E02003273,Luton 016,10797,1640,1289,1416,1768,1391,1368,960,581,321,63,2929,7868,1925,27.13,72.87,17.83
E02003274,Luton 017,11281,2360,1415,1749,2252,1536,829,561,313,222,44,3775,7506,1140,33.46,66.54,10.11
E02003275,Luton 018,15836,2324,1195,4190,3591,1843,1264,751,382,238,58,3519,12317,1429,22.22,77.78,9.02
E02003276,Luton 019,9089,1746,1139,1458,1860,1175,741,510,245,170,45,2885,6204,970,31.74,68.26,10.67
E02003277,Luton 020,11030,1933,1324,1664,1812,1398,1189,877,459,311,63,3257,7773,1710,29.53,70.47,15.5
E02003278,Luton 021,14017,2151,1103,3271,2907,1769,1366,753,439,214,44,3254,10763,1450,23.21,76.79,10.34
E02003279,Southend-on-Sea 001,9511,997,785,978,1017,1182,1372,1180,1217,644,139,1782,7729,3180,18.74,81.26,33.43
E02003280,Southend-on-Sea 002,10451,1179,1001,1183,1218,1330,1491,1290,1105,526,128,2180,8271,3049,20.86,79.14,29.17
E02003281,Southend-on-Sea 003,9626,897,830,884,973,1152,1378,1255,1390,663,204,1727,7899,3512,17.94,82.06,36.48
E02003282,Southend-on-Sea 004,10644,1279,1097,1196,1208,1443,1526,1190,1058,513,134,2376,8268,2895,22.32,77.68,27.2
E02003283,Southend-on-Sea 005,11142,1370,1170,1240,1454,1537,1490,1251,973,506,151,2540,8602,2881,22.8,77.2,25.86
E02003284,Southend-on-Sea 006,11325,1564,1159,1463,1622,1539,1666,1147,746,343,76,2723,8602,2312,24.04,75.96,20.42
E02003285,Southend-on-Sea 007,11191,1739,1086,1741,1903,1646,1456,907,500,180,33,2825,8366,1620,25.24,74.76,14.48
E02003286,Southend-on-Sea 008,9442,1165,896,875,1037,1481,1375,1070,947,465,131,2061,7381,2613,21.83,78.17,27.67
E02003287,Southend-on-Sea 009,10083,1213,991,1085,1166,1249,1381,1103,1082,652,161,2204,7879,2998,21.86,78.14,29.73
E02003288,Southend-on-Sea 010,12889,2025,1324,2039,2039,1803,1580,962,665,341,111,3349,9540,2079,25.98,74.02,16.13
E02003289,Southend-on-Sea 011,10465,1358,866,1172,1552,1797,1457,957,779,415,112,2224,8241,2263,21.25,78.75,21.62
E02003290,Southend-on-Sea 012,10517,1156,755,1305,1531,1621,1424,1093,765,582,285,1911,8606,2725,18.17,81.83,25.91
E02003291,Southend-on-Sea 013,11994,1534,1174,1572,1453,1606,1747,1320,1128,415,45,2708,9286,2908,22.58,77.42,24.25
E02003292,Southend-on-Sea 014,12343,1804,1125,2047,2027,1784,1580,1045,615,250,66,2929,9414,1976,23.73,76.27,16.01
E02003293,Southend-on-Sea 015,11703,1294,787,2162,1929,1659,1495,931,808,496,142,2081,9622,2377,17.78,82.22,20.31
E02003294,Southend-on-Sea 016,9274,876,733,941,851,1155,1397,1195,1270,688,168,1609,7665,3321,17.35,82.65,35.81
E02003295,Southend-on-Sea 017,10525,1357,1152,1214,1174,1304,1542,1170,1016,474,122,2509,8016,2782,23.84,76.16,26.43
E02003296,Thurrock 001,6804,692,617,768,675,861,1040,936,825,353,37,1309,5495,2151,19.24,80.76,31.61
E02003297,Thurrock 002,7163,859,732,884,857,871,937,799,781,375,68,1591,5572,2023,22.21,77.79,28.24
E02003298,Thurrock 003,6816,765,596,853,787,837,996,788,752,380,62,1361,5455,1982,19.97,80.03,29.08
E02003299,Thurrock 004,5989,636,522,718,587,781,1041,754,617,285,48,1158,4831,1704,19.34,80.66,28.45
E02003300,Thurrock 005,8503,1233,791,1238,1238,1145,1022,841,683,287,25,2024,6479,1836,23.8,76.2,21.59
E02003301,Thurrock 006,11571,1785,1249,1613,1815,1598,1446,1042,729,235,59,3034,8537,2065,26.22,73.78,17.85
E02003302,Thurrock 007,10732,1720,1134,1559,1698,1524,1426,881,510,226,54,2854,7878,1671,26.59,73.41,15.57
E02003303,Thurrock 008,9187,1495,985,1203,1425,1238,1194,842,542,209,54,2480,6707,1647,26.99,73.01,17.93
E02003304,Thurrock 009,9784,1194,1096,1201,1169,1379,1307,1036,860,418,124,2290,7494,2438,23.41,76.59,24.92
E02003305,Thurrock 010,6708,939,659,725,858,919,829,763,650,305,61,1598,5110,1779,23.82,76.18,26.52
E02003307,Thurrock 012,10338,1588,1148,1369,1225,1215,1406,985,781,513,108,2736,7602,2387,26.47,73.53,23.09
E02003308,Thurrock 013,7234,1135,749,1022,1033,983,937,738,475,126,36,1884,5350,1375,26.04,73.96,19.01
E02003309,Thurrock 014,7632,975,690,915,1064,1041,1099,852,668,281,47,1665,5967,1848,21.82,78.18,24.21
E02003310,Thurrock 015,15282,2828,1503,2371,3361,2361,1525,806,379,132,16,4331,10951,1333,28.34,71.66,8.72
E02003311,Thurrock 016,9351,1294,797,1408,1823,1413,1183,659,456,251,67,2091,7260,1433,22.36,77.64,15.32
E02003312,Thurrock 017,10079,2017,902,1595,2262,1481,1027,447,246,91,11,2919,7160,795,28.96,71.04,7.89
E02003313,Thurrock 018,14748,2726,1912,2173,2191,1916,1713,1064,692,294,67,4638,10110,2117,31.45,68.55,14.35
E02006859,Thurrock 019,8163,1266,1089,1221,1474,1593,1006,313,155,38,8,2355,5808,514,28.85,71.15,6.3
E02006926,Thurrock 020,8257,1283,1049,1154,1278,1408,1138,545,287,102,13,2332,5925,947,28.24,71.76,11.47
E02003314,Medway 001,6375,699,488,751,645,686,1005,972,794,276,59,1187,5188,2101,18.62,81.38,32.96
E02003315,Medway 002,5593,672,534,645,641,779,841,673,577,211,20,1206,4387,1481,21.56,78.44,26.48
E02003316,Medway 003,10973,1568,1079,1352,1405,1513,1536,1127,983,359,51,2647,8326,2520,24.12,75.88,22.97
E02003317,Medway 004,6831,882,675,837,915,892,971,724,562,314,59,1557,5274,1659,22.79,77.21,24.29
E02003318,Medway 005,5974,683,501,758,677,727,967,725,617,285,34,1184,4790,1661,19.82,80.18,27.8
E02003319,Medway 006,8456,1237,839,1270,1414,1186,1073,695,467,236,39,2076,6380,1437,24.55,75.45,16.99
E02003320,Medway 007,9242,1235,826,2329,1413,1172,1069,654,376,140,28,2061,7181,1198,22.3,77.7,12.96
E02003321,Medway 008,6569,987,713,898,895,800,858,630,515,242,31,1700,4869,1418,25.88,74.12,21.59
E02003322,Medway 009,8305,1064,790,2644,1198,834,786,507,294,165,23,1854,6451,989,22.32,77.68,11.91
E02003323,Medway 010,7693,1208,899,1261,1163,971,1023,580,363,185,40,2107,5586,1168,27.39,72.61,15.18
E02003324,Medway 011,9862,1596,1058,1548,1696,1260,1104,801,547,223,29,2654,7208,1600,26.91,73.09,16.22
E02003325,Medway 012,7774,1254,765,1463,1412,1028,854,538,309,127,24,2019,5755,998,25.97,74.03,12.84
E02003326,Medway 013,8021,1129,899,1236,1162,1039,1092,706,524,183,51,2028,5993,1464,25.28,74.72,18.25
E02003327,Medway 014,7535,947,623,1431,1081,1003,1021,616,533,225,55,1570,5965,1429,20.84,79.16,18.96
E02003328,Medway 015,9827,1373,908,2174,1771,1268,1143,640,367,134,49,2281,7546,1190,23.21,76.79,12.11
E02003329,Medway 016,7139,1162,764,1177,1180,935,858,585,320,127,31,1926,5213,1063,26.98,73.02,14.89
E02003330,Medway 017,6746,923,745,945,994,985,893,639,424,179,19,1668,5078,1261,24.73,75.27,18.69
E02003331,Medway 018,8855,1119,898,1183,1137,936,1371,1015,743,365,88,2017,6838,2211,22.78,77.22,24.97
E02003332,Medway 019,6300,795,601,847,758,780,985,703,487,253,91,1396,4904,1534,22.16,77.84,24.35
E02003333,Medway 020,7457,1201,805,1285,1331,1000,870,484,299,152,30,2006,5451,965,26.9,73.1,12.94
E02003334,Medway 021,6179,860,692,968,957,833,808,503,342,167,49,1552,4627,1061,25.12,74.88,17.17
E02003335,Medway 022,7592,1420,952,1269,1216,1052,835,453,260,103,32,2372,5220,848,31.24,68.76,11.17
E02003336,Medway 023,6076,701,487,695,670,717,877,793,675,401,60,1188,4888,1929,19.55,80.45,31.75
E02003337,Medway 024,7231,826,731,1210,939,947,1019,682,511,297,69,1557,5674,1559,21.53,78.47,21.56
E02003338,Medway 025,7198,936,674,964,998,969,944,764,637,266,46,1610,5588,1713,22.37,77.63,23.8
E02003339,Medway 026,6491,757,640,777,784,778,1008,725,601,335,86,1397,5094,1747,21.52,78.48,26.91
E02003340,Medway 027,8003,1049,854,1135,965,1006,1171,879,570,303,71,1903,6100,1823,23.78,76.22,22.78
E02003341,Medway 028,6596,802,596,773,841,923,1013,716,674,231,27,1398,5198,1648,21.19,78.81,24.98
E02003342,Medway 029,6353,780,582,707,711,794,875,795,708,345,56,1362,4991,1904,21.44,78.56,29.97
E02003343,Medway 030,5914,511,547,616,521,730,910,844,840,322,73,1058,4856,2079,17.89,82.11,35.15
E02003344,Medway 031,7118,933,746,1058,906,920,975,886,481,187,26,1679,5439,1580,23.59,76.41,22.2
E02003345,Medway 032,6052,854,572,765,864,793,802,733,491,173,5,1426,4626,1402,23.56,76.44,23.17
E02003346,Medway 033,6950,845,695,867,826,871,987,743,713,339,64,1540,5410,1859,22.16,77.84,26.75
E02003347,Medway 034,6126,902,575,1016,986,811,886,517,319,93,21,1477,4649,950,24.11,75.89,15.51
E02003348,Medway 035,7781,774,679,812,744,953,1109,1130,1013,472,95,1453,6328,2710,18.67,81.33,34.83
E02003349,Medway 036,7288,913,699,849,873,934,892,859,855,345,69,1612,5676,2128,22.12,77.88,29.2
E02003350,Medway 037,6275,778,670,832,757,823,870,667,561,278,39,1448,4827,1545,23.08,76.92,24.62
E02003351,Medway 038,7806,1058,745,1045,1077,954,1086,830,742,235,34,1803,6003,1841,23.1,76.9,23.58
E02003352,Bracknell Forest 001,5861,509,576,551,485,826,1074,739,727,323,51,1085,4776,1840,18.51,81.49,31.39
E02003353,Bracknell Forest 002,10306,1274,898,1410,1484,1495,1636,1085,632,322,70,2172,8134,2109,21.08,78.92,20.46
E02003354,Bracknell Forest 003,9962,1146,1077,1153,1297,1641,1723,1003,561,271,90,2223,7739,1925,22.31,77.69,19.32
E02003355,Bracknell Forest 004,6749,913,779,904,1064,1012,909,566,331,210,61,1692,5057,1168,25.07,74.93,17.31
E02003356,Bracknell Forest 005,7279,794,916,764,852,1034,1179,824,512,337,67,1710,5569,1740,23.49,76.51,23.9
E02003357,Bracknell Forest 006,10204,1500,930,1454,1961,1454,1186,767,507,387,58,2430,7774,1719,23.81,76.19,16.85
E02003358,Bracknell Forest 007,11341,1505,1162,1728,1973,1725,1419,852,565,324,88,2667,8674,1829,23.52,76.48,16.13
E02003359,Bracknell Forest 008,6513,902,483,925,1270,981,957,609,262,92,32,1385,5128,995,21.27,78.73,15.28
E02003360,Bracknell Forest 009,11817,1921,1298,1516,2019,1793,1374,954,714,211,17,3219,8598,1896,27.24,72.76,16.04
E02003361,Bracknell Forest 010,7385,954,699,967,1126,1087,1058,749,487,216,42,1653,5732,1494,22.38,77.62,20.23
E02003362,Bracknell Forest 011,6826,1013,634,787,1134,980,877,731,501,145,24,1647,5179,1401,24.13,75.87,20.52
E02003363,Bracknell Forest 012,7263,641,1386,863,633,891,986,706,662,377,118,2027,5236,1863,27.91,72.09,25.65
E02003364,Bracknell Forest 013,6758,791,696,896,891,1024,1078,714,509,136,23,1487,5271,1382,22.0,78.0,20.45
E02003365,Bracknell Forest 014,6775,791,763,628,805,967,1052,821,603,286,59,1554,5221,1769,22.94,77.06,26.11
E02003366,Bracknell Forest 015,7510,849,584,1683,1053,885,986,763,449,209,49,1433,6077,1470,19.08,80.92,19.57
E02003367,West Berkshire 001,6451,745,947,607,516,939,1076,768,611,200,42,1692,4759,1621,26.23,73.77,25.13
E02003368,West Berkshire 002,5689,668,459,595,589,783,929,749,638,232,47,1127,4562,1666,19.81,80.19,29.28
E02003369,West Berkshire 003,6502,777,744,591,563,929,1084,792,616,327,79,1521,4981,1814,23.39,76.61,27.9
E02003370,West Berkshire 004,6661,719,620,676,681,941,1073,867,714,305,65,1339,5322,1951,20.1,79.9,29.29
E02003371,West Berkshire 005,5702,577,582,615,518,794,971,730,563,311,41,1159,4543,1645,20.33,79.67,28.85
E02003372,West Berkshire 006,7628,923,782,910,820,923,1169,928,747,366,60,1705,5923,2101,22.35,77.65,27.54
E02003373,West Berkshire 007,8661,1001,1395,930,796,1265,1364,849,713,281,67,2396,6265,1910,27.66,72.34,22.05
E02003374,West Berkshire 008,5557,661,510,764,729,756,846,739,381,137,34,1171,4386,1291,21.07,78.93,23.23
E02003375,West Berkshire 009,5890,740,559,680,689,842,901,704,485,251,39,1299,4591,1479,22.05,77.95,25.11
E02003376,West Berkshire 010,5847,681,489,629,656,739,891,724,674,301,63,1170,4677,1762,20.01,79.99,30.14
E02003377,West Berkshire 011,10336,1046,1569,1025,971,1356,1601,1360,951,395,62,2615,7721,2768,25.3,74.7,26.78
E02003378,West Berkshire 012,7827,884,610,899,928,1070,1049,915,844,466,162,1494,6333,2387,19.09,80.91,30.5
E02003379,West Berkshire 013,6912,973,566,1031,1086,951,937,592,470,239,67,1539,5373,1368,22.27,77.73,19.79
E02003380,West Berkshire 014,7816,927,721,1001,1030,1084,1184,957,628,244,40,1648,6168,1869,21.08,78.92,23.91
E02003381,West Berkshire 015,5929,788,643,604,698,920,880,627,509,199,61,1431,4498,1396,24.14,75.86,23.55
E02003382,West Berkshire 016,7972,1031,765,1069,982,1085,1233,757,647,312,91,1796,6176,1807,22.53,77.47,22.67
E02003383,West Berkshire 017,6789,916,743,763,836,1076,1073,737,434,186,25,1659,5130,1382,24.44,75.56,20.36
E02003384,West Berkshire 018,6512,702,631,632,553,852,1138,888,729,314,73,1333,5179,2004,20.47,79.53,30.77
E02003385,West Berkshire 019,10263,1328,697,1719,2063,1383,1190,852,641,317,73,2025,8238,1883,19.73,80.27,18.35
E02003386,West Berkshire 020,8238,1096,801,978,1113,1234,1115,840,718,271,72,1897,6341,1901,23.03,76.97,23.08
E02003387,West Berkshire 021,9452,1198,1060,969,944,1374,1318,1053,1004,460,72,2258,7194,2589,23.89,76.11,27.39
E02003388,West Berkshire 022,5816,675,646,520,557,891,900,697,610,268,52,1321,4495,1627,22.71,77.29,27.97
E02003389,Reading 001,7404,925,802,761,673,1123,1060,796,798,382,84,1727,5677,2060,23.33,76.67,27.82
E02003390,Reading 002,7147,877,906,533,533,1151,1195,849,682,347,74,1783,5364,1952,24.95,75.05,27.31
E02003391,Reading 003,8001,1175,912,712,846,1229,1087,816,686,417,121,2087,5914,2040,26.08,73.92,25.5
E02003392,Reading 004,7839,1154,634,1250,1394,1145,937,600,423,242,60,1788,6051,1325,22.81,77.19,16.9
E02003393,Reading 005,7480,994,695,845,829,972,1171,859,690,343,82,1689,5791,1974,22.58,77.42,26.39
E02003394,Reading 006,7973,1450,948,1046,1150,1046,969,668,399,251,46,2398,5575,1364,30.08,69.92,17.11
E02003395,Reading 007,10186,1712,869,1929,2129,1497,1089,520,286,123,32,2581,7605,961,25.34,74.66,9.43
E02003396,Reading 008,9124,1402,790,1374,1630,1315,1163,686,454,258,52,2192,6932,1450,24.02,75.98,15.89
E02003397,Reading 009,7387,1141,792,847,830,878,1040,746,661,348,104,1933,5454,1859,26.17,73.83,25.17
E02003398,Reading 010,10571,1498,825,2593,2009,1496,1011,561,410,145,23,2323,8248,1139,21.98,78.02,10.77
E02003399,Reading 011,14683,1849,718,4297,3627,1996,1088,599,391,103,15,2567,12116,1108,17.48,82.52,7.55
E02003400,Reading 012,8163,802,622,2957,1097,884,761,460,295,207,78,1424,6739,1040,17.44,82.56,12.74
E02003401,Reading 013,8697,1309,676,1361,1512,1242,982,717,442,355,101,1985,6712,1615,22.82,77.18,18.57
E02003402,Reading 014,10450,1130,725,3256,1973,1335,931,558,339,171,32,1855,8595,1100,17.75,82.25,10.53
E02003403,Reading 015,8641,1318,852,1010,1050,1118,1234,847,716,410,86,2170,6471,2059,25.11,74.89,23.83
E02003404,Reading 016,9550,836,744,4563,904,723,656,490,369,212,53,1580,7970,1124,16.54,83.46,11.77
E02003405,Reading 017,11362,1855,1280,1978,1993,1411,1355,801,445,211,33,3135,8227,1490,27.59,72.41,13.11
E02003406,Reading 018,7122,997,795,987,927,889,1040,781,460,200,46,1792,5330,1487,25.16,74.84,20.88
E02003407,Slough 001,10070,1897,1400,1294,1487,1446,1249,690,314,242,51,3297,6773,1297,32.74,67.26,12.88
E02003408,Slough 002,10982,2003,1319,1354,1849,1604,1199,919,456,246,33,3322,7660,1654,30.25,69.75,15.06
E02003409,Slough 003,9957,1533,1090,1333,1605,1505,1330,843,458,219,41,2623,7334,1561,26.34,73.66,15.68
E02003410,Slough 004,11545,1982,1600,1604,1883,1610,1163,928,474,247,54,3582,7963,1703,31.03,68.97,14.75
E02003411,Slough 005,11329,1873,1389,1682,1821,1648,1150,857,498,314,97,3262,8067,1766,28.79,71.21,15.59
E02003412,Slough 006,9820,1538,1137,1183,1508,1530,1248,806,576,243,51,2675,7145,1676,27.24,72.76,17.07
E02003413,Slough 007,13401,2377,1447,1973,2612,1946,1295,968,478,254,51,3824,9577,1751,28.54,71.46,13.07
E02003414,Slough 008,13196,2507,1580,1612,2424,2078,1387,887,514,164,43,4087,9109,1608,30.97,69.03,12.19
E02003415,Slough 009,12962,2475,1366,1993,2679,1871,1128,740,409,225,76,3841,9121,1450,29.63,70.37,11.19
E02003416,Slough 010,9270,1542,987,1127,1568,1431,1104,742,474,249,46,2529,6741,1511,27.28,72.72,16.3
E02003417,Slough 011,11500,1912,1099,1568,2227,1813,1234,863,472,266,46,3011,8489,1647,26.18,73.82,14.32
E02003418,Slough 012,10116,1589,1301,1206,1516,1739,1214,854,389,235,73,2890,7226,1551,28.57,71.43,15.33
E02003419,Slough 013,8843,1405,1054,1114,1350,1366,1083,685,500,239,47,2459,6384,1471,27.81,72.19,16.63
E02003420,Slough 014,6548,1086,624,895,1260,1041,803,467,240,114,18,1710,4838,839,26.11,73.89,12.81
E02003421,Windsor and Maidenhead 001,5606,647,595,559,648,797,815,631,542,311,61,1242,4364,1545,22.15,77.85,27.56
E02003422,Windsor and Maidenhead 002,11452,1319,1113,876,1055,1646,1983,1383,1278,629,170,2432,9020,3460,21.24,78.76,30.21
E02003423,Windsor and Maidenhead 003,6470,946,748,739,899,956,822,609,494,211,46,1694,4776,1360,26.18,73.82,21.02
E02003424,Windsor and Maidenhead 004,8960,1024,718,893,1160,1317,1295,992,926,504,131,1742,7218,2553,19.44,80.56,28.49
E02003425,Windsor and Maidenhead 005,13103,2008,1086,1884,2691,1879,1385,933,679,435,123,3094,10009,2170,23.61,76.39,16.56
E02003426,Windsor and Maidenhead 006,9786,1071,1158,1017,1022,1601,1563,990,747,454,163,2229,7557,2354,22.78,77.22,24.05
E02003427,Windsor and Maidenhead 007,8220,1270,930,967,1403,1255,964,614,493,263,61,2200,6020,1431,26.76,73.24,17.41
E02003428,Windsor and Maidenhead 008,9128,1271,948,945,1129,1318,1305,1024,833,306,49,2219,6909,2212,24.31,75.69,24.23
E02003429,Windsor and Maidenhead 009,7672,861,861,754,788,1130,1150,897,780,357,94,1722,5950,2128,22.45,77.55,27.74
E02003430,Windsor and Maidenhead 010,7065,600,1188,963,956,924,1076,650,409,251,48,1788,5277,1358,25.31,74.69,19.22
E02003431,Windsor and Maidenhead 011,6767,830,649,733,922,1027,1040,679,543,255,89,1479,5288,1566,21.86,78.14,23.14
E02003432,Windsor and Maidenhead 012,7229,913,629,1040,1230,1197,892,535,434,284,75,1542,5687,1328,21.33,78.67,18.37
E02003433,Windsor and Maidenhead 013,6624,943,544,811,885,813,820,633,680,412,83,1487,5137,1808,22.45,77.55,27.29
E02003434,Windsor and Maidenhead 014,9113,1228,898,1113,1278,1262,1267,836,650,417,164,2126,6987,2067,23.33,76.67,22.68
E02003435,Windsor and Maidenhead 015,7212,924,791,737,899,1219,1089,628,602,278,45,1715,5497,1553,23.78,76.22,21.53
E02003436,Windsor and Maidenhead 016,8551,821,809,928,784,1203,1419,1048,917,493,129,1630,6921,2587,19.06,80.94,30.25
E02003437,Windsor and Maidenhead 017,7554,755,1011,814,632,1156,1238,836,701,309,102,1766,5788,1948,23.38,76.62,25.79
E02003438,Windsor and Maidenhead 018,10910,939,1682,971,876,1587,1802,1149,1047,655,202,2621,8289,3053,24.02,75.98,27.98
E02003439,Wokingham 001,5599,570,498,519,552,826,877,699,650,308,100,1068,4531,1757,19.07,80.93,31.38
E02003440,Wokingham 002,9268,1203,983,810,1123,1575,1301,923,818,435,97,2186,7082,2273,23.59,76.41,24.53
E02003441,Wokingham 003,7681,820,800,738,734,1073,1217,918,791,488,102,1620,6061,2299,21.09,78.91,29.93
E02003442,Wokingham 004,7851,1166,799,943,1063,1122,1269,736,499,203,51,1965,5886,1489,25.03,74.97,18.97
E02003443,Wokingham 005,7243,1103,707,777,1034,948,833,601,645,507,88,1810,5433,1841,24.99,75.01,25.42
E02003444,Wokingham 006,9814,1315,1093,1264,1350,1453,1284,893,670,408,84,2408,7406,2055,24.54,75.46,20.94
E02003445,Wokingham 007,8722,1214,796,912,1237,1196,1236,852,826,418,35,2010,6712,2131,23.05,76.95,24.43
E02003446,Wokingham 008,10145,921,1080,2368,978,1399,1327,887,782,326,77,2001,8144,2072,19.72,80.28,20.42
E02003447,Wokingham 009,10337,1455,1152,1251,1461,1729,1366,898,601,335,89,2607,7730,1923,25.22,74.78,18.6
E02003448,Wokingham 010,7465,960,822,668,898,1163,1098,822,672,294,68,1782,5683,1856,23.87,76.13,24.86
E02003449,Wokingham 011,7809,1027,848,957,1290,1315,1095,718,361,158,40,1875,5934,1277,24.01,75.99,16.35
E02003450,Wokingham 012,12338,1847,1251,1595,1970,1988,1492,1117,690,306,82,3098,9240,2195,25.11,74.89,17.79
E02003451,Wokingham 013,9086,1077,776,1026,1314,1352,1087,827,825,598,204,1853,7233,2454,20.39,79.61,27.01
E02003452,Wokingham 014,8573,1324,934,884,1118,1391,1162,748,647,309,56,2258,6315,1760,26.34,73.66,20.53
E02003453,Wokingham 015,6715,834,829,550,647,1053,1149,843,564,215,31,1663,5052,1653,24.77,75.23,24.62
E02003454,Wokingham 016,8801,1238,916,787,1139,1341,1164,915,757,395,149,2154,6647,2216,24.47,75.53,25.18
E02003455,Wokingham 017,8619,1342,800,847,1337,1239,1173,882,657,271,71,2142,6477,1881,24.85,75.15,21.82
E02003456,Wokingham 018,6984,980,892,824,902,1057,962,602,468,267,30,1872,5112,1367,26.8,73.2,19.57
E02003457,Wokingham 019,10005,1030,1141,932,869,1536,1752,1327,997,349,72,2171,7834,2745,21.7,78.3,27.44
E02003458,Wokingham 020,8064,825,1049,730,707,1163,1366,926,852,379,67,1874,6190,2224,23.24,76.76,27.58
E02003459,Milton Keynes 001,8372,958,867,689,762,1144,1315,1141,914,478,104,1825,6547,2637,21.8,78.2,31.5
E02003460,Milton Keynes 002,10764,1514,964,989,1421,1465,1529,1335,1043,424,80,2478,8286,2882,23.02,76.98,26.77
E02003461,Milton Keynes 003,7219,881,700,648,853,1006,850,948,824,377,132,1581,5638,2281,21.9,78.1,31.6
E02003462,Milton Keynes 004,7536,921,688,826,1072,1058,1066,944,603,292,66,1609,5927,1905,21.35,78.65,25.28
E02003463,Milton Keynes 005,6566,715,647,670,812,899,957,947,647,232,40,1362,5204,1866,20.74,79.26,28.42
E02003464,Milton Keynes 006,6695,1061,788,859,1036,899,845,690,386,113,18,1849,4846,1207,27.62,72.38,18.03
E02003465,Milton Keynes 007,6080,644,423,647,770,833,878,910,571,327,77,1067,5013,1885,17.55,82.45,31.0
E02003466,Milton Keynes 008,7717,1206,841,1151,1447,1031,907,586,329,195,24,2047,5670,1134,26.53,73.47,14.69
E02003467,Milton Keynes 009,6442,902,643,917,976,846,735,680,418,227,98,1545,4897,1423,23.98,76.02,22.09
E02003468,Milton Keynes 010,8310,1229,723,874,1263,1122,939,955,764,375,66,1952,6358,2160,23.49,76.51,25.99
E02003469,Milton Keynes 011,5552,676,468,613,781,717,791,842,477,165,22,1144,4408,1506,20.61,79.39,27.13
E02003470,Milton Keynes 012,5965,1128,925,792,852,796,613,502,271,71,15,2053,3912,859,34.42,65.58,14.4
E02003471,Milton Keynes 013,6566,820,734,920,1032,856,820,744,455,145,40,1554,5012,1384,23.67,76.33,21.08
E02003472,Milton Keynes 014,9827,1235,773,2169,2287,1488,936,586,226,107,20,2008,7819,939,20.43,79.57,9.56
E02003473,Milton Keynes 015,5448,703,521,628,834,788,765,624,422,123,40,1224,4224,1209,22.47,77.53,22.19
E02003474,Milton Keynes 016,8882,1256,1015,1104,1330,1479,1128,880,500,157,33,2271,6611,1570,25.57,74.43,17.68
E02003475,Milton Keynes 017,22727,4300,2726,3034,4599,3903,2100,1250,508,235,72,7026,15701,2065,30.91,69.09,9.09
E02003476,Milton Keynes 018,9086,1424,1094,1326,1586,1294,1062,699,394,167,40,2518,6568,1300,27.71,72.29,14.31
E02003477,Milton Keynes 019,15398,2584,1780,2046,2651,2459,1677,1010,752,362,77,4364,11034,2201,28.34,71.66,14.29
E02003478,Milton Keynes 020,6772,937,685,744,1004,1049,1018,700,421,162,52,1622,5150,1335,23.95,76.05,19.71
E02003479,Milton Keynes 021,7439,1143,861,1085,1366,1178,837,575,306,80,8,2004,5435,969,26.94,73.06,13.03
E02003480,Milton Keynes 022,8077,1127,844,1104,1188,1346,1283,717,355,98,15,1971,6106,1185,24.4,75.6,14.67
E02003481,Milton Keynes 023,8014,1425,947,1024,1306,1160,844,730,395,150,33,2372,5642,1308,29.6,70.4,16.32
E02003482,Milton Keynes 024,6724,793,692,668,726,1013,1081,827,557,301,66,1485,5239,1751,22.09,77.91,26.04
E02003483,Milton Keynes 025,11046,1604,1574,1322,1597,2150,1704,663,286,126,20,3178,7868,1095,28.77,71.23,9.91
E02003484,Milton Keynes 026,7061,977,757,900,978,1054,971,781,465,147,31,1734,5327,1424,24.56,75.44,20.17
E02003485,Milton Keynes 027,8040,1231,795,965,1011,1016,1045,812,768,346,51,2026,6014,1977,25.2,74.8,24.59
E02003486,Milton Keynes 028,9401,1346,1203,1080,1383,1807,1382,689,346,137,28,2549,6852,1200,27.11,72.89,12.76
E02003487,Milton Keynes 029,7258,979,743,796,885,838,919,874,803,351,70,1722,5536,2098,23.73,76.27,28.91
E02003488,Milton Keynes 030,7874,1102,791,1034,1125,941,956,821,691,333,80,1893,5981,1925,24.04,75.96,24.45
E02003489,Milton Keynes 031,7329,991,615,775,1028,908,1004,819,643,462,84,1606,5723,2008,21.91,78.09,27.4
E02003490,Milton Keynes 032,9270,1961,1205,1217,1499,1197,900,623,437,173,58,3166,6104,1291,34.15,65.85,13.93
E02003491,Brighton and Hove 001,7854,982,829,1098,900,1071,1227,739,630,294,84,1811,6043,1747,23.06,76.94,22.24
E02003492,Brighton and Hove 002,11708,640,620,6894,1075,764,691,470,327,200,27,1260,10448,1024,10.76,89.24,8.75
E02003493,Brighton and Hove 003,8223,932,747,1071,800,1036,1307,822,797,542,169,1679,6544,2330,20.42,79.58,28.34
E02003494,Brighton and Hove 004,6548,707,745,913,583,954,1121,710,507,262,46,1452,5096,1525,22.17,77.83,23.29
E02003495,Brighton and Hove 005,7083,905,630,1096,941,957,1031,638,600,244,41,1535,5548,1523,21.67,78.33,21.5
E02003496,Brighton and Hove 006,7517,915,768,1042,886,937,1067,732,676,407,87,1683,5834,1902,22.39,77.61,25.3
E02003497,Brighton and Hove 007,7646,925,824,918,687,1063,1232,837,681,353,126,1749,5897,1997,22.87,77.13,26.12
E02003498,Brighton and Hove 008,9078,963,816,2856,1075,956,1015,643,463,249,42,1779,7299,1397,19.6,80.4,15.39
E02003499,Brighton and Hove 009,8044,810,723,2642,891,754,935,556,441,238,54,1533,6511,1289,19.06,80.94,16.02
E02003500,Brighton and Hove 010,8227,887,1063,1714,812,1296,1327,639,323,127,39,1950,6277,1128,23.7,76.3,13.71
E02003501,Brighton and Hove 011,8797,897,864,1477,1255,1325,1301,740,539,293,106,1761,7036,1678,20.02,79.98,19.07
E02003502,Brighton and Hove 012,7685,1039,729,1101,1083,1056,1187,660,510,279,41,1768,5917,1490,23.01,76.99,19.39
E02003503,Brighton and Hove 013,8950,1145,968,1250,1074,1164,1359,869,659,367,95,2113,6837,1990,23.61,76.39,22.23
E02003504,Brighton and Hove 014,8769,778,690,2085,1463,1321,1120,653,396,199,64,1468,7301,1312,16.74,83.26,14.96
E02003505,Brighton and Hove 015,10365,685,475,4855,1470,1083,917,509,227,118,26,1160,9205,880,11.19,88.81,8.49
E02003506,Brighton and Hove 016,7212,1149,655,966,1185,1341,915,530,292,137,42,1804,5408,1001,25.01,74.99,13.88
E02003507,Brighton and Hove 017,9851,1194,894,1283,1088,1186,1517,1099,919,549,122,2088,7763,2689,21.2,78.8,27.3
E02003508,Brighton and Hove 018,9837,836,703,3904,1300,1150,969,514,304,132,25,1539,8298,975,15.65,84.35,9.91
E02003509,Brighton and Hove 019,9354,937,461,1991,1918,1513,1108,638,477,238,73,1398,7956,1426,14.95,85.05,15.24
E02003510,Brighton and Hove 020,8948,861,654,1658,1636,1385,1167,650,492,313,132,1515,7433,1587,16.93,83.07,17.74
E02003511,Brighton and Hove 021,8498,1143,867,1111,1163,1397,1265,719,506,251,76,2010,6488,1552,23.65,76.35,18.26
E02003512,Brighton and Hove 022,9928,842,617,3845,1476,1181,1012,539,284,107,25,1459,8469,955,14.7,85.3,9.62
E02003513,Brighton and Hove 023,6595,667,653,840,716,971,1100,677,534,322,115,1320,5275,1648,20.02,79.98,24.99
E02003514,Brighton and Hove 024,9560,581,383,2986,2217,1360,966,560,312,155,40,964,8596,1067,10.08,89.92,11.16
E02003515,Brighton and Hove 025,9170,1231,1041,1785,1186,1156,1247,701,511,268,44,2272,6898,1524,24.78,75.22,16.62
E02003516,Brighton and Hove 026,9096,557,342,2495,1930,1460,1023,618,414,204,53,899,8197,1289,9.88,90.12,14.17
E02003517,Brighton and Hove 027,12672,691,612,5404,2221,1412,1102,636,398,156,40,1303,11369,1230,10.28,89.72,9.71
E02003518,Brighton and Hove 028,8114,640,407,1447,1506,1221,1076,716,606,368,127,1047,7067,1817,12.9,87.1,22.39
E02003519,Brighton and Hove 029,9882,466,303,3393,2173,1423,1056,613,317,111,27,769,9113,1068,7.78,92.22,10.81
E02003520,Brighton and Hove 030,9421,712,441,2837,1766,1219,1055,710,445,198,38,1153,8268,1391,12.24,87.76,14.76
E02003521,Brighton and Hove 031,8402,481,635,2250,1158,1088,1064,722,591,309,104,1116,7286,1726,13.28,86.72,20.54
E02003522,Brighton and Hove 032,7717,633,643,1821,1010,906,1069,728,591,235,81,1276,6441,1635,16.53,83.47,21.19
E02003523,Brighton and Hove 033,10134,938,696,1144,961,1224,1664,1360,1296,646,205,1634,8500,3507,16.12,83.88,34.61
E02003524,Portsmouth 001,7965,1067,984,1354,979,962,1096,765,490,220,48,2051,5914,1523,25.75,74.25,19.12
E02003525,Portsmouth 002,6449,918,716,1132,954,727,853,580,368,177,24,1634,4815,1149,25.34,74.66,17.82
E02003526,Portsmouth 003,6717,672,614,716,625,759,943,865,826,545,152,1286,5431,2388,19.15,80.85,35.55
E02003527,Portsmouth 004,6328,850,571,964,854,726,856,637,571,252,47,1421,4907,1507,22.46,77.54,23.81
E02003529,Portsmouth 006,8304,1154,861,1184,1125,1122,1131,748,594,303,82,2015,6289,1727,24.27,75.73,20.8
E02003530,Portsmouth 007,7750,1003,787,1200,1039,924,996,777,634,325,65,1790,5960,1801,23.1,76.9,23.24
E02003531,Portsmouth 008,7712,743,668,1179,955,975,1292,840,678,332,50,1411,6301,1900,18.3,81.7,24.64
E02003532,Portsmouth 009,7617,990,694,1298,1176,969,1058,715,496,179,42,1684,5933,1432,22.11,77.89,18.8
E02003533,Portsmouth 010,5732,813,512,1038,843,781,732,479,326,178,30,1325,4407,1013,23.12,76.88,17.67
E02003534,Portsmouth 011,8999,1229,914,1531,1339,1195,1225,791,526,207,42,2143,6856,1566,23.81,76.19,17.4
E02003535,Portsmouth 012,9864,1513,1030,1929,1571,1231,1235,703,424,182,46,2543,7321,1355,25.78,74.22,13.74
E02003536,Portsmouth 013,8211,1331,852,1538,1136,973,883,726,507,224,41,2183,6028,1498,26.59,73.41,18.24
E02003537,Portsmouth 014,10335,1209,1076,1541,1395,1342,1535,1021,762,389,65,2285,8050,2237,22.11,77.89,21.64
E02003538,Portsmouth 015,10562,1434,897,2514,1978,1212,1162,658,467,191,49,2331,8231,1365,22.07,77.93,12.92
E02003539,Portsmouth 016,16422,1544,1075,7480,1970,1357,1209,878,591,262,56,2619,13803,1787,15.95,84.05,10.88
E02003540,Portsmouth 017,9693,1174,804,1584,1299,1105,1280,937,924,458,128,1978,7715,2447,20.41,79.59,25.25
E02003541,Portsmouth 018,12688,1436,915,5419,1399,1038,864,688,538,317,74,2351,10337,1617,18.53,81.47,12.74
E02003542,Portsmouth 019,9402,959,724,3217,1353,1038,858,575,420,209,49,1683,7719,1253,17.9,82.1,13.33
E02003543,Portsmouth 020,8854,619,502,3894,1064,873,796,563,328,161,54,1121,7733,1106,12.66,87.34,12.49
E02003544,Portsmouth 021,6365,857,518,1221,1126,795,869,479,329,147,24,1375,4990,979,21.6,78.4,15.38
E02003545,Portsmouth 022,7463,530,487,2318,1086,828,751,622,491,262,88,1017,6446,1463,13.63,86.37,19.6
E02003546,Portsmouth 023,8597,1122,595,1356,1257,1018,1202,901,704,355,87,1717,6880,2047,19.97,80.03,23.81
E02003547,Portsmouth 024,9527,635,563,2858,1281,974,964,815,827,491,119,1198,8329,2252,12.57,87.43,23.64
E02003548,Portsmouth 025,6774,570,539,1775,958,834,810,555,414,235,84,1109,5665,1288,16.37,83.63,19.01
E02006821,Portsmouth 026,6575,836,650,774,834,848,975,614,641,337,66,1486,5089,1658,22.6,77.4,25.22
E02003549,Southampton 001,8999,687,555,3749,768,773,857,719,547,257,87,1242,7757,1610,13.8,86.2,17.89
E02003550,Southampton 002,7737,1051,794,1125,925,998,946,922,709,217,50,1845,5892,1898,23.85,76.15,24.53
E02003551,Southampton 003,6964,650,491,2692,667,642,642,544,421,178,37,1141,5823,1180,16.38,83.62,16.94
E02003552,Southampton 004,5985,718,584,969,653,757,765,742,570,175,52,1302,4683,1539,21.75,78.25,25.71
E02003553,Southampton 005,7912,735,637,3504,947,680,567,437,262,115,28,1372,6540,842,17.34,82.66,10.64
E02003554,Southampton 006,6236,679,426,1216,914,702,688,619,553,309,130,1105,5131,1611,17.72,82.28,25.83
E02003555,Southampton 007,8175,1182,867,1356,1137,1020,901,864,539,260,49,2049,6126,1712,25.06,74.94,20.94
E02003556,Southampton 008,5834,792,553,829,738,694,839,574,493,284,38,1345,4489,1389,23.05,76.95,23.81
E02003557,Southampton 009,7125,624,346,2795,823,652,544,491,505,263,82,970,6155,1341,13.61,86.39,18.82
E02003558,Southampton 010,7052,1067,689,1226,1145,955,737,538,424,219,52,1756,5296,1233,24.9,75.1,17.48
E02003559,Southampton 011,7834,1029,774,1122,944,1036,1067,836,590,337,99,1803,6031,1862,23.02,76.98,23.77
E02003560,Southampton 012,7436,1277,865,1259,1084,859,783,691,355,206,57,2142,5294,1309,28.81,71.19,17.6
E02003561,Southampton 013,8583,720,456,3684,1102,773,666,516,385,212,69,1176,7407,1182,13.7,86.3,13.77
E02003562,Southampton 014,8491,1190,742,1397,1261,1153,1063,753,579,271,82,1932,6559,1685,22.75,77.25,19.84
E02003563,Southampton 015,7820,1122,671,1293,1225,1001,941,617,525,345,80,1793,6027,1567,22.93,77.07,20.04
E02003564,Southampton 016,7670,1117,713,1125,1016,862,997,756,637,358,89,1830,5840,1840,23.86,76.14,23.99
E02003565,Southampton 017,7518,489,252,3887,1072,647,504,288,206,103,70,741,6777,667,9.86,90.14,8.87
E02003566,Southampton 018,6089,817,567,814,810,632,794,701,569,301,84,1384,4705,1655,22.73,77.27,27.18
E02003567,Southampton 019,7675,1216,879,1219,1089,964,950,698,421,198,41,2095,5580,1358,27.3,72.7,17.69
E02003568,Southampton 020,8997,909,486,2845,1776,1074,771,589,319,176,52,1395,7602,1136,15.51,84.49,12.63
E02003569,Southampton 021,8011,1003,549,1843,1576,1008,921,615,334,136,26,1552,6459,1111,19.37,80.63,13.87
E02003570,Southampton 022,12217,1678,1161,4201,2003,1398,990,488,212,82,4,2839,9378,786,23.24,76.76,6.43
E02003571,Southampton 023,11109,500,221,7478,1106,581,364,333,237,215,74,721,10388,859,6.49,93.51,7.73
E02003572,Southampton 024,6100,852,572,823,830,732,856,631,501,260,43,1424,4676,1435,23.34,76.66,23.52
E02003573,Southampton 025,7536,1093,779,1100,971,756,1003,774,618,369,73,1872,5664,1834,24.84,75.16,24.34
E02003574,Southampton 026,7337,847,602,1030,862,859,1081,856,793,365,42,1449,5888,2056,19.75,80.25,28.02
E02003575,Southampton 027,6585,1177,738,1052,918,659,810,534,461,198,38,1915,4670,1231,29.08,70.92,18.69
E02003576,Southampton 028,8131,1201,788,1431,1162,1045,1065,684,511,200,44,1989,6142,1439,24.46,75.54,17.7
E02003577,Southampton 029,14201,1459,676,5772,2594,1410,1059,688,364,167,12,2135,12066,1231,15.03,84.97,8.67
E02003578,Southampton 030,6066,779,486,980,812,688,933,634,484,220,50,1265,4801,1388,20.85,79.15,22.88
E02003579,Southampton 031,9092,1263,731,1656,1417,1028,1130,836,584,349,98,1994,7098,1867,21.93,78.07,20.53
E02003580,Southampton 032,6003,1073,629,962,825,647,757,530,395,154,31,1702,4301,1110,28.35,71.65,18.49
E02003581,Isle of Wight 001,7885,900,638,1082,967,975,1180,936,746,359,102,1538,6347,2143,19.51,80.49,27.18
E02003582,Isle of Wight 002,8608,898,791,780,816,1053,1354,1172,1117,517,110,1689,6919,2916,19.62,80.38,33.88
E02003583,Isle of Wight 003,7434,762,663,787,828,826,1007,1062,1061,359,79,1425,6009,2561,19.17,80.83,34.45
E02003584,Isle of Wight 004,6468,494,471,1057,678,805,1040,901,703,251,68,965,5503,1923,14.92,85.08,29.73
E02003585,Isle of Wight 005,6782,484,519,615,469,670,1043,1149,1180,518,135,1003,5779,2982,14.79,85.21,43.97
E02003586,Isle of Wight 006,7868,879,760,863,733,937,1190,1027,973,407,99,1639,6229,2506,20.83,79.17,31.85
E02003587,Isle of Wight 007,8769,1149,850,1149,993,1150,1276,1000,802,327,73,1999,6770,2202,22.8,77.2,25.11
E02003588,Isle of Wight 008,8437,968,716,1164,1059,967,1263,998,820,377,105,1684,6753,2300,19.96,80.04,27.26
E02003589,Isle of Wight 009,8133,976,630,1413,1129,1027,1195,834,579,297,53,1606,6527,1763,19.75,80.25,21.68
E02003590,Isle of Wight 010,7460,475,519,542,462,705,1047,1275,1478,778,179,994,6466,3710,13.32,86.68,49.73
E02003591,Isle of Wight 011,9618,1073,969,1150,1054,1166,1361,1147,1095,466,137,2042,7576,2845,21.23,78.77,29.58
E02003592,Isle of Wight 012,9487,632,578,848,580,842,1373,1737,1817,865,215,1210,8277,4634,12.75,87.25,48.85
E02003593,Isle of Wight 013,5269,361,375,400,385,571,864,1004,850,385,74,736,4533,2313,13.97,86.03,43.9
E02003594,Isle of Wight 014,9430,900,759,1077,935,1023,1422,1419,1166,572,157,1659,7771,3314,17.59,82.41,35.14
E02003595,Isle of Wight 015,7906,623,496,698,583,758,1236,1445,1368,575,124,1119,6787,3512,14.15,85.85,44.42
E02003596,Isle of Wight 016,8949,803,583,1019,757,862,1422,1476,1245,607,175,1386,7563,3503,15.49,84.51,39.14
E02003597,Isle of Wight 017,5739,478,455,510,428,605,912,1005,901,378,67,933,4806,2351,16.26,83.74,40.97
E02003598,Isle of Wight 018,7529,537,574,695,600,765,1216,1314,1245,464,119,1111,6418,3142,14.76,85.24,41.73
E02004290,County Durham 002,5776,544,483,630,613,732,942,842,663,279,48,1027,4749,1832,17.78,82.22,31.72
E02004291,County Durham 005,7248,853,601,1006,1032,901,1101,817,614,267,56,1454,5794,1754,20.06,79.94,24.2
E02004292,County Durham 007,7883,761,612,897,775,910,1201,969,1108,566,84,1373,6510,2727,17.42,82.58,34.59
E02004293,County Durham 011,9758,1169,900,1445,1221,1139,1476,1026,825,438,119,2069,7689,2408,21.2,78.8,24.68
E02004294,County Durham 013,8317,677,681,975,795,1051,1497,1164,983,425,69,1358,6959,2641,16.33,83.67,31.75
E02004295,County Durham 015,7276,675,636,920,690,958,1157,998,842,354,46,1311,5965,2240,18.02,81.98,30.79
E02004296,County Durham 019,8364,895,712,1124,1057,990,1350,1087,782,326,41,1607,6757,2236,19.21,80.79,26.73
E02004297,County Durham 001,8125,846,663,958,986,994,1309,1034,869,390,76,1509,6616,2369,18.57,81.43,29.16
E02004298,County Durham 003,10060,995,837,1111,1104,1269,1636,1385,1089,541,93,1832,8228,3108,18.21,81.79,30.89
E02004299,County Durham 004,8538,937,731,1119,993,1044,1206,1226,851,342,89,1668,6870,2508,19.54,80.46,29.37
E02004300,County Durham 006,7867,1010,647,1049,961,886,1100,951,858,349,56,1657,6210,2214,21.06,78.94,28.14
E02004301,County Durham 008,9555,1279,1057,1463,1250,1122,1255,1034,698,337,60,2336,7219,2129,24.45,75.55,22.28
E02004302,County Durham 009,7840,1022,607,1126,990,970,1061,968,721,320,55,1629,6211,2064,20.78,79.22,26.33
E02004303,County Durham 010,11174,1107,910,1546,1399,1485,1754,1330,1079,472,92,2017,9157,2973,18.05,81.95,26.61
E02004304,County Durham 012,9245,1175,877,1168,1210,1121,1334,989,819,430,122,2052,7193,2360,22.2,77.8,25.53
E02004305,County Durham 014,9993,1376,927,1515,1346,1222,1367,1063,795,348,34,2303,7690,2240,23.05,76.95,22.42
E02004306,County Durham 020,5936,648,440,548,588,691,941,903,769,362,46,1088,4848,2080,18.33,81.67,35.04
E02004307,County Durham 024,6672,715,534,879,786,773,1096,900,618,310,61,1249,5423,1889,18.72,81.28,28.31
E02004308,County Durham 022,8210,700,558,790,1118,1188,1243,1181,1018,370,44,1258,6952,2613,15.32,84.68,31.83
E02004309,County Durham 023,6342,734,536,813,818,858,856,716,605,339,67,1270,5072,1727,20.03,79.97,27.23
E02004310,County Durham 026,7926,861,697,1060,990,959,1147,1048,797,325,42,1558,6368,2212,19.66,80.34,27.91
E02004311,County Durham 027,9182,1015,734,1081,1135,1092,1451,1257,970,376,71,1749,7433,2674,19.05,80.95,29.12
E02004312,County Durham 028,7429,693,514,730,829,857,978,1053,1151,545,79,1207,6222,2828,16.25,83.75,38.07
E02004313,County Durham 029,7876,684,570,2844,1012,674,726,569,514,249,34,1254,6622,1366,15.92,84.08,17.34
E02004314,County Durham 030,14473,175,151,11515,832,339,387,396,336,271,71,326,14147,1074,2.25,97.75,7.42
E02004315,County Durham 033,14775,1304,1267,5446,1577,1512,1327,1126,778,346,92,2571,12204,2342,17.4,82.6,15.85
E02004316,County Durham 031,6320,760,539,805,868,771,936,819,539,244,39,1299,5021,1641,20.55,79.45,25.97
E02004317,County Durham 038,7575,753,668,916,875,878,1154,1059,822,365,85,1421,6154,2331,18.76,81.24,30.77
E02004318,County Durham 041,6661,741,514,942,875,816,986,817,621,255,94,1255,5406,1787,18.84,81.16,26.83
E02004319,County Durham 044,7837,886,719,1043,988,965,1271,877,757,292,39,1605,6232,1965,20.48,79.52,25.07
E02004320,County Durham 016,8958,954,750,1062,1122,1110,1409,1192,801,473,85,1704,7254,2551,19.02,80.98,28.48
E02004321,County Durham 017,8559,986,749,1245,1141,973,1256,1143,649,363,54,1735,6824,2209,20.27,79.73,25.81
E02004322,County Durham 018,8517,1094,861,1239,1007,1014,1036,1053,814,343,56,1955,6562,2266,22.95,77.05,26.61
E02004323,County Durham 021,8066,943,670,1336,1060,939,1225,887,607,338,61,1613,6453,1893,20.0,80.0,23.47
E02004324,County Durham 025,5735,605,503,721,719,678,875,743,590,276,25,1108,4627,1634,19.32,80.68,28.49
E02004325,County Durham 032,8526,1144,857,1254,1087,1000,1243,940,602,325,74,2001,6525,1941,23.47,76.53,22.77
E02004326,County Durham 034,6856,929,621,1073,850,784,986,743,566,275,29,1550,5306,1613,22.61,77.39,23.53
E02004327,County Durham 036,5785,568,508,768,654,668,862,799,607,303,48,1076,4709,1757,18.6,81.4,30.37
E02004328,County Durham 035,7274,960,718,1069,896,906,988,740,614,331,52,1678,5596,1737,23.07,76.93,23.88
E02004329,County Durham 037,6393,548,556,829,618,763,1031,972,708,315,53,1104,5289,2048,17.27,82.73,32.04
E02004330,County Durham 039,5715,559,377,734,661,589,910,862,674,310,39,936,4779,1885,16.38,83.62,32.98
E02004331,County Durham 040,7287,897,609,1032,844,868,1143,794,738,317,45,1506,5781,1894,20.67,79.33,25.99
E02004332,County Durham 043,7353,893,684,924,899,890,1202,909,646,261,45,1577,5776,1861,21.45,78.55,25.31
E02004333,County Durham 047,6910,623,512,801,744,775,1055,1167,871,312,50,1135,5775,2400,16.43,83.57,34.73
E02004334,County Durham 048,7240,809,708,942,845,869,1180,901,675,258,53,1517,5723,1887,20.95,79.05,26.06
E02004335,County Durham 049,7369,1019,572,1176,1050,896,940,819,587,241,69,1591,5778,1716,21.59,78.41,23.29
E02004336,County Durham 050,6703,697,504,779,701,753,1045,970,825,372,57,1201,5502,2224,17.92,82.08,33.18
E02004337,County Durham 052,10003,1199,918,1265,1272,1319,1421,1269,874,397,69,2117,7886,2609,21.16,78.84,26.08
E02004338,County Durham 053,7106,760,639,992,816,835,1178,864,682,300,40,1399,5707,1886,19.69,80.31,26.54
E02004339,County Durham 054,6847,621,648,636,687,884,1050,905,980,367,69,1269,5578,2321,18.53,81.47,33.9
E02004340,County Durham 059,10335,1220,912,1424,1236,1176,1536,1306,954,504,67,2132,8203,2831,20.63,79.37,27.39
E02004341,County Durham 060,8671,892,744,1039,924,1040,1526,1212,931,286,77,1636,7035,2506,18.87,81.13,28.9
E02004342,County Durham 061,5766,952,672,911,768,650,708,476,356,212,61,1624,4142,1105,28.17,71.83,19.16
E02004343,County Durham 062,5504,616,500,744,647,599,837,671,532,323,35,1116,4388,1561,20.28,79.72,28.36
E02004344,County Durham 063,7130,775,594,860,724,708,1123,998,791,475,82,1369,5761,2346,19.2,80.8,32.9
E02004345,County Durham 064,12728,1114,1103,1318,1110,1559,2172,1965,1580,680,127,2217,10511,4352,17.42,82.58,34.19
E02004346,County Durham 065,5142,401,424,470,359,581,1015,871,682,291,48,825,4317,1892,16.04,83.96,36.8
E02004347,County Durham 066,7256,529,609,1205,596,698,1078,1003,910,528,100,1138,6118,2541,15.68,84.32,35.02
E02004348,County Durham 042,7983,623,628,714,608,974,1432,1327,1159,438,80,1251,6732,3004,15.67,84.33,37.63
E02004349,County Durham 045,9442,1283,908,1232,1122,1157,1345,1123,798,410,64,2191,7251,2395,23.2,76.8,25.37
E02004350,County Durham 046,9692,969,866,1141,1169,1164,1418,1401,1064,398,102,1835,7857,2965,18.93,81.07,30.59
E02004351,County Durham 051,7361,891,717,970,841,838,1110,953,682,298,61,1608,5753,1994,21.84,78.16,27.09
E02004352,County Durham 055,7938,906,714,1210,929,930,1163,945,727,349,65,1620,6318,2086,20.41,79.59,26.28
E02004353,County Durham 056,7340,712,589,823,696,870,1268,953,848,485,96,1301,6039,2382,17.72,82.28,32.45
E02004354,County Durham 057,9106,1047,807,1190,1179,1105,1356,1191,937,253,41,1854,7252,2422,20.36,79.64,26.6
E02004355,County Durham 058,7265,891,776,1028,862,843,1044,882,613,268,58,1667,5598,1821,22.95,77.05,25.07
E02003811,Cheshire East 022,6765,647,640,559,498,851,1211,1003,911,390,55,1287,5478,2359,19.02,80.98,34.87
E02003812,Cheshire East 023,6203,627,617,441,553,837,916,774,876,453,109,1244,4959,2212,20.05,79.95,35.66
E02003813,Cheshire East 024,6113,530,439,668,572,747,1035,926,711,383,102,969,5144,2122,15.85,84.15,34.71
E02003814,Cheshire East 025,8017,1117,795,1109,994,1070,1361,823,529,201,18,1912,6105,1571,23.85,76.15,19.6
E02003815,Cheshire East 026,7208,1016,702,859,840,936,967,781,678,362,67,1718,5490,1888,23.83,76.17,26.19
E02003816,Cheshire East 027,7163,759,559,903,851,918,1043,859,819,345,107,1318,5845,2130,18.4,81.6,29.74
E02003817,Cheshire East 028,6885,687,617,532,652,888,998,990,915,485,121,1304,5581,2511,18.94,81.06,36.47
E02003818,Cheshire East 029,5380,482,426,471,455,644,911,857,768,296,70,908,4472,1991,16.88,83.12,37.01
E02003819,Cheshire East 030,6188,529,546,550,560,764,898,900,941,380,120,1075,5113,2341,17.37,82.63,37.83
E02003820,Cheshire East 031,9151,1262,873,1247,1276,1289,1441,866,627,215,55,2135,7016,1763,23.33,76.67,19.27
E02003821,Cheshire East 032,5416,460,424,570,538,667,854,766,736,336,65,884,4532,1903,16.32,83.68,35.14
E02003822,Cheshire East 033,10886,1001,888,1054,954,1300,1891,1582,1518,611,87,1889,8997,3798,17.35,82.65,34.89
E02003823,Cheshire East 040,6535,650,584,650,588,745,931,835,964,485,103,1234,5301,2387,18.88,81.12,36.53
E02003824,Cheshire East 042,5680,653,564,558,589,746,832,714,690,270,64,1217,4463,1738,21.43,78.57,30.6
E02003825,Cheshire East 034,6347,749,639,917,729,937,1203,693,358,100,22,1388,4959,1173,21.87,78.13,18.48
E02003826,Cheshire East 035,8120,1252,869,1241,1100,988,993,779,572,252,74,2121,5999,1677,26.12,73.88,20.65
E02003827,Cheshire East 036,9708,1478,962,1556,1520,1147,1147,852,666,330,50,2440,7268,1898,25.13,74.87,19.55
E02003828,Cheshire East 037,6880,1075,728,951,972,798,817,644,554,265,76,1803,5077,1539,26.21,73.79,22.37
E02003829,Cheshire East 038,5687,471,460,959,515,601,809,746,740,317,69,931,4756,1872,16.37,83.63,32.92
E02003830,Cheshire East 039,8186,1142,776,1498,1246,1131,979,689,442,227,56,1918,6268,1414,23.43,76.57,17.27
E02003831,Cheshire East 041,9707,988,830,1017,947,1237,1716,1323,1082,480,87,1818,7889,2972,18.73,81.27,30.62
E02003832,Cheshire East 043,6554,785,597,1277,1185,918,855,488,282,140,27,1382,5172,937,21.09,78.91,14.3
E02003833,Cheshire East 044,6094,693,606,822,727,820,933,631,561,240,61,1299,4795,1493,21.32,78.68,24.5
E02003834,Cheshire East 045,7123,905,673,1242,1091,1003,932,607,414,202,54,1578,5545,1277,22.15,77.85,17.93
E02003835,Cheshire East 046,7798,677,614,687,636,941,1305,1142,1144,581,71,1291,6507,2938,16.56,83.44,37.68
E02003836,Cheshire East 047,7008,606,486,816,754,856,935,914,933,512,196,1092,5916,2555,15.58,84.42,36.46
E02003837,Cheshire East 049,14244,1606,1650,1746,1449,2071,2486,1522,1147,458,109,3256,10988,3236,22.86,77.14,22.72
E02003838,Cheshire East 048,6994,845,571,753,785,839,1043,914,810,363,71,1416,5578,2158,20.25,79.75,30.86
E02003839,Cheshire East 050,6998,671,595,799,674,847,961,863,934,535,119,1266,5732,2451,18.09,81.91,35.02
E02003840,Cheshire East 051,10552,859,953,839,758,1260,1901,1835,1353,653,141,1812,8740,3982,17.17,82.83,37.74
E02003853,Cheshire East 001,6102,616,481,541,604,715,1030,826,746,424,119,1097,5005,2115,17.98,82.02,34.66
E02003854,Cheshire East 002,6295,714,583,535,553,835,901,911,826,359,78,1297,4998,2174,20.6,79.4,34.54
E02003855,Cheshire East 003,6443,641,546,486,521,775,919,970,984,486,115,1187,5256,2555,18.42,81.58,39.66
E02003856,Cheshire East 004,10869,1284,1004,1234,1456,1488,1628,1156,983,504,132,2288,8581,2775,21.05,78.95,25.53
E02003857,Cheshire East 005,6603,848,633,747,891,936,949,748,565,237,49,1481,5122,1599,22.43,77.57,24.22
E02003858,Cheshire East 006,7010,687,701,713,700,961,1104,829,702,488,125,1388,5622,2144,19.8,80.2,30.58
E02003859,Cheshire East 007,11967,1147,924,1126,1122,1509,2000,1654,1545,730,210,2071,9896,4139,17.31,82.69,34.59
E02003860,Cheshire East 008,7230,926,820,580,672,1123,1081,784,733,433,78,1746,5484,2028,24.15,75.85,28.05
E02003861,Cheshire East 009,6380,786,613,658,706,841,931,693,697,375,80,1399,4981,1845,21.93,78.07,28.92
E02003862,Cheshire East 011,5115,378,480,335,248,579,920,806,794,415,160,858,4257,2175,16.77,83.23,42.52
E02003863,Cheshire East 010,6715,792,684,519,582,972,980,846,799,433,108,1476,5239,2186,21.98,78.02,32.55
E02003864,Cheshire East 012,8278,763,710,702,825,1080,1323,1109,936,628,202,1473,6805,2875,17.79,82.21,34.73
E02003865,Cheshire East 013,7915,872,714,710,878,1153,1274,990,887,345,92,1586,6329,2314,20.04,79.96,29.24
E02003866,Cheshire East 014,5970,566,590,516,507,840,1078,809,712,281,71,1156,4814,1873,19.36,80.64,31.37
E02003867,Cheshire East 015,7529,963,772,785,854,965,1196,902,692,319,81,1735,5794,1994,23.04,76.96,26.48
E02003868,Cheshire East 016,8289,921,736,1032,1111,1172,1229,922,696,383,87,1657,6632,2088,19.99,80.01,25.19
E02003869,Cheshire East 017,7137,721,635,679,802,945,1151,867,785,447,105,1356,5781,2204,19.0,81.0,30.88
E02003870,Cheshire East 018,10318,1125,694,1599,1711,1418,1504,1003,759,406,99,1819,8499,2267,17.63,82.37,21.97
E02003871,Cheshire East 019,6761,851,575,724,780,844,1056,835,684,339,73,1426,5335,1931,21.09,78.91,28.56
E02003872,Cheshire East 020,9595,768,774,801,719,1121,1793,1478,1351,698,92,1542,8053,3619,16.07,83.93,37.72
E02003873,Cheshire East 021,6041,796,551,854,811,757,916,621,467,231,37,1347,4694,1356,22.3,77.7,22.45
E02003794,Cheshire West and Chester 022,8606,933,858,923,909,1085,1326,1139,1006,371,56,1791,6815,2572,20.81,79.19,29.89
E02003795,Cheshire West and Chester 025,5777,642,504,721,577,672,783,759,670,347,102,1146,4631,1878,19.84,80.16,32.51
E02003796,Cheshire West and Chester 027,7265,946,609,778,873,825,1000,843,781,518,92,1555,5710,2234,21.4,78.6,30.75
E02003797,Cheshire West and Chester 028,10259,1167,909,1360,1195,1506,1381,1070,911,585,175,2076,8183,2741,20.24,79.76,26.72
E02003798,Cheshire West and Chester 029,6073,869,635,817,804,714,938,596,495,165,40,1504,4569,1296,24.77,75.23,21.34
E02003799,Cheshire West and Chester 031,7113,974,662,1055,903,802,990,782,591,305,49,1636,5477,1727,23.0,77.0,24.28
E02003800,Cheshire West and Chester 030,6844,772,628,606,589,922,1006,891,893,447,90,1400,5444,2321,20.46,79.54,33.91
E02003801,Cheshire West and Chester 032,6839,884,631,681,851,921,983,814,633,364,77,1515,5324,1888,22.15,77.85,27.61
E02003802,Cheshire West and Chester 033,8834,660,326,2245,1547,1063,951,956,634,357,95,986,7848,2042,11.16,88.84,23.12
E02003803,Cheshire West and Chester 034,9932,417,327,4729,1319,771,791,687,533,278,80,744,9188,1578,7.49,92.51,15.89
E02003804,Cheshire West and Chester 036,6557,706,488,999,1050,898,861,660,512,292,91,1194,5363,1555,18.21,81.79,23.72
E02003805,Cheshire West and Chester 039,6296,554,657,662,475,817,981,877,814,366,93,1211,5085,2150,19.23,80.77,34.15
E02003806,Cheshire West and Chester 041,7764,1103,678,787,1092,1100,981,867,665,373,118,1781,5983,2023,22.94,77.06,26.06
E02003807,Cheshire West and Chester 043,8007,699,650,788,835,1098,1196,986,1072,561,122,1349,6658,2741,16.85,83.15,34.23
E02003808,Cheshire West and Chester 044,6452,870,631,970,911,860,934,650,437,156,33,1501,4951,1276,23.26,76.74,19.78
E02003809,Cheshire West and Chester 046,8011,807,740,762,700,995,1366,1060,993,482,106,1547,6464,2641,19.31,80.69,32.97
E02003810,Cheshire West and Chester 047,9094,990,863,838,844,1162,1399,1271,1121,477,129,1853,7241,2998,20.38,79.62,32.97
E02003841,Cheshire West and Chester 001,7951,767,673,899,757,881,1161,1117,1064,522,110,1440,6511,2813,18.11,81.89,35.38
E02003842,Cheshire West and Chester 004,5357,415,434,439,368,572,941,916,805,387,80,849,4508,2188,15.85,84.15,40.84
E02003843,Cheshire West and Chester 005,6025,676,511,713,718,692,965,795,581,330,44,1187,4838,1750,19.7,80.3,29.05
E02003844,Cheshire West and Chester 006,6476,564,471,745,579,767,946,1005,926,411,62,1035,5441,2404,15.98,84.02,37.12
E02003845,Cheshire West and Chester 007,9672,1420,861,1705,1503,1194,1271,837,487,313,81,2281,7391,1718,23.58,76.42,17.76
E02003846,Cheshire West and Chester 008,6800,1026,762,1072,922,727,919,591,477,249,55,1788,5012,1372,26.29,73.71,20.18
E02003847,Cheshire West and Chester 009,9466,879,818,1174,960,1234,1740,1225,970,416,50,1697,7769,2661,17.93,82.07,28.11
E02003848,Cheshire West and Chester 010,5005,592,522,717,600,637,726,530,391,248,42,1114,3891,1211,22.26,77.74,24.2
E02003849,Cheshire West and Chester 011,7689,1220,773,1186,1192,873,1044,647,514,209,31,1993,5696,1401,25.92,74.08,18.22
E02003850,Cheshire West and Chester 013,5050,541,420,650,546,551,783,718,573,233,35,961,4089,1559,19.03,80.97,30.87
E02003851,Cheshire West and Chester 014,5551,546,488,609,508,750,1016,679,614,291,50,1034,4517,1634,18.63,81.37,29.44
E02003852,Cheshire West and Chester 016,6399,593,546,764,665,764,1034,902,710,357,64,1139,5260,2033,17.8,82.2,31.77
E02003874,Cheshire West and Chester 002,9171,963,787,902,948,1207,1364,1126,1174,551,149,1750,7421,3000,19.08,80.92,32.71
E02003875,Cheshire West and Chester 003,6256,510,468,509,469,778,1152,1056,906,338,70,978,5278,2370,15.63,84.37,37.88
E02003876,Cheshire West and Chester 012,5495,704,485,648,639,705,760,718,599,195,42,1189,4306,1554,21.64,78.36,28.28
E02003877,Cheshire West and Chester 015,9291,863,752,938,836,1126,1572,1312,1177,573,142,1615,7676,3204,17.38,82.62,34.48
E02003878,Cheshire West and Chester 017,8751,945,726,910,968,1088,1395,1211,940,432,136,1671,7080,2719,19.09,80.91,31.07
E02003879,Cheshire West and Chester 018,8670,1319,676,1437,1490,1172,1053,654,506,275,88,1995,6675,1523,23.01,76.99,17.57
E02003880,Cheshire West and Chester 019,6227,681,620,743,573,747,940,863,713,265,82,1301,4926,1923,20.89,79.11,30.88
E02003881,Cheshire West and Chester 020,5873,646,545,794,822,826,908,689,460,144,39,1191,4682,1332,20.28,79.72,22.68
E02003882,Cheshire West and Chester 021,9292,1093,905,1291,1152,1195,1413,1095,727,379,42,1998,7294,2243,21.5,78.5,24.14
E02003883,Cheshire West and Chester 023,10700,1112,1166,1115,1056,1618,1813,1255,995,480,90,2278,8422,2820,21.29,78.71,26.36
E02003884,Cheshire West and Chester 024,8487,930,794,698,708,1062,1291,1199,1130,535,140,1724,6763,3004,20.31,79.69,35.4
E02003885,Cheshire West and Chester 026,5988,718,493,597,588,783,937,840,658,291,83,1211,4777,1872,20.22,79.78,31.26
E02003886,Cheshire West and Chester 035,6514,876,642,985,857,819,984,639,469,205,38,1518,4996,1351,23.3,76.7,20.74
E02003887,Cheshire West and Chester 037,6492,780,615,838,789,866,1039,757,603,175,30,1395,5097,1565,21.49,78.51,24.11
E02003888,Cheshire West and Chester 038,6269,750,550,969,744,807,957,668,510,262,52,1300,4969,1492,20.74,79.26,23.8
E02003889,Cheshire West and Chester 040,5900,945,679,808,783,649,763,512,506,219,36,1624,4276,1273,27.53,72.47,21.58
E02003890,Cheshire West and Chester 042,6488,845,570,948,860,763,948,728,571,216,39,1415,5073,1554,21.81,78.19,23.95
E02003891,Cheshire West and Chester 045,6043,585,611,495,424,806,935,891,862,365,69,1196,4847,2187,19.79,80.21,36.19
E02006008,Shropshire 025,9395,1043,796,1128,1123,1288,1416,1096,976,440,89,1839,7556,2601,19.57,80.43,27.68
E02006009,Shropshire 027,6970,700,505,1344,742,715,921,720,732,455,136,1205,5765,2043,17.29,82.71,29.31
E02006010,Shropshire 029,11796,1200,982,1059,1201,1503,1912,1766,1456,588,129,2182,9614,3939,18.5,81.5,33.39
E02006011,Shropshire 031,5963,550,508,539,617,804,791,763,834,437,120,1058,4905,2154,17.74,82.26,36.12
E02006012,Shropshire 033,6358,439,450,628,602,767,1065,998,920,410,79,889,5469,2407,13.98,86.02,37.86
E02006013,Shropshire 034,7752,668,576,686,618,969,1305,1153,1187,480,110,1244,6508,2930,16.05,83.95,37.8
E02006014,Shropshire 035,9684,880,784,984,842,1026,1566,1581,1404,507,110,1664,8020,3602,17.18,82.82,37.2
E02006015,Shropshire 001,10499,1117,927,1269,1239,1252,1611,1286,1109,535,154,2044,8455,3084,19.47,80.53,29.37
E02006016,Shropshire 002,8236,734,646,830,729,1026,1401,1240,1155,406,69,1380,6856,2870,16.76,83.24,34.85
E02006017,Shropshire 004,8147,743,871,838,819,932,1323,1139,940,464,78,1614,6533,2621,19.81,80.19,32.17
E02006018,Shropshire 005,12327,1408,1074,1542,1459,1563,1721,1445,1347,656,112,2482,9845,3560,20.13,79.87,28.88
E02006019,Shropshire 008,6343,590,607,784,717,766,852,779,716,463,69,1197,5146,2027,18.87,81.13,31.96
E02006020,Shropshire 009,7769,782,646,1381,1010,900,1202,923,597,259,69,1428,6341,1848,18.38,81.62,23.79
E02006021,Shropshire 010,8578,736,828,959,786,1056,1612,1260,902,375,64,1564,7014,2601,18.23,81.77,30.32
E02006022,Shropshire 013,6338,676,558,850,783,752,946,816,605,283,69,1234,5104,1773,19.47,80.53,27.97
E02006023,Shropshire 003,10033,1019,1067,1135,1019,1169,1558,1371,1083,507,105,2086,7947,3066,20.79,79.21,30.56
E02006024,Shropshire 006,10164,1225,871,1305,1434,1262,1472,1155,861,472,107,2096,8068,2595,20.62,79.38,25.53
E02006025,Shropshire 007,9955,961,852,1220,1190,1336,1445,1098,1103,596,154,1813,8142,2951,18.21,81.79,29.64
E02006026,Shropshire 011,7149,675,735,761,650,945,1153,1045,821,307,57,1410,5739,2230,19.72,80.28,31.19
E02006027,Shropshire 012,5491,488,427,519,460,650,915,860,744,357,71,915,4576,2032,16.66,83.34,37.01
E02006028,Shropshire 014,9432,859,899,1036,898,1125,1573,1255,1139,531,117,1758,7674,3042,18.64,81.36,32.25
E02006029,Shropshire 015,8121,1081,827,1196,1058,925,1110,843,671,358,52,1908,6213,1924,23.49,76.51,23.69
E02006030,Shropshire 016,8249,1133,804,1157,1248,1025,1158,817,576,263,68,1937,6312,1724,23.48,76.52,20.9
E02006031,Shropshire 017,8361,924,533,1272,1385,1074,1225,861,650,342,95,1457,6904,1948,17.43,82.57,23.3
E02006032,Shropshire 018,9010,1167,905,1107,1166,1177,1295,1002,829,315,47,2072,6938,2193,23.0,77.0,24.34
E02006033,Shropshire 019,8782,655,523,1475,1117,1049,1267,1057,974,500,165,1178,7604,2696,13.41,86.59,30.7
E02006034,Shropshire 020,10302,1173,938,1266,1262,1424,1515,1240,932,432,120,2111,8191,2724,20.49,79.51,26.44
E02006035,Shropshire 021,5602,439,407,462,602,635,787,815,913,458,84,846,4756,2270,15.1,84.9,40.52
E02006036,Shropshire 022,6427,576,497,780,836,823,1015,830,632,349,89,1073,5354,1900,16.7,83.3,29.56
E02006037,Shropshire 023,10334,1050,1340,1201,1090,1207,1527,1270,992,486,171,2390,7944,2919,23.13,76.87,28.25
E02006038,Shropshire 024,8213,904,634,830,913,978,1237,1176,1015,451,75,1538,6675,2717,18.73,81.27,33.08
E02006039,Shropshire 026,8189,818,722,887,814,938,1237,1201,1011,450,111,1540,6649,2773,18.81,81.19,33.86
E02006040,Shropshire 028,7956,684,959,905,645,866,1370,1099,993,381,54,1643,6313,2527,20.65,79.35,31.76
E02006041,Shropshire 030,5945,481,491,567,515,657,1070,978,780,327,79,972,4973,2164,16.35,83.65,36.4
E02006042,Shropshire 032,5989,365,420,493,441,527,938,1052,1027,582,144,785,5204,2805,13.11,86.89,46.84
E02006043,Shropshire 036,6830,660,483,685,667,719,1153,1114,903,379,67,1143,5687,2463,16.73,83.27,36.06
E02006044,Shropshire 037,6338,463,590,518,474,625,1060,1152,976,406,74,1053,5285,2608,16.61,83.39,41.15
E02006045,Shropshire 038,10988,946,770,1226,1150,1170,1577,1499,1498,924,228,1716,9272,4149,15.62,84.38,37.76
E02006046,Shropshire 039,9121,758,791,986,782,998,1570,1343,1290,521,82,1549,7572,3236,16.98,83.02,35.48
E02003892,Cornwall 010,6456,556,471,525,510,645,1105,1209,1013,335,87,1027,5429,2644,15.91,84.09,40.95
E02003893,Cornwall 012,6605,560,547,632,489,733,1170,1186,910,310,68,1107,5498,2474,16.76,83.24,37.46
E02003894,Cornwall 013,8348,824,759,956,810,1060,1271,1187,992,417,72,1583,6765,2668,18.96,81.04,31.96
E02003895,Cornwall 016,8851,1088,828,1036,967,1068,1299,1180,919,400,66,1916,6935,2565,21.65,78.35,28.98
E02003896,Cornwall 017,5855,634,549,727,570,672,862,753,714,323,51,1183,4672,1841,20.2,79.8,31.44
E02003897,Cornwall 022,5578,554,504,514,485,748,945,851,733,225,19,1058,4520,1828,18.97,81.03,32.77
E02003898,Cornwall 023,6725,542,574,600,502,813,1166,1120,1012,343,53,1116,5609,2528,16.59,83.41,37.59
E02003899,Cornwall 025,5478,609,441,601,516,655,789,731,775,303,58,1050,4428,1867,19.17,80.83,34.08
E02003900,Cornwall 026,7104,746,685,810,801,899,1040,933,806,333,51,1431,5673,2123,20.14,79.86,29.88
E02003901,Cornwall 028,7853,660,646,725,593,794,1312,1384,1156,472,111,1306,6547,3123,16.63,83.37,39.77
E02003902,Cornwall 029,5214,587,465,645,576,616,745,748,559,237,36,1052,4162,1580,20.18,79.82,30.3
E02003903,Cornwall 034,6325,593,492,598,579,724,1066,1050,859,325,39,1085,5240,2273,17.15,82.85,35.94
E02003904,Cornwall 037,4995,308,343,403,312,520,887,949,824,365,84,651,4344,2222,13.03,86.97,44.48
E02003905,Cornwall 032,6867,865,692,679,833,909,1106,898,632,222,31,1557,5310,1783,22.67,77.33,25.96
E02003906,Cornwall 033,5937,651,567,460,633,806,832,837,765,321,65,1218,4719,1988,20.52,79.48,33.48
E02003907,Cornwall 040,8370,1005,791,812,978,1146,1116,1114,936,394,78,1796,6574,2522,21.46,78.54,30.13
E02003908,Cornwall 042,8512,992,902,1041,912,1152,1152,945,883,443,90,1894,6618,2361,22.25,77.75,27.74
E02003909,Cornwall 043,10491,1263,860,1518,1322,1251,1459,1236,995,480,107,2123,8368,2818,20.24,79.76,26.86
E02003910,Cornwall 044,6460,603,491,944,831,839,903,725,665,377,82,1094,5366,1849,16.93,83.07,28.62
E02003911,Cornwall 047,9040,927,768,813,864,1043,1366,1223,1364,582,90,1695,7345,3259,18.75,81.25,36.05
E02003912,Cornwall 048,8009,660,688,733,628,906,1339,1257,1219,467,112,1348,6661,3055,16.83,83.17,38.14
E02003913,Cornwall 056,6174,561,522,594,436,657,892,1044,974,423,71,1083,5091,2512,17.54,82.46,40.69
E02003914,Cornwall 060,8339,843,632,2359,1025,891,907,745,629,270,38,1475,6864,1682,17.69,82.31,20.17
E02003915,Cornwall 062,7851,684,604,2243,764,778,932,797,676,315,58,1288,6563,1846,16.41,83.59,23.51
E02003916,Cornwall 063,7000,358,306,2730,528,558,640,734,683,381,82,664,6336,1880,9.49,90.51,26.86
E02003917,Cornwall 064,8195,950,611,1197,944,950,1127,1109,851,390,66,1561,6634,2416,19.05,80.95,29.48
E02003918,Cornwall 045,7121,744,569,693,692,887,1106,1093,882,380,75,1313,5808,2430,18.44,81.56,34.12
E02003919,Cornwall 046,7421,984,612,1002,916,847,1066,848,708,383,55,1596,5825,1994,21.51,78.49,26.87
E02003920,Cornwall 049,8081,967,660,998,1086,974,1157,894,837,423,85,1627,6454,2239,20.13,79.87,27.71
E02003921,Cornwall 050,6095,648,535,583,631,802,946,826,751,309,64,1183,4912,1950,19.41,80.59,31.99
E02003922,Cornwall 051,8673,1141,798,1126,1119,1087,1265,951,776,349,61,1939,6734,2137,22.36,77.64,24.64
E02003923,Cornwall 052,8571,1276,755,1332,1094,1014,1009,934,767,328,62,2031,6540,2091,23.7,76.3,24.4
E02003924,Cornwall 053,6970,748,561,799,703,734,1032,950,912,444,87,1309,5661,2393,18.78,81.22,34.33
E02003925,Cornwall 055,7350,865,739,971,845,904,1069,900,702,298,57,1604,5746,1957,21.82,78.18,26.63
E02003926,Cornwall 059,8459,967,742,902,852,1084,1417,1209,888,336,62,1709,6750,2495,20.2,79.8,29.5
E02003927,Cornwall 066,11494,879,888,2951,910,1115,1371,1418,1329,516,117,1767,9727,3380,15.37,84.63,29.41
E02003928,Cornwall 071,12161,1633,1220,1545,1570,1460,1690,1292,1137,536,78,2853,9308,3043,23.46,76.54,25.02
E02003929,Cornwall 072,6931,605,556,645,562,803,1127,1108,1020,423,82,1161,5770,2633,16.75,83.25,37.99
E02003930,Cornwall 073,9630,805,808,1350,854,1000,1342,1533,1312,516,110,1613,8017,3471,16.75,83.25,36.04
E02003931,Cornwall 001,10667,1103,924,1205,999,1233,1455,1555,1386,655,152,2027,8640,3748,19.0,81.0,35.14
E02003932,Cornwall 002,7558,813,642,680,691,846,1174,1311,896,407,98,1455,6103,2712,19.25,80.75,35.88
E02003933,Cornwall 003,7192,658,580,624,560,803,1155,1279,1054,394,85,1238,5954,2812,17.21,82.79,39.1
E02003934,Cornwall 004,7252,787,656,727,696,797,1128,1082,936,361,82,1443,5809,2461,19.9,80.1,33.94
E02003935,Cornwall 005,10918,1475,1019,1520,1464,1328,1487,1139,901,471,114,2494,8424,2625,22.84,77.16,24.04
E02003936,Cornwall 006,8499,647,666,841,598,894,1505,1453,1279,488,128,1313,7186,3348,15.45,84.55,39.39
E02003937,Cornwall 007,5630,466,514,458,467,651,825,848,771,441,189,980,4650,2249,17.41,82.59,39.95
E02003938,Cornwall 008,7116,845,623,732,766,899,964,940,884,383,80,1468,5648,2287,20.63,79.37,32.14
E02003939,Cornwall 009,7100,677,612,753,679,869,981,900,934,559,136,1289,5811,2529,18.15,81.85,35.62
E02003940,Cornwall 011,6242,481,514,513,528,648,1137,1072,884,381,84,995,5247,2421,15.94,84.06,38.79
E02003941,Cornwall 014,8442,1084,816,1099,1092,1059,1160,898,780,367,87,1900,6542,2132,22.51,77.49,25.25
E02003942,Cornwall 015,7998,1138,732,1112,1026,938,1011,895,711,359,76,1870,6128,2041,23.38,76.62,25.52
E02003943,Cornwall 054,6956,581,541,720,652,800,1037,1161,928,423,113,1122,5834,2625,16.13,83.87,37.74
E02003944,Cornwall 057,10144,1143,837,1148,1043,1246,1435,1298,1328,553,113,1980,8164,3292,19.52,80.48,32.45
E02003945,Cornwall 058,6104,485,484,480,475,653,1000,995,979,429,124,969,5135,2527,15.87,84.13,41.4
E02003946,Cornwall 061,9622,952,913,929,897,1165,1549,1368,1246,478,125,1865,7757,3217,19.38,80.62,33.43
E02003947,Cornwall 065,6646,607,520,585,508,747,1114,1119,988,349,109,1127,5519,2565,16.96,83.04,38.59
E02003948,Cornwall 067,8284,855,774,961,778,945,1294,1023,1038,506,110,1629,6655,2677,19.66,80.34,32.32
E02003949,Cornwall 068,6651,531,507,794,651,792,1077,963,804,420,112,1038,5613,2299,15.61,84.39,34.57
E02003950,Cornwall 069,5603,577,466,449,504,649,878,1013,670,293,104,1043,4560,2080,18.62,81.38,37.12
E02003951,Cornwall 070,5929,461,454,497,438,677,920,976,971,438,97,915,5014,2482,15.43,84.57,41.86
E02003952,Cornwall 018,8786,1107,799,934,1162,1261,1172,1041,856,345,109,1906,6880,2351,21.69,78.31,26.76
E02003953,Cornwall 019,11432,1493,998,1234,1395,1455,1598,1385,1222,529,123,2491,8941,3259,21.79,78.21,28.51
E02003954,Cornwall 020,7403,726,493,954,1052,1086,1005,901,663,392,131,1219,6184,2087,16.47,83.53,28.19
E02003955,Cornwall 021,9966,1086,852,1236,1193,1406,1411,1201,994,478,109,1938,8028,2782,19.45,80.55,27.91
E02003956,Cornwall 024,7893,940,740,977,934,1046,1132,1007,721,330,66,1680,6213,2124,21.28,78.72,26.91
E02003957,Cornwall 027,11019,1254,927,1246,1224,1227,1778,1502,1237,526,98,2181,8838,3363,19.79,80.21,30.52
E02003958,Cornwall 030,8416,1001,835,1053,922,991,1308,1122,798,330,56,1836,6580,2306,21.82,78.18,27.4
E02003959,Cornwall 031,7110,805,658,906,775,833,1034,861,786,354,98,1463,5647,2099,20.58,79.42,29.52
E02003960,Cornwall 035,6057,460,435,529,448,646,984,980,963,482,130,895,5162,2555,14.78,85.22,42.18
E02003961,Cornwall 036,9863,1059,878,1069,976,1171,1450,1371,1220,530,139,1937,7926,3260,19.64,80.36,33.05
E02003962,Cornwall 038,7313,870,605,931,820,867,1089,872,736,393,130,1475,5838,2131,20.17,79.83,29.14
E02003963,Cornwall 039,10148,1221,875,1369,1070,1121,1379,1213,1080,652,168,2096,8052,3113,20.65,79.35,30.68
E02003964,Cornwall 041,8030,567,605,670,542,895,1251,1319,1402,645,134,1172,6858,3500,14.6,85.4,43.59
E02006781,Isles of Scilly 001,2224,206,131,285,267,270,325,298,275,121,46,337,1887,740,15.15,84.85,33.27
E02006634,Wiltshire 012,8633,840,829,705,719,1213,1498,1273,999,446,111,1669,6964,2829,19.33,80.67,32.77
E02006635,Wiltshire 019,8533,706,1334,893,664,997,1263,997,939,556,184,2040,6493,2676,23.91,76.09,31.36
E02006636,Wiltshire 024,6987,698,588,595,625,873,1203,1058,853,414,80,1286,5701,2405,18.41,81.59,34.42
E02006637,Wiltshire 025,10990,1260,1098,1314,1400,1478,1664,1160,1025,510,81,2358,8632,2776,21.46,78.54,25.26
E02006638,Wiltshire 026,6256,561,453,667,563,708,952,874,855,518,105,1014,5242,2352,16.21,83.79,37.6
E02006639,Wiltshire 028,8466,652,694,812,782,1054,1580,1263,1137,424,68,1346,7120,2892,15.9,84.1,34.16
E02006640,Wiltshire 029,7389,760,746,581,643,1116,1267,1097,783,352,44,1506,5883,2276,20.38,79.62,30.8
E02006641,Wiltshire 034,8167,740,1004,817,719,994,1410,1106,885,397,95,1744,6423,2483,21.35,78.65,30.4
E02006642,Wiltshire 038,5653,597,491,472,545,746,1071,836,632,225,38,1088,4565,1731,19.25,80.75,30.62
E02006643,Wiltshire 041,18085,3485,1709,4858,3220,1743,1318,926,557,207,62,5194,12891,1752,28.72,71.28,9.69
E02006644,Wiltshire 001,6525,562,651,585,573,870,1110,998,801,308,67,1213,5312,2174,18.59,81.41,33.32
E02006645,Wiltshire 002,7834,939,828,803,934,1111,1166,925,736,315,77,1767,6067,2053,22.56,77.44,26.21
E02006646,Wiltshire 003,7739,1056,792,752,951,1050,1213,800,626,390,109,1848,5891,1925,23.88,76.12,24.87
E02006647,Wiltshire 004,5958,576,554,395,440,865,1044,948,803,271,62,1130,4828,2084,18.97,81.03,34.98
E02006648,Wiltshire 005,6109,672,620,522,614,858,993,746,659,327,98,1292,4817,1830,21.15,78.85,29.96
E02006649,Wiltshire 006,7521,890,658,831,836,1002,1228,922,703,354,97,1548,5973,2076,20.58,79.42,27.6
E02006650,Wiltshire 007,12984,1757,1139,1656,1775,1636,1783,1389,1246,524,79,2896,10088,3238,22.3,77.7,24.94
E02006651,Wiltshire 008,7475,749,732,710,748,1022,1352,1015,812,284,51,1481,5994,2162,19.81,80.19,28.92
E02006652,Wiltshire 009,9603,1087,1100,1229,1065,1429,1613,953,689,359,79,2187,7416,2080,22.77,77.23,21.66
E02006653,Wiltshire 010,9662,1019,1018,1173,1196,1285,1573,1068,916,341,73,2037,7625,2398,21.08,78.92,24.82
E02006654,Wiltshire 011,9395,991,816,1215,1243,1235,1292,932,889,620,162,1807,7588,2603,19.23,80.77,27.71
E02006655,Wiltshire 013,7454,634,731,642,552,976,1409,1087,867,423,133,1365,6089,2510,18.31,81.69,33.67
E02006656,Wiltshire 014,6809,697,636,855,915,980,1294,772,433,197,30,1333,5476,1432,19.58,80.42,21.03
E02006657,Wiltshire 015,10868,1441,1394,1315,1383,1562,1538,1030,790,329,86,2835,8033,2235,26.09,73.91,20.56
E02006658,Wiltshire 016,7540,832,622,802,796,936,1277,994,832,386,63,1454,6086,2275,19.28,80.72,30.17
E02006659,Wiltshire 017,7934,1056,687,962,996,1089,1057,870,784,338,95,1743,6191,2087,21.97,78.03,26.3
E02006660,Wiltshire 018,13452,1627,1326,1264,1572,1867,1940,1608,1414,690,144,2953,10499,3856,21.95,78.05,28.66
E02006661,Wiltshire 045,10805,2411,770,2669,2084,882,804,597,384,164,40,3181,7624,1185,29.44,70.56,10.97
E02006662,Wiltshire 046,6188,788,547,708,816,812,854,813,571,238,41,1335,4853,1663,21.57,78.43,26.87
E02006663,Wiltshire 048,12354,1645,1278,1441,1784,1709,1740,1255,844,514,144,2923,9431,2757,23.66,76.34,22.32
E02006664,Wiltshire 049,6403,617,631,575,543,855,1043,930,796,334,79,1248,5155,2139,19.49,80.51,33.41
E02006665,Wiltshire 050,6735,613,525,551,526,722,1091,1057,1068,454,128,1138,5597,2707,16.9,83.1,40.19
E02006666,Wiltshire 051,6680,853,733,591,862,958,999,680,586,334,84,1586,5094,1684,23.74,76.26,25.21
E02006667,Wiltshire 052,6813,1062,762,900,1014,871,933,658,397,182,34,1824,4989,1271,26.77,73.23,18.66
E02006668,Wiltshire 053,5871,525,547,546,547,764,953,760,787,327,115,1072,4799,1989,18.26,81.74,33.88
E02006669,Wiltshire 054,10301,1032,810,869,1046,1282,1660,1430,1341,688,143,1842,8459,3602,17.88,82.12,34.97
E02006670,Wiltshire 055,6742,697,527,899,1091,866,946,745,586,285,100,1224,5518,1716,18.15,81.85,25.45
E02006671,Wiltshire 056,6108,616,501,802,884,742,878,687,581,331,86,1117,4991,1685,18.29,81.71,27.59
E02006672,Wiltshire 057,9072,1360,944,966,1229,1124,1132,854,820,489,154,2304,6768,2317,25.4,74.6,25.54
E02006673,Wiltshire 058,4988,388,409,517,483,607,590,728,689,448,129,797,4191,1994,15.98,84.02,39.98
E02006674,Wiltshire 059,5962,728,590,706,772,760,814,683,510,329,70,1318,4644,1592,22.11,77.89,26.7
E02006675,Wiltshire 060,7947,709,788,634,642,1016,1439,1184,985,465,85,1497,6450,2719,18.84,81.16,34.21
E02006676,Wiltshire 061,6313,547,655,467,494,719,1049,1012,849,431,90,1202,5111,2382,19.04,80.96,37.73
E02006677,Wiltshire 062,8030,791,722,673,657,970,1303,1174,1040,554,146,1513,6517,2914,18.84,81.16,36.29
E02006678,Wiltshire 020,7600,974,749,908,913,1040,1072,789,798,318,39,1723,5877,1944,22.67,77.33,25.58
E02006679,Wiltshire 021,11414,1366,1171,1104,1213,1575,1744,1408,1177,560,96,2537,8877,3241,22.23,77.77,28.39
E02006680,Wiltshire 022,7406,786,598,833,842,868,1147,905,787,509,131,1384,6022,2332,18.69,81.31,31.49
E02006681,Wiltshire 023,5812,545,522,383,464,803,912,871,799,414,99,1067,4745,2183,18.36,81.64,37.56
E02006682,Wiltshire 027,10010,997,917,708,998,1303,1416,1466,1301,710,194,1914,8096,3671,19.12,80.88,36.67
E02006683,Wiltshire 030,8413,1074,903,854,1052,1202,1305,941,728,297,57,1977,6436,2023,23.5,76.5,24.05
E02006684,Wiltshire 031,6673,774,536,1183,1008,901,895,658,485,210,23,1310,5363,1376,19.63,80.37,20.62
E02006685,Wiltshire 032,10216,1461,961,1279,1508,1435,1139,1008,857,457,111,2422,7794,2433,23.71,76.29,23.82
E02006686,Wiltshire 033,5537,584,551,648,598,706,818,645,539,308,140,1135,4402,1632,20.5,79.5,29.47
E02006687,Wiltshire 035,7686,990,731,982,1129,1062,1195,811,557,208,21,1721,5965,1597,22.39,77.61,20.78
E02006688,Wiltshire 036,5624,618,518,715,823,742,852,557,525,237,37,1136,4488,1356,20.2,79.8,24.11
E02006689,Wiltshire 037,6885,830,603,624,720,855,999,964,893,351,46,1433,5452,2254,20.81,79.19,32.74
E02006690,Wiltshire 039,6536,603,522,555,574,749,1112,1015,950,390,66,1125,5411,2421,17.21,82.79,37.04
E02006691,Wiltshire 040,14614,1818,1501,1816,2001,2062,2061,1374,1235,593,153,3319,11295,3355,22.71,77.29,22.96
E02006692,Wiltshire 042,5661,737,460,855,846,608,641,609,502,314,89,1197,4464,1514,21.14,78.86,26.74
E02006693,Wiltshire 043,5962,621,569,588,615,822,917,805,667,308,50,1190,4772,1830,19.96,80.04,30.69
E02006694,Wiltshire 044,6201,480,570,776,598,711,928,799,803,425,111,1050,5151,2138,16.93,83.07,34.48
E02006695,Wiltshire 047,6441,486,683,432,473,759,1130,975,952,450,101,1169,5272,2478,18.15,81.85,38.47
E02003616,Bedford 001,5510,542,567,456,417,688,1011,781,691,291,66,1109,4401,1829,20.13,79.87,33.19
E02003617,Bedford 002,8789,842,898,748,643,1209,1558,1219,1038,526,108,1740,7049,2891,19.8,80.2,32.89
E02003618,Bedford 003,8733,1016,975,927,845,1262,1308,995,865,469,71,1991,6742,2400,22.8,77.2,27.48
E02003619,Bedford 004,11815,1598,1184,1135,1378,1612,1778,1432,1136,457,105,2782,9033,3130,23.55,76.45,26.49
E02003620,Bedford 005,8035,915,729,767,811,966,1202,1039,946,561,99,1644,6391,2645,20.46,79.54,32.92
E02003621,Bedford 006,7770,738,742,750,645,969,1161,1069,1069,527,100,1480,6290,2765,19.05,80.95,35.59
E02003622,Bedford 007,9050,1280,1064,1167,1065,1244,1199,893,665,388,85,2344,6706,2031,25.9,74.1,22.44
E02003623,Bedford 008,10710,1523,1074,1105,1376,1443,1491,1220,942,449,87,2597,8113,2698,24.25,75.75,25.19
E02003624,Bedford 009,5762,538,578,1001,670,701,767,547,494,333,133,1116,4646,1507,19.37,80.63,26.15
E02003625,Bedford 010,8759,901,615,1575,1371,1123,1103,846,598,442,185,1516,7243,2071,17.31,82.69,23.64
E02003626,Bedford 011,5366,623,538,746,647,800,806,595,396,182,33,1161,4205,1206,21.64,78.36,22.47
E02003627,Bedford 012,10387,1277,796,1921,1632,1474,1358,891,581,333,124,2073,8314,1929,19.96,80.04,18.57
E02003628,Bedford 013,9483,1711,1238,1466,1562,1335,958,630,310,232,41,2949,6534,1213,31.1,68.9,12.79
E02003629,Bedford 014,10191,1588,1051,1407,1632,1414,1242,862,525,373,97,2639,7552,1857,25.9,74.1,18.22
E02003630,Bedford 015,10989,1688,1137,1884,2011,1513,1299,769,428,203,57,2825,8164,1457,25.71,74.29,13.26
E02003631,Bedford 016,5460,654,485,669,712,741,809,684,459,205,42,1139,4321,1390,20.86,79.14,25.46
E02003632,Bedford 017,5923,805,521,749,840,788,861,656,433,216,54,1326,4597,1359,22.39,77.61,22.94
E02003633,Bedford 018,9699,1521,1048,1273,1417,1243,1285,926,646,283,57,2569,7130,1912,26.49,73.51,19.71
E02003634,Bedford 019,13152,2319,1291,1432,2037,1780,1671,1253,934,351,84,3610,9542,2622,27.45,72.55,19.94
E02003635,Bedford 020,7709,1258,821,869,1056,952,1062,695,604,313,79,2079,5630,1691,26.97,73.03,21.94
E02003599,Central Bedfordshire 001,5929,807,615,836,832,848,826,582,384,165,34,1422,4507,1165,23.98,76.02,19.65
E02003600,Central Bedfordshire 002,6693,770,625,859,803,939,1006,784,639,210,58,1395,5298,1691,20.84,79.16,25.27
E02003601,Central Bedfordshire 003,7745,906,696,811,962,1020,1176,1072,747,298,57,1602,6143,2174,20.68,79.32,28.07
E02003602,Central Bedfordshire 004,6185,572,541,617,594,776,1030,919,741,336,59,1113,5072,2055,18.0,82.0,33.23
E02003603,Central Bedfordshire 005,10914,1359,909,1578,1871,1420,1419,1075,795,376,112,2268,8646,2358,20.78,79.22,21.61
E02003604,Central Bedfordshire 006,10759,1688,952,1533,1784,1468,1262,930,724,340,78,2640,8119,2072,24.54,75.46,19.26
E02003605,Central Bedfordshire 007,9488,1228,769,1723,1231,1206,1243,874,852,309,53,1997,7491,2088,21.05,78.95,22.01
E02003606,Central Bedfordshire 008,8124,814,791,848,714,1124,1374,1073,897,432,57,1605,6519,2459,19.76,80.24,30.27
E02003607,Central Bedfordshire 009,10776,1419,1020,1280,1662,1493,1552,1085,835,348,82,2439,8337,2350,22.63,77.37,21.81
E02003608,Central Bedfordshire 010,12144,1462,1078,1483,1634,1681,1899,1392,983,445,87,2540,9604,2907,20.92,79.08,23.94
E02003609,Central Bedfordshire 011,11622,1619,1196,1485,1699,1618,1700,1081,802,353,69,2815,8807,2305,24.22,75.78,19.83
E02003610,Central Bedfordshire 012,8660,977,972,996,1001,1366,1320,831,700,451,46,1949,6711,2028,22.51,77.49,23.42
E02003611,Central Bedfordshire 013,9593,1198,844,1045,1260,1423,1429,1073,826,389,106,2042,7551,2394,21.29,78.71,24.96
E02003612,Central Bedfordshire 014,12413,1988,1124,1252,1887,2032,1637,1152,902,371,68,3112,9301,2493,25.07,74.93,20.08
E02003613,Central Bedfordshire 015,5888,623,594,800,718,890,863,588,483,260,69,1217,4671,1400,20.67,79.33,23.78
E02003614,Central Bedfordshire 016,7931,932,666,1064,1222,972,1273,954,571,242,35,1598,6333,1802,20.15,79.85,22.72
E02003615,Central Bedfordshire 017,10052,1210,1018,955,1210,1384,1605,1228,961,408,73,2228,7824,2670,22.16,77.84,26.56
E02003636,Central Bedfordshire 018,7382,814,749,841,876,1007,1266,764,682,332,51,1563,5819,1829,21.17,78.83,24.78
E02003637,Central Bedfordshire 019,10132,1097,944,1153,1029,1303,1722,1289,1032,501,62,2041,8091,2884,20.14,79.86,28.46
E02003638,Central Bedfordshire 020,7718,955,730,798,978,933,1132,1009,774,347,62,1685,6033,2192,21.83,78.17,28.4
E02003639,Central Bedfordshire 021,9654,1327,748,1236,1577,1293,1298,936,721,389,129,2075,7579,2175,21.49,78.51,22.53
E02003640,Central Bedfordshire 022,6214,678,480,729,861,889,821,739,670,260,87,1158,5056,1756,18.64,81.36,28.26
E02003641,Central Bedfordshire 023,5601,635,515,548,752,791,844,692,606,194,24,1150,4451,1516,20.53,79.47,27.07
E02003642,Central Bedfordshire 025,9750,1525,1253,1367,1582,1341,1224,829,423,189,17,2778,6972,1458,28.49,71.51,14.95
E02003643,Central Bedfordshire 024,13386,2281,1257,1721,2684,1999,1401,981,686,331,45,3538,9848,2043,26.43,73.57,15.26
E02003644,Central Bedfordshire 026,9847,1367,950,1216,1671,1262,1363,1011,601,328,78,2317,7530,2018,23.53,76.47,20.49
E02003645,Central Bedfordshire 027,7104,749,665,1046,899,885,1103,705,601,388,63,1414,5690,1757,19.9,80.1,24.73
E02003646,Central Bedfordshire 028,10413,1543,1055,1331,1719,1335,1308,976,753,326,67,2598,7815,2122,24.95,75.05,20.38
E02003647,Central Bedfordshire 029,10235,1294,875,1477,1758,1289,1279,876,751,492,144,2169,8066,2263,21.19,78.81,22.11
E02003648,Central Bedfordshire 030,5737,913,554,799,827,662,765,542,362,254,59,1467,4270,1217,25.57,74.43,21.21
E02003649,Central Bedfordshire 031,6875,661,531,946,880,781,1086,782,840,330,38,1192,5683,1990,17.34,82.66,28.95
E02003650,Central Bedfordshire 032,6954,707,551,640,696,788,1149,1027,908,406,82,1258,5696,2423,18.09,81.91,34.84
E02003651,Central Bedfordshire 033,6730,744,536,641,845,913,963,894,841,327,26,1280,5450,2088,19.02,80.98,31.03
E02005702,Northumberland 004,6606,486,492,787,585,657,1069,1035,919,453,123,978,5628,2530,14.8,85.2,38.3
E02005703,Northumberland 005,6752,537,581,777,732,772,1084,1019,773,377,100,1118,5634,2269,16.56,83.44,33.6
E02005704,Northumberland 006,12660,1065,967,1347,1136,1395,2160,2082,1616,762,130,2032,10628,4590,16.05,83.95,36.26
E02005705,Northumberland 007,7632,579,552,571,538,862,1321,1508,1123,467,111,1131,6501,3209,14.82,85.18,42.05
E02005706,Northumberland 001,9550,1019,822,1201,1166,1024,1362,1279,1005,546,126,1841,7709,2956,19.28,80.72,30.95
E02005707,Northumberland 002,7174,533,566,551,622,773,1199,1201,1192,458,79,1099,6075,2930,15.32,84.68,40.84
E02005708,Northumberland 003,10442,724,670,970,857,925,1822,2018,1623,717,116,1394,9048,4474,13.35,86.65,42.85
E02005709,Northumberland 022,7009,1050,724,1112,952,739,911,709,488,251,73,1774,5235,1521,25.31,74.69,21.7
E02005710,Northumberland 023,9431,1099,751,1269,1363,1166,1323,1135,835,392,98,1850,7581,2460,19.62,80.38,26.08
E02005711,Northumberland 024,8115,972,849,1060,923,952,1124,997,849,336,53,1821,6294,2235,22.44,77.56,27.54
E02005712,Northumberland 025,8576,1167,844,1367,1185,1050,1163,883,637,261,19,2011,6565,1800,23.45,76.55,20.99
E02005713,Northumberland 026,6404,534,547,662,652,805,1040,1064,776,285,39,1081,5323,2164,16.88,83.12,33.79
E02005714,Northumberland 027,5142,460,610,508,458,838,886,803,484,76,19,1070,4072,1382,20.81,79.19,26.88
E02005715,Northumberland 029,8768,1063,820,1145,1106,1100,1110,1066,819,438,101,1883,6885,2424,21.48,78.52,27.65
E02005716,Northumberland 028,8896,1023,773,1056,1151,1172,1260,1249,844,299,69,1796,7100,2461,20.19,79.81,27.66
E02005717,Northumberland 030,7583,640,565,719,802,902,1161,1194,1002,506,92,1205,6378,2794,15.89,84.11,36.85
E02005718,Northumberland 031,6416,490,447,638,612,731,894,1070,1109,364,61,937,5479,2604,14.6,85.4,40.59
E02005719,Northumberland 032,8551,831,625,1266,1104,1105,1254,1095,903,321,47,1456,7095,2366,17.03,82.97,27.67
E02005720,Northumberland 008,12074,1106,815,1606,1604,1405,1847,1777,1328,472,114,1921,10153,3691,15.91,84.09,30.57
E02005721,Northumberland 011,5526,517,499,598,627,706,921,786,513,304,55,1016,4510,1658,18.39,81.61,30.0
E02005722,Northumberland 015,8289,853,688,757,757,1051,1471,1360,950,339,63,1541,6748,2712,18.59,81.41,32.72
E02005723,Northumberland 016,6177,488,521,543,720,677,892,976,753,493,114,1009,5168,2336,16.33,83.67,37.82
E02005724,Northumberland 018,6668,659,613,537,597,820,1040,953,915,450,84,1272,5396,2402,19.08,80.92,36.02
E02005725,Northumberland 033,6879,608,631,580,619,759,1019,999,890,587,187,1239,5640,2663,18.01,81.99,38.71
E02005726,Northumberland 034,7834,715,696,861,662,904,1219,1101,1003,551,122,1411,6423,2777,18.01,81.99,35.45
E02005727,Northumberland 019,6333,560,477,558,572,708,1175,1092,804,338,49,1037,5296,2283,16.37,83.63,36.05
E02005728,Northumberland 037,7030,624,600,669,693,740,1151,1118,971,396,68,1224,5806,2553,17.41,82.59,36.32
E02005729,Northumberland 036,5697,494,554,473,570,748,953,887,679,292,47,1048,4649,1905,18.4,81.6,33.44
E02005730,Northumberland 035,13026,1129,1097,1390,1229,1490,2049,1900,1605,866,271,2226,10800,4642,17.09,82.91,35.64
E02005731,Northumberland 038,11047,1140,1127,1347,1239,1476,1779,1310,1096,441,92,2267,8780,2939,20.52,79.48,26.6
E02005732,Northumberland 039,9161,768,735,746,736,1074,1440,1505,1290,726,141,1503,7658,3662,16.41,83.59,39.97
E02005733,Northumberland 040,8480,809,672,821,703,970,1447,1474,1065,408,111,1481,6999,3058,17.46,82.54,36.06
E02005734,Northumberland 009,6133,657,539,733,624,674,932,903,713,311,47,1196,4937,1974,19.5,80.5,32.19
E02005735,Northumberland 010,7799,1091,721,1249,1062,988,1049,772,554,234,79,1812,5987,1639,23.23,76.77,21.02
E02005736,Northumberland 013,8244,1088,767,1180,1078,1018,1105,972,742,249,45,1855,6389,2008,22.5,77.5,24.36
E02005737,Northumberland 012,7289,738,555,970,821,844,1178,1046,742,319,76,1293,5996,2183,17.74,82.26,29.95
E02005738,Northumberland 014,4923,441,412,603,534,617,834,704,553,204,21,853,4070,1482,17.33,82.67,30.1
E02005739,Northumberland 017,9199,915,733,1043,1039,1096,1447,1242,1069,523,92,1648,7551,2926,17.91,82.09,31.81
E02005740,Northumberland 020,10368,1210,952,1400,1292,1278,1508,1264,949,420,95,2162,8206,2728,20.85,79.15,26.31
E02005741,Northumberland 021,8551,773,786,970,921,1023,1472,1168,868,475,95,1559,6992,2606,18.23,81.77,30.48
E02003172,Bournemouth 001,6321,757,587,700,668,704,948,805,696,361,95,1344,4977,1957,21.26,78.74,30.96
E02003173,Bournemouth 002,6437,763,464,646,626,731,923,899,795,481,109,1227,5210,2284,19.06,80.94,35.48
E02003174,Bournemouth 003,7979,926,723,882,824,949,1184,989,904,492,106,1649,6330,2491,20.67,79.33,31.22
E02003175,Bournemouth 004,9135,1385,996,905,1202,1267,1268,940,737,329,106,2381,6754,2112,26.06,73.94,23.12
E02003176,Bournemouth 005,7384,1055,829,1003,958,927,1031,740,530,266,45,1884,5500,1581,25.51,74.49,21.41
E02003177,Bournemouth 006,8096,1157,820,975,922,1219,1190,833,562,357,61,1977,6119,1813,24.42,75.58,22.39
E02003178,Bournemouth 007,8414,1058,820,1354,966,1032,1108,876,735,387,78,1878,6536,2076,22.32,77.68,24.67
E02003179,Bournemouth 008,6561,843,667,710,732,862,919,696,694,344,94,1510,5051,1828,23.01,76.99,27.86
E02003180,Bournemouth 009,9550,1146,756,3025,1227,1047,991,601,494,208,55,1902,7648,1358,19.92,80.08,14.22
E02003181,Bournemouth 010,8667,1131,888,1336,1036,1204,1170,829,653,323,97,2019,6648,1902,23.3,76.7,21.95
E02003182,Bournemouth 011,6530,783,623,738,765,881,963,775,619,296,87,1406,5124,1777,21.53,78.47,27.21
E02003183,Bournemouth 012,6956,542,579,1611,634,797,936,734,685,339,99,1121,5835,1857,16.12,83.88,26.7
E02003184,Bournemouth 013,8007,975,590,2073,1353,1028,826,534,342,207,79,1565,6442,1162,19.55,80.45,14.51
E02003185,Bournemouth 014,7543,1094,759,781,893,1131,1156,775,589,301,64,1853,5690,1729,24.57,75.43,22.92
E02003186,Bournemouth 015,9230,1292,833,1752,1615,1301,1156,658,400,213,10,2125,7105,1281,23.02,76.98,13.88
E02003187,Bournemouth 016,9426,1162,838,1494,1328,1387,1281,932,623,323,58,2000,7426,1936,21.22,78.78,20.54
E02003188,Bournemouth 017,12990,764,516,4807,2371,1297,915,918,750,494,158,1280,11710,2320,9.85,90.15,17.86
E02003189,Bournemouth 018,8654,903,569,1040,1123,1118,1246,1035,846,567,207,1472,7182,2655,17.01,82.99,30.68
E02003190,Bournemouth 019,10647,1180,598,1832,2161,1622,1438,949,499,274,94,1778,8869,1816,16.7,83.3,17.06
E02003191,Bournemouth 020,8270,781,572,676,778,964,1134,1238,1211,673,243,1353,6917,3365,16.36,83.64,40.69
E02003192,Bournemouth 021,12863,955,409,4673,2181,1283,1047,910,816,426,163,1364,11499,2315,10.6,89.4,18.0
E02003194,Poole 001,6166,482,836,554,422,692,810,903,939,423,105,1318,4848,2370,21.38,78.62,38.44
E02003195,Poole 002,5495,635,533,695,722,720,760,669,461,239,61,1168,4327,1430,21.26,78.74,26.02
E02003196,Poole 003,10170,751,998,893,621,1209,1751,1462,1312,938,235,1749,8421,3947,17.2,82.8,38.81
E02003197,Poole 004,6729,805,675,775,809,848,1040,864,614,274,25,1480,5249,1777,21.99,78.01,26.41
E02003198,Poole 005,7389,1014,713,1000,1050,915,1053,718,654,227,45,1727,5662,1644,23.37,76.63,22.25
E02003199,Poole 006,9152,1074,790,1047,1124,1076,1375,1127,935,503,101,1864,7288,2666,20.37,79.63,29.13
E02003200,Poole 007,10235,1241,1007,1378,1372,1261,1355,1088,1003,436,94,2248,7987,2621,21.96,78.04,25.61
E02003201,Poole 008,10908,1457,964,1466,1664,1500,1467,1093,845,379,73,2421,8487,2390,22.19,77.81,21.91
E02003202,Poole 009,6275,673,446,1078,904,777,815,708,561,269,44,1119,5156,1582,17.83,82.17,25.21
E02003203,Poole 010,7550,989,598,953,1217,1065,1083,786,567,234,58,1587,5963,1645,21.02,78.98,21.79
E02003204,Poole 011,9069,942,811,1156,1071,1264,1300,992,883,511,139,1753,7316,2525,19.33,80.67,27.84
E02003205,Poole 012,8328,950,804,869,892,1079,1269,1030,883,464,88,1754,6574,2465,21.06,78.94,29.6
E02003206,Poole 013,10043,1151,1064,1117,1271,1546,1484,1006,885,432,87,2215,7828,2410,22.06,77.94,24.0
E02003207,Poole 014,7148,1017,717,959,1052,874,939,620,640,279,51,1734,5414,1590,24.26,75.74,22.24
E02003208,Poole 015,11923,1258,734,2139,1698,1428,1462,1241,1051,748,164,1992,9931,3204,16.71,83.29,26.87
E02003209,Poole 016,6466,774,516,779,759,779,999,856,648,298,58,1290,5176,1860,19.95,80.05,28.77
E02003210,Poole 017,9581,992,829,918,1108,1241,1340,1140,1128,718,167,1821,7760,3153,19.01,80.99,32.91
E02003211,Poole 018,8956,535,443,851,831,848,1055,1315,1608,1109,361,978,7978,4393,10.92,89.08,49.05
E02004236,Christchurch 001,6023,533,476,659,551,644,876,891,864,449,80,1009,5014,2284,16.75,83.25,37.92
E02004237,Christchurch 002,8260,804,890,859,734,1111,1207,939,986,564,166,1694,6566,2655,20.51,79.49,32.14
E02004238,Christchurch 003,7446,420,511,632,474,694,941,1092,1484,975,223,931,6515,3774,12.5,87.5,50.68
E02004239,Christchurch 004,6083,518,466,523,464,657,857,893,1070,519,116,984,5099,2598,16.18,83.82,42.71
E02004240,Christchurch 005,6369,761,644,920,826,795,965,676,503,237,42,1405,4964,1458,22.06,77.94,22.89
E02004241,Christchurch 006,9683,1044,899,1082,1134,1253,1198,1077,1127,720,149,1943,7740,3073,20.07,79.93,31.74
E02004242,Christchurch 007,6416,412,413,424,453,567,940,1115,1251,668,173,825,5591,3207,12.86,87.14,49.98
E02006883,Bournemouth 023,5879,432,174,929,1174,735,642,553,564,454,222,606,5273,1793,10.31,89.69,30.5
E02006885,Bournemouth 024,7929,568,297,1383,1419,1062,956,807,775,493,169,865,7064,2244,10.91,89.09,28.3
E02004243,East Dorset 001,6523,641,636,602,596,750,1149,1011,797,294,47,1277,5246,2149,19.58,80.42,32.94
E02004244,East Dorset 002,7426,773,586,790,763,909,1052,951,976,515,111,1359,6067,2553,18.3,81.7,34.38
E02004245,East Dorset 003,7709,842,754,811,729,938,1083,973,960,488,131,1596,6113,2552,20.7,79.3,33.1
E02004246,East Dorset 004,7354,478,468,566,440,616,1127,1325,1508,662,164,946,6408,3659,12.86,87.14,49.76
E02004247,East Dorset 005,6155,564,543,547,496,715,1127,995,779,306,83,1107,5048,2163,17.99,82.01,35.14
E02004248,East Dorset 006,7623,502,447,656,545,654,1024,1199,1506,889,201,949,6674,3795,12.45,87.55,49.78
E02004249,East Dorset 007,5701,541,585,504,430,760,875,829,805,339,33,1126,4575,2006,19.75,80.25,35.19
E02004250,East Dorset 008,7960,685,550,817,650,746,950,1176,1330,816,240,1235,6725,3562,15.52,84.48,44.75
E02004251,East Dorset 009,6542,635,519,604,637,729,966,893,934,514,111,1154,5388,2452,17.64,82.36,37.48
E02004252,East Dorset 010,7673,726,660,944,799,860,1022,944,918,619,181,1386,6287,2662,18.06,81.94,34.69
E02004253,East Dorset 011,9641,786,669,788,737,973,1356,1452,1608,969,303,1455,8186,4332,15.09,84.91,44.93
E02004254,East Dorset 012,10219,1085,1045,1109,1037,1290,1515,1365,1188,503,82,2130,8089,3138,20.84,79.16,30.71
E02004255,North Dorset 001,7640,681,633,823,763,938,1104,984,976,565,173,1314,6326,2698,17.2,82.8,35.31
E02004256,North Dorset 002,9170,861,928,825,888,1061,1441,1432,1107,489,138,1789,7381,3166,19.51,80.49,34.53
E02004257,North Dorset 003,8935,1090,846,1038,1061,1108,1165,1054,917,502,154,1936,6999,2627,21.67,78.33,29.4
E02004258,North Dorset 004,10210,861,805,848,934,1122,1535,1608,1541,765,191,1666,8544,4105,16.32,83.68,40.21
E02004259,North Dorset 005,7256,582,874,672,574,757,1121,1141,1014,434,87,1456,5800,2676,20.07,79.93,36.88
E02004260,North Dorset 006,9061,973,1137,1182,1112,1010,1161,1080,969,371,66,2110,6951,2486,23.29,76.71,27.44
E02004261,North Dorset 007,10470,1201,841,1204,1355,1267,1505,1257,1110,577,153,2042,8428,3097,19.5,80.5,29.58
E02004262,North Dorset 008,7976,713,657,713,659,887,1462,1344,1104,372,65,1370,6606,2885,17.18,82.82,36.17
E02004263,Purbeck 001,5920,587,577,523,562,722,943,893,720,334,59,1164,4756,2006,19.66,80.34,33.89
E02004264,Purbeck 002,8701,967,812,974,923,1053,1291,1119,1005,476,81,1779,6922,2681,20.45,79.55,30.81
E02004265,Purbeck 003,8787,885,698,867,805,950,1310,1342,1186,620,124,1583,7204,3272,18.02,81.98,37.24
E02004266,Purbeck 004,8866,1048,761,1268,1133,1111,1147,1025,939,366,68,1809,7057,2398,20.4,79.6,27.05
E02004267,Purbeck 005,5007,324,386,422,319,504,846,961,814,354,77,710,4297,2206,14.18,85.82,44.06
E02004268,Purbeck 006,9817,701,739,948,837,947,1501,1567,1621,754,202,1440,8377,4144,14.67,85.33,42.21
E02004269,West Dorset 001,9894,781,1513,1068,800,896,1149,1156,1396,879,256,2294,7600,3687,23.19,76.81,37.27
E02004270,West Dorset 002,7679,592,639,652,531,743,1321,1345,1213,522,121,1231,6448,3201,16.03,83.97,41.69
E02004271,West Dorset 003,9688,801,732,795,733,1045,1553,1633,1568,682,146,1533,8155,4029,15.82,84.18,41.59
E02004272,West Dorset 004,11899,1117,1042,945,978,1499,2052,1808,1620,689,149,2159,9740,4266,18.14,81.86,35.85
E02004273,West Dorset 005,7223,446,552,513,384,736,1224,1320,1244,635,169,998,6225,3368,13.82,86.18,46.63
E02004274,West Dorset 006,6549,598,527,615,570,700,968,1061,930,456,124,1125,5424,2571,17.18,82.82,39.26
E02004275,West Dorset 007,7538,633,550,514,548,770,1142,1493,1259,545,84,1183,6355,3381,15.69,84.31,44.85
E02004276,West Dorset 008,5552,412,320,492,455,526,798,1004,948,480,117,732,4820,2549,13.18,86.82,45.91
E02004277,West Dorset 009,12465,1179,963,1534,1343,1499,1762,1406,1431,1042,306,2142,10323,4185,17.18,82.82,33.57
E02004278,West Dorset 010,8973,927,857,888,847,1176,1338,1218,1063,541,118,1784,7189,2940,19.88,80.12,32.76
E02004279,West Dorset 011,8037,706,620,736,692,886,1298,1387,1130,486,96,1326,6711,3099,16.5,83.5,38.56
E02004280,West Dorset 012,8230,837,657,722,843,899,1332,1277,1070,518,75,1494,6736,2940,18.15,81.85,35.72
E02004281,Weymouth and Portland 001,7484,964,685,940,913,875,1167,946,686,275,33,1649,5835,1940,22.03,77.97,25.92
E02004282,Weymouth and Portland 002,8786,605,584,734,595,879,1206,1592,1577,809,205,1189,7597,4183,13.53,86.47,47.61
E02004283,Weymouth and Portland 003,8751,799,855,935,864,964,1301,1252,1130,536,115,1654,7097,3033,18.9,81.1,34.66
E02004284,Weymouth and Portland 004,9784,873,628,1366,1076,1108,1460,1419,1128,579,147,1501,8283,3273,15.34,84.66,33.45
E02004285,Weymouth and Portland 005,7545,744,601,955,821,925,1165,960,838,435,101,1345,6200,2334,17.83,82.17,30.93
E02004286,Weymouth and Portland 006,5207,489,528,594,508,625,842,707,555,273,86,1017,4190,1621,19.53,80.47,31.13
E02004287,Weymouth and Portland 007,5571,519,545,619,520,673,865,788,733,248,61,1064,4507,1830,19.1,80.9,32.85
E02004288,Weymouth and Portland 008,6043,627,453,992,708,760,1006,756,504,196,41,1080,4963,1497,17.87,82.13,24.77
E02004289,Weymouth and Portland 009,7268,856,624,801,696,812,1110,1108,901,299,61,1480,5788,2369,20.36,79.64,32.59
E02003652,Aylesbury Vale 001,11232,1247,1912,1793,1128,1403,1503,1085,746,334,81,3159,8073,2246,28.12,71.88,20.0
E02003653,Aylesbury Vale 002,6875,788,560,1296,805,855,910,698,602,305,56,1348,5527,1661,19.61,80.39,24.16
E02003654,Aylesbury Vale 003,5810,581,596,544,488,808,998,864,638,254,39,1177,4633,1795,20.26,79.74,30.9
E02003655,Aylesbury Vale 004,10137,1176,1063,989,1086,1511,1656,1263,993,339,61,2239,7898,2656,22.09,77.91,26.2
E02003656,Aylesbury Vale 005,6342,615,544,696,688,773,1009,850,711,362,94,1159,5183,2017,18.27,81.73,31.8
E02003657,Aylesbury Vale 006,6828,788,666,631,691,915,1144,966,685,288,54,1454,5374,1993,21.29,78.71,29.19
E02003658,Aylesbury Vale 007,8914,1311,771,817,1122,1125,1357,1110,833,352,116,2082,6832,2411,23.36,76.64,27.05
E02003659,Aylesbury Vale 008,10045,1357,1109,1189,1271,1504,1522,988,762,262,81,2466,7579,2093,24.55,75.45,20.84
E02003660,Aylesbury Vale 009,10348,1152,1090,988,1077,1517,1798,1276,972,404,74,2242,8106,2726,21.67,78.33,26.34
E02003661,Aylesbury Vale 010,6085,643,611,599,723,886,1044,768,516,244,51,1254,4831,1579,20.61,79.39,25.95
E02003662,Aylesbury Vale 011,6705,888,571,1043,1075,920,999,606,394,174,35,1459,5246,1209,21.76,78.24,18.03
E02003663,Aylesbury Vale 012,12636,2712,1265,1831,2824,1656,1128,661,367,146,46,3977,8659,1220,31.47,68.53,9.65
E02003664,Aylesbury Vale 013,8808,1506,914,1356,1615,1175,992,546,367,242,95,2420,6388,1250,27.48,72.52,14.19
E02003665,Aylesbury Vale 014,6184,815,574,938,878,898,913,507,413,215,33,1389,4795,1168,22.46,77.54,18.89
E02003666,Aylesbury Vale 015,8390,1155,638,1526,1698,1086,958,577,393,284,75,1793,6597,1329,21.37,78.63,15.84
E02003667,Aylesbury Vale 016,9834,1309,880,1479,1934,1552,1249,756,466,172,37,2189,7645,1431,22.26,77.74,14.55
E02003668,Aylesbury Vale 017,9007,960,955,1002,946,1281,1271,980,899,601,112,1915,7092,2592,21.26,78.74,28.78
E02003669,Aylesbury Vale 018,7962,1268,870,1365,1398,1037,904,581,371,131,37,2138,5824,1120,26.85,73.15,14.07
E02003670,Aylesbury Vale 019,9986,1321,854,1531,1631,1394,1276,954,657,277,91,2175,7811,1979,21.78,78.22,19.82
E02003671,Aylesbury Vale 020,6223,884,660,908,1021,951,831,584,286,85,13,1544,4679,968,24.81,75.19,15.56
E02003672,Aylesbury Vale 021,10821,1238,1046,1010,1082,1521,1784,1351,1130,554,105,2284,8537,3140,21.11,78.89,29.02
E02003673,Aylesbury Vale 022,8972,1031,760,741,953,1320,1258,1136,1109,537,127,1791,7181,2909,19.96,80.04,32.42
E02003674,Aylesbury Vale 023,5487,613,598,465,449,775,911,724,662,242,48,1211,4276,1676,22.07,77.93,30.54
E02003675,Aylesbury Vale 024,9588,1308,965,1105,1232,1389,1274,889,801,466,159,2273,7315,2315,23.71,76.29,24.14
E02003676,Chiltern 001,7932,710,881,695,478,1099,1480,1132,926,459,72,1591,6341,2589,20.06,79.94,32.64
E02003677,Chiltern 002,10192,1407,1158,1195,1270,1494,1420,986,772,413,77,2565,7627,2248,25.17,74.83,22.06
E02003678,Chiltern 003,5806,739,621,615,666,892,821,628,458,266,100,1360,4446,1452,23.42,76.58,25.01
E02003679,Chiltern 004,7066,1002,583,950,1119,926,954,593,542,325,72,1585,5481,1532,22.43,77.57,21.68
E02003680,Chiltern 005,9604,1042,1031,930,662,1377,1526,1191,1123,609,113,2073,7531,3036,21.58,78.42,31.61
E02003681,Chiltern 006,10634,1395,1355,1003,979,1612,1459,1049,947,613,222,2750,7884,2831,25.86,74.14,26.62
E02003682,Chiltern 007,7612,922,897,658,843,1276,1118,827,714,304,53,1819,5793,1898,23.9,76.1,24.93
E02003683,Chiltern 008,7251,930,864,733,730,1082,1052,759,617,396,88,1794,5457,1860,24.74,75.26,25.65
E02003685,Chiltern 010,7985,906,949,689,609,1173,1327,946,830,448,108,1855,6130,2332,23.23,76.77,29.2
E02003686,Chiltern 011,7373,789,770,729,593,989,1164,882,770,555,132,1559,5814,2339,21.14,78.86,31.72
E02003687,Chiltern 012,5826,714,719,525,476,854,920,661,490,367,100,1433,4393,1618,24.6,75.4,27.77
E02006823,Chiltern 013,8765,992,924,703,671,1217,1338,1181,994,600,145,1916,6849,2920,21.86,78.14,33.31
E02003688,South Bucks 001,12752,1616,1450,1279,1415,1890,1812,1233,1066,789,202,3066,9686,3290,24.04,75.96,25.8
E02003689,South Bucks 002,9122,1079,1023,963,835,1212,1414,1033,860,536,167,2102,7020,2596,23.04,76.96,28.46
E02003690,South Bucks 003,6887,723,524,772,868,804,1046,781,694,526,149,1247,5640,2150,18.11,81.89,31.22
E02003691,South Bucks 004,6908,785,736,657,684,953,1108,770,696,383,136,1521,5387,1985,22.02,77.98,28.73
E02003692,South Bucks 005,8987,1035,836,964,1031,1136,1422,1151,855,481,76,1871,7116,2563,20.82,79.18,28.52
E02003693,South Bucks 006,6719,650,560,672,653,895,1099,926,747,421,96,1210,5509,2190,18.01,81.99,32.59
E02003694,South Bucks 007,7970,1099,739,890,1041,1119,1199,903,595,317,68,1838,6132,1883,23.06,76.94,23.63
E02003695,South Bucks 008,11095,1402,963,1393,1581,1346,1741,1249,863,452,105,2365,8730,2669,21.32,78.68,24.06
E02003696,Wycombe 001,7951,848,625,698,712,983,1154,1038,1042,654,197,1473,6478,2931,18.53,81.47,36.86
E02003697,Wycombe 002,5769,601,584,444,448,794,961,811,712,324,90,1185,4584,1937,20.54,79.46,33.58
E02003698,Wycombe 003,8081,824,797,731,639,1024,1383,1023,1085,499,76,1621,6460,2683,20.06,79.94,33.2
E02003699,Wycombe 004,5583,679,523,525,577,762,885,729,570,268,65,1202,4381,1632,21.53,78.47,29.23
E02003701,Wycombe 006,11463,1581,1215,1545,1500,1672,1529,962,911,449,99,2796,8667,2421,24.39,75.61,21.12
E02003702,Wycombe 007,8024,849,697,811,776,1203,1419,984,867,351,67,1546,6478,2269,19.27,80.73,28.28
E02003703,Wycombe 008,8394,1115,980,1351,1246,1129,1144,713,457,217,42,2095,6299,1429,24.96,75.04,17.02
E02003704,Wycombe 009,5644,682,616,535,552,798,896,732,559,227,47,1298,4346,1565,23.0,77.0,27.73
E02003705,Wycombe 010,6899,1020,773,1231,1073,1007,752,542,313,163,25,1793,5106,1043,25.99,74.01,15.12
E02003706,Wycombe 011,6887,1009,711,1059,1087,939,817,567,426,215,57,1720,5167,1265,24.97,75.03,18.37
E02003707,Wycombe 012,6955,1056,701,1155,1191,1024,832,481,302,185,28,1757,5198,996,25.26,74.74,14.32
E02003708,Wycombe 013,9758,1634,1238,1740,1750,1357,920,658,259,175,27,2872,6886,1119,29.43,70.57,11.47
E02003709,Wycombe 014,5667,961,658,743,906,795,675,456,273,176,24,1619,4048,929,28.57,71.43,16.39
E02003710,Wycombe 015,11795,1572,1721,2093,1792,1611,1208,846,566,304,82,3293,8502,1798,27.92,72.08,15.24
E02003711,Wycombe 016,9671,1468,832,1476,1705,1345,1150,779,582,264,70,2300,7371,1695,23.78,76.22,17.53
E02003712,Wycombe 017,7819,947,738,744,927,1088,1120,875,776,499,105,1685,6134,2255,21.55,78.45,28.84
E02003713,Wycombe 018,5802,703,565,526,538,756,855,711,630,448,70,1268,4534,1859,21.85,78.15,32.04
E02003714,Wycombe 019,6520,897,611,673,923,939,924,732,541,240,40,1508,5012,1553,23.13,76.87,23.82
E02003715,Wycombe 020,6381,731,773,422,437,999,1011,831,804,325,48,1504,4877,2008,23.57,76.43,31.47
E02003716,Wycombe 021,5471,538,490,481,471,743,872,736,660,390,90,1028,4443,1876,18.79,81.21,34.29
E02003717,Wycombe 022,8830,1071,975,690,696,1365,1275,993,989,622,154,2046,6784,2758,23.17,76.83,31.23
E02003718,Wycombe 023,5599,735,600,510,600,862,807,583,515,273,114,1335,4264,1485,23.84,76.16,26.52
E02006824,Wycombe 024,9305,1114,1018,819,823,1339,1404,1062,1097,520,109,2132,7173,2788,22.91,77.09,29.96
E02003719,Cambridge 001,8261,1242,672,1473,1073,1028,1060,776,474,352,111,1914,6347,1713,23.17,76.83,20.74
E02003720,Cambridge 002,8541,1019,702,2006,957,1049,995,815,577,317,104,1721,6820,1813,20.15,79.85,21.23
E02003721,Cambridge 003,8814,1076,894,1849,1067,1063,1035,806,520,381,123,1970,6844,1830,22.35,77.65,20.76
E02003722,Cambridge 004,7912,820,579,1751,908,974,1001,832,650,305,92,1399,6513,1879,17.68,82.32,23.75
E02003723,Cambridge 005,9864,578,384,5555,976,602,577,506,392,240,54,962,8902,1192,9.75,90.25,12.08
E02003724,Cambridge 006,8955,1265,811,1863,1230,1179,1100,765,435,238,69,2076,6879,1507,23.18,76.82,16.83
E02003725,Cambridge 007,15139,791,733,8491,1417,919,920,765,624,364,115,1524,13615,1868,10.07,89.93,12.34
E02003726,Cambridge 008,8442,685,607,3166,1173,882,786,616,350,141,36,1292,7150,1143,15.3,84.7,13.54
E02003727,Cambridge 009,8447,989,531,2501,1295,1104,923,540,334,177,53,1520,6927,1104,17.99,82.01,13.07
E02003728,Cambridge 010,8918,1041,687,2421,1148,1044,979,743,478,295,82,1728,7190,1598,19.38,80.62,17.92
E02003729,Cambridge 011,8040,1242,761,1122,866,1138,1020,804,665,327,95,2003,6037,1891,24.91,75.09,23.52
E02003730,Cambridge 012,14285,2340,1661,3456,1706,1738,1423,794,699,349,119,4001,10284,1961,28.01,71.99,13.73
E02003731,Cambridge 013,9180,910,1005,2313,796,976,1157,862,599,437,125,1915,7265,2023,20.86,79.14,22.04
E02003732,East Cambridgeshire 001,9888,1316,963,1346,1467,1236,1325,978,743,396,118,2279,7609,2235,23.05,76.95,22.6
E02003733,East Cambridgeshire 002,8528,986,837,795,947,1224,1342,1063,925,345,64,1823,6705,2397,21.38,78.62,28.11
E02003734,East Cambridgeshire 003,12343,1667,1275,1434,1692,1792,1547,1209,1051,512,164,2942,9401,2936,23.84,76.16,23.79
E02003735,East Cambridgeshire 004,9303,1101,942,1100,1178,1456,1210,931,857,436,92,2043,7260,2316,21.96,78.04,24.9
E02003736,East Cambridgeshire 005,10196,1162,1090,960,1037,1369,1589,1322,1152,439,76,2252,7944,2989,22.09,77.91,29.32
E02003737,East Cambridgeshire 006,13972,1787,1174,1701,2264,2118,1901,1408,1013,486,120,2961,11011,3027,21.19,78.81,21.66
E02003738,East Cambridgeshire 007,6280,743,606,652,697,850,985,756,663,273,55,1349,4931,1747,21.48,78.52,27.82
E02003739,East Cambridgeshire 008,6417,728,701,562,643,889,1005,773,685,331,100,1429,4988,1889,22.27,77.73,29.44
E02003740,East Cambridgeshire 009,6311,697,655,583,558,848,973,830,670,387,110,1352,4959,1997,21.42,78.58,31.64
E02006825,East Cambridgeshire 011,6602,686,569,701,768,889,991,832,768,340,58,1255,5347,1998,19.01,80.99,30.26
E02003742,Fenland 001,6664,644,520,670,613,698,1041,1042,964,394,78,1164,5500,2478,17.47,82.53,37.18
E02003743,Fenland 002,11376,1442,1049,1850,1706,1453,1373,1041,867,461,134,2491,8885,2503,21.9,78.1,22.0
E02003744,Fenland 003,14355,1567,1029,2161,2027,1830,1930,1648,1266,716,181,2596,11759,3811,18.08,81.92,26.55
E02003745,Fenland 004,10314,1133,970,1063,1136,1217,1578,1438,1227,459,93,2103,8211,3217,20.39,79.61,31.19
E02003746,Fenland 005,7756,962,641,1089,1057,929,1077,802,744,369,86,1603,6153,2001,20.67,79.33,25.8
E02003747,Fenland 006,11882,1479,1006,1516,1285,1384,1618,1484,1299,650,161,2485,9397,3594,20.91,79.09,30.25
E02003748,Fenland 007,7819,929,604,988,878,823,1053,1069,920,463,92,1533,6286,2544,19.61,80.39,32.54
E02003749,Fenland 008,6024,643,515,657,691,686,1029,842,653,242,66,1158,4866,1803,19.22,80.78,29.93
E02003750,Fenland 009,7481,801,627,883,729,756,1040,972,962,545,166,1428,6053,2645,19.09,80.91,35.36
E02003751,Fenland 010,7027,791,601,705,700,856,1145,971,812,364,82,1392,5635,2229,19.81,80.19,31.72
E02003752,Fenland 011,11152,1375,954,1497,1348,1388,1609,1281,1033,539,128,2329,8823,2981,20.88,79.12,26.73
E02003753,Huntingdonshire 001,11314,1427,1088,1423,1529,1530,1572,1229,1035,391,90,2515,8799,2745,22.23,77.77,24.26
E02003754,Huntingdonshire 002,5683,560,517,511,533,792,952,881,604,293,40,1077,4606,1818,18.95,81.05,31.99
E02003755,Huntingdonshire 003,8146,887,695,1035,935,1006,1351,1011,818,356,52,1582,6564,2237,19.42,80.58,27.46
E02003756,Huntingdonshire 004,6960,778,613,855,765,904,1153,838,723,275,56,1391,5569,1892,19.99,80.01,27.18
E02003757,Huntingdonshire 005,6538,730,530,699,690,825,1012,897,685,339,131,1260,5278,2052,19.27,80.73,31.39
E02003758,Huntingdonshire 006,9606,1248,815,1055,1314,1259,1375,1204,893,353,90,2063,7543,2540,21.48,78.52,26.44
E02003759,Huntingdonshire 007,5908,576,538,581,570,776,1040,856,698,214,59,1114,4794,1827,18.86,81.14,30.92
E02003760,Huntingdonshire 008,9277,1457,1032,1517,1692,1192,1067,646,414,231,29,2489,6788,1320,26.83,73.17,14.23
E02003761,Huntingdonshire 009,5955,619,484,653,763,697,896,731,680,347,85,1103,4852,1843,18.52,81.48,30.95
E02003762,Huntingdonshire 010,9568,1273,840,1206,1196,1174,1378,1039,949,415,98,2113,7455,2501,22.08,77.92,26.14
E02003763,Huntingdonshire 011,9696,1078,862,1256,1400,1371,1345,1176,844,313,51,1940,7756,2384,20.01,79.99,24.59
E02003764,Huntingdonshire 012,10613,1279,933,1794,1854,1563,1396,847,507,347,93,2212,8401,1794,20.84,79.16,16.9
E02003765,Huntingdonshire 013,7322,749,605,892,981,1016,945,763,774,466,131,1354,5968,2134,18.49,81.51,29.15
E02003766,Huntingdonshire 014,7279,961,658,869,1043,1005,1023,775,639,252,54,1619,5660,1720,22.24,77.76,23.63
E02003767,Huntingdonshire 015,6497,588,726,575,479,942,1214,880,743,310,40,1314,5183,1973,20.22,79.78,30.37
E02003768,Huntingdonshire 016,9738,1050,827,900,939,1263,1474,1283,1308,577,117,1877,7861,3285,19.28,80.72,33.73
E02003769,Huntingdonshire 017,7516,616,569,736,835,1006,1240,1100,974,337,103,1185,6331,2514,15.77,84.23,33.45
E02003770,Huntingdonshire 018,10440,1595,969,1130,1639,1505,1392,983,847,317,63,2564,7876,2210,24.56,75.44,21.17
E02003771,Huntingdonshire 019,6492,665,545,880,780,893,990,665,628,348,98,1210,5282,1739,18.64,81.36,26.79
E02003772,Huntingdonshire 020,6749,655,556,735,729,857,1064,916,837,340,60,1211,5538,2153,17.94,82.06,31.9
E02003773,Huntingdonshire 021,10843,1350,953,1577,1613,1516,1551,993,848,390,52,2303,8540,2283,21.24,78.76,21.06
E02003774,Huntingdonshire 022,5823,675,443,763,738,747,844,613,616,305,79,1118,4705,1613,19.2,80.8,27.7
E02003775,South Cambridgeshire 001,6886,804,723,694,769,1020,1079,817,667,255,58,1527,5359,1797,22.18,77.82,26.1
E02003776,South Cambridgeshire 002,6593,683,699,667,723,906,1008,786,659,362,100,1382,5211,1907,20.96,79.04,28.92
E02003777,South Cambridgeshire 003,8305,1232,920,815,1209,1370,1007,825,621,264,42,2152,6153,1752,25.91,74.09,21.1
E02003778,South Cambridgeshire 004,6348,884,473,695,1155,874,818,612,512,252,73,1357,4991,1449,21.38,78.62,22.83
E02003779,South Cambridgeshire 005,5027,550,408,540,704,680,776,675,491,166,37,958,4069,1369,19.06,80.94,27.23
E02003780,South Cambridgeshire 006,12091,1450,1181,1759,1901,1804,1427,1040,818,533,178,2631,9460,2569,21.76,78.24,21.25
E02003781,South Cambridgeshire 007,6437,712,555,858,929,951,980,689,460,257,46,1267,5170,1452,19.68,80.32,22.56
E02003783,South Cambridgeshire 009,7590,781,644,1254,793,984,976,821,738,440,159,1425,6165,2158,18.77,81.23,28.43
E02003784,South Cambridgeshire 010,8614,903,1039,808,766,1343,1405,1011,885,398,56,1942,6672,2350,22.54,77.46,27.28
E02003785,South Cambridgeshire 011,9173,1083,854,1077,1370,1327,1198,921,782,463,98,1937,7236,2264,21.12,78.88,24.68
E02003786,South Cambridgeshire 012,6588,742,668,564,711,983,909,755,679,421,156,1410,5178,2011,21.4,78.6,30.53
E02003787,South Cambridgeshire 013,7298,808,697,591,658,956,1197,1038,887,405,61,1505,5793,2391,20.62,79.38,32.76
E02003788,South Cambridgeshire 014,7464,960,750,612,823,1086,1158,838,808,352,77,1710,5754,2075,22.91,77.09,27.8
E02003789,South Cambridgeshire 015,7233,889,592,717,900,1015,987,854,794,407,78,1481,5752,2133,20.48,79.52,29.49
E02003790,South Cambridgeshire 016,9419,946,1009,856,856,1300,1522,1247,1022,532,129,1955,7464,2930,20.76,79.24,31.11
E02003791,South Cambridgeshire 017,8024,945,812,704,866,1206,1334,962,798,321,76,1757,6267,2157,21.9,78.1,26.88
E02003792,South Cambridgeshire 018,9664,1171,918,875,1019,1340,1455,1222,1101,440,123,2089,7575,2886,21.62,78.38,29.86
E02003793,South Cambridgeshire 019,6999,782,698,689,691,1009,1235,821,760,275,39,1480,5519,1895,21.15,78.85,27.08
E02006873,South Cambridgeshire 020,9469,1779,1427,1029,1744,1859,944,313,217,137,20,3206,6263,687,33.86,66.14,7.26
E02006874,South Cambridgeshire 021,9864,1464,1186,876,1326,1636,1444,917,665,287,63,2650,7214,1932,26.87,73.13,19.59
E02003965,Allerdale 001,11087,1019,920,1371,983,1256,1699,1600,1392,671,176,1939,9148,3839,17.49,82.51,34.63
E02003966,Allerdale 002,7006,579,530,702,561,800,1241,1144,973,394,82,1109,5897,2593,15.83,84.17,37.01
E02003967,Allerdale 003,8378,886,711,967,839,963,1343,1205,951,454,59,1597,6781,2669,19.06,80.94,31.86
E02003968,Allerdale 004,9111,845,782,1126,975,1118,1387,1195,1085,498,100,1627,7484,2878,17.86,82.14,31.59
E02003969,Allerdale 005,6714,871,654,947,836,752,944,764,611,286,49,1525,5189,1710,22.71,77.29,25.47
E02003970,Allerdale 006,8119,702,675,860,781,1045,1400,1180,933,422,121,1377,6742,2656,16.96,83.04,32.71
E02003971,Allerdale 007,7867,658,671,758,691,955,1299,1232,1012,474,117,1329,6538,2835,16.89,83.11,36.04
E02003972,Allerdale 008,9079,990,778,1140,1044,1082,1469,1067,967,460,82,1768,7311,2576,19.47,80.53,28.37
E02003973,Allerdale 009,8720,1124,774,1318,1138,1025,1225,1034,693,313,76,1898,6822,2116,21.77,78.23,24.27
E02003974,Allerdale 010,7805,929,632,1053,953,841,1120,961,837,405,74,1561,6244,2277,20.0,80.0,29.17
E02003975,Allerdale 011,7166,734,628,757,804,898,1084,953,794,416,98,1362,5804,2261,19.01,80.99,31.55
E02003976,Allerdale 012,6709,414,580,641,635,760,1126,996,919,504,134,994,5715,2553,14.82,85.18,38.05
E02003977,Barrow-in-Furness 001,6229,627,530,922,629,728,1045,817,618,272,41,1157,5072,1748,18.57,81.43,28.06
E02003978,Barrow-in-Furness 002,5556,543,496,695,585,664,915,664,669,278,47,1039,4517,1658,18.7,81.3,29.84
E02003979,Barrow-in-Furness 003,7530,619,545,733,600,852,1235,1080,1123,629,114,1164,6366,2946,15.46,84.54,39.12
E02003980,Barrow-in-Furness 004,6487,836,598,1035,800,759,915,770,548,196,30,1434,5053,1544,22.11,77.89,23.8
E02003981,Barrow-in-Furness 005,6592,673,615,996,816,817,1020,723,597,257,78,1288,5304,1655,19.54,80.46,25.11
E02003982,Barrow-in-Furness 006,7629,869,735,822,878,956,1178,953,865,315,58,1604,6025,2191,21.03,78.97,28.72
E02003983,Barrow-in-Furness 007,7501,943,723,1179,942,879,1103,799,614,278,41,1666,5835,1732,22.21,77.79,23.09
E02003984,Barrow-in-Furness 008,6593,849,558,1088,980,743,886,673,498,249,69,1407,5186,1489,21.34,78.66,22.58
E02003985,Barrow-in-Furness 009,6741,670,603,913,746,818,930,884,795,326,56,1273,5468,2061,18.88,81.12,30.57
E02003986,Barrow-in-Furness 010,6191,650,467,789,806,769,939,764,709,262,36,1117,5074,1771,18.04,81.96,28.61
E02003987,Carlisle 001,5913,491,521,594,575,686,1019,950,701,301,75,1012,4901,2027,17.11,82.89,34.28
E02003988,Carlisle 002,6651,603,599,680,555,764,1152,980,842,387,89,1202,5449,2298,18.07,81.93,34.55
E02003989,Carlisle 003,7092,768,606,730,748,862,1038,970,874,411,85,1374,5718,2340,19.37,80.63,32.99
E02003990,Carlisle 004,10382,1192,878,1030,1104,1357,1563,1374,1114,627,143,2070,8312,3258,19.94,80.06,31.38
E02003991,Carlisle 005,7507,698,631,773,727,855,1198,1189,944,403,89,1329,6178,2625,17.7,82.3,34.97
E02003992,Carlisle 006,8206,684,577,1723,955,1048,1254,948,594,335,88,1261,6945,1965,15.37,84.63,23.95
E02003993,Carlisle 007,8791,807,698,729,768,1031,1468,1495,1174,519,102,1505,7286,3290,17.12,82.88,37.42
E02003994,Carlisle 008,7236,843,537,1132,962,900,1002,751,590,408,111,1380,5856,1860,19.07,80.93,25.7
E02003995,Carlisle 009,9828,1363,845,1322,1328,1220,1368,1012,870,412,88,2208,7620,2382,22.47,77.53,24.24
E02003996,Carlisle 010,9503,1029,697,1870,1528,1195,1322,951,575,278,58,1726,7777,1862,18.16,81.84,19.59
E02003997,Carlisle 011,9519,1422,998,1333,1339,1172,1201,972,675,316,91,2420,7099,2054,25.42,74.58,21.58
E02003998,Carlisle 012,6817,990,709,924,830,809,907,725,602,274,47,1699,5118,1648,24.92,75.08,24.17
E02003999,Carlisle 013,11233,1261,1058,1288,1230,1324,1605,1485,1236,618,128,2319,8914,3467,20.64,79.36,30.86
E02004000,Copeland 001,5199,517,430,613,608,616,831,710,523,289,62,947,4252,1584,18.22,81.78,30.47
E02004001,Copeland 002,5294,445,395,694,643,643,862,720,551,279,62,840,4454,1612,15.87,84.13,30.45
E02004002,Copeland 003,9961,989,932,1254,1044,1316,1574,1240,1006,526,80,1921,8040,2852,19.29,80.71,28.63
E02004003,Copeland 004,11620,1171,921,1593,1315,1276,1977,1630,1159,491,87,2092,9528,3367,18.0,82.0,28.98
E02004004,Copeland 005,9833,1424,899,1344,1321,1131,1342,1151,758,373,90,2323,7510,2372,23.62,76.38,24.12
E02004005,Copeland 006,7768,829,697,961,903,933,1182,1031,835,352,45,1526,6242,2263,19.64,80.36,29.13
E02004006,Copeland 007,8689,798,649,819,761,1014,1511,1396,1106,539,96,1447,7242,3137,16.65,83.35,36.1
E02004007,Copeland 008,9819,965,784,1139,1004,1074,1579,1435,1250,489,100,1749,8070,3274,17.81,82.19,33.34
E02004008,Eden 001,6307,499,523,615,511,711,1162,1130,790,294,72,1022,5285,2286,16.2,83.8,36.25
E02004009,Eden 002,6173,533,538,638,535,723,1146,962,718,336,44,1071,5102,2060,17.35,82.65,33.37
E02004010,Eden 003,7515,832,620,1087,1020,956,1055,780,625,379,161,1452,6063,1945,19.32,80.68,25.88
E02004011,Eden 004,10264,933,808,1121,999,1170,1551,1471,1335,695,181,1741,8523,3682,16.96,83.04,35.87
E02004012,Eden 005,5507,426,406,499,445,646,992,932,748,342,71,832,4675,2093,15.11,84.89,38.01
E02004013,Eden 006,9849,843,857,963,842,1113,1676,1558,1298,581,118,1700,8149,3555,17.26,82.74,36.1
E02004014,Eden 007,7638,661,593,723,661,836,1324,1262,1017,464,97,1254,6384,2840,16.42,83.58,37.18
E02004015,South Lakeland 001,6415,413,432,848,677,720,955,903,829,497,141,845,5570,2370,13.17,86.83,36.94
E02004016,South Lakeland 002,8260,777,654,851,860,1006,1365,1094,1050,484,119,1431,6829,2747,17.32,82.68,33.26
E02004017,South Lakeland 003,8821,915,755,1062,1047,1099,1351,1118,882,494,98,1670,7151,2592,18.93,81.07,29.38
E02004018,South Lakeland 004,8447,859,816,1175,1027,1128,1258,991,736,344,113,1675,6772,2184,19.83,80.17,25.86
E02004019,South Lakeland 005,7906,632,686,785,663,935,1317,1188,1107,499,94,1318,6588,2888,16.67,83.33,36.53
E02004020,South Lakeland 006,8757,873,786,927,854,1107,1375,1133,980,541,181,1659,7098,2835,18.94,81.06,32.37
E02004021,South Lakeland 007,5342,392,343,391,460,610,945,931,852,338,80,735,4607,2201,13.76,86.24,41.2
E02004022,South Lakeland 008,5505,430,376,493,437,547,1001,1049,823,304,45,806,4699,2221,14.64,85.36,40.35
E02004023,South Lakeland 009,6197,455,822,564,397,604,958,1005,846,448,98,1277,4920,2397,20.61,79.39,38.68
E02004024,South Lakeland 010,7412,624,676,620,564,817,1201,1199,1065,545,101,1300,6112,2910,17.54,82.46,39.26
E02004025,South Lakeland 011,8012,653,756,661,603,875,1216,1262,1265,552,169,1409,6603,3248,17.59,82.41,40.54
E02004026,South Lakeland 012,8135,803,660,1031,861,1118,1260,1010,839,445,108,1463,6672,2402,17.98,82.02,29.53
E02004027,South Lakeland 013,8155,503,500,760,503,759,1217,1425,1481,794,213,1003,7152,3913,12.3,87.7,47.98
E02004028,South Lakeland 014,7724,662,617,778,619,809,1311,1167,1160,531,70,1279,6445,2928,16.56,83.44,37.91
E02004029,Amber Valley 001,6972,756,552,996,988,854,984,923,598,275,46,1308,5664,1842,18.76,81.24,26.42
E02004030,Amber Valley 002,5920,488,451,497,496,748,1010,1007,828,341,54,939,4981,2230,15.86,84.14,37.67
E02004031,Amber Valley 003,7899,1098,754,1215,1144,932,1052,783,601,240,80,1852,6047,1704,23.45,76.55,21.57
E02004032,Amber Valley 004,8554,747,629,1033,873,1137,1289,1173,1152,419,102,1376,7178,2846,16.09,83.91,33.27
E02004033,Amber Valley 005,9034,906,662,1242,1132,1178,1468,1093,823,394,136,1568,7466,2446,17.36,82.64,27.08
E02004034,Amber Valley 006,7317,666,507,768,696,840,1136,1065,1142,420,77,1173,6144,2704,16.03,83.97,36.96
E02004035,Amber Valley 007,6643,516,519,625,532,844,1134,1076,943,381,73,1035,5608,2473,15.58,84.42,37.23
E02004036,Amber Valley 008,10426,1160,976,1389,1254,1337,1548,1233,1060,404,65,2136,8290,2762,20.49,79.51,26.49
E02004037,Amber Valley 009,8143,857,759,947,927,1111,1355,960,824,339,64,1616,6527,2187,19.85,80.15,26.86
E02004038,Amber Valley 010,7871,743,553,961,994,1058,1274,955,805,402,126,1296,6575,2288,16.47,83.53,29.07
E02004039,Amber Valley 011,8117,804,651,1022,895,1138,1353,1010,802,351,91,1455,6662,2254,17.93,82.07,27.77
E02004040,Amber Valley 012,9633,1128,823,1391,1227,1312,1478,1071,787,353,63,1951,7682,2274,20.25,79.75,23.61
E02004041,Amber Valley 013,7431,782,614,1124,960,1011,1055,901,692,242,50,1396,6035,1885,18.79,81.21,25.37
E02004043,Amber Valley 015,7411,774,615,853,848,899,1118,1028,847,339,90,1389,6022,2304,18.74,81.26,31.09
E02004044,Amber Valley 016,8686,1000,948,851,748,1131,1366,1037,966,497,142,1948,6738,2642,22.43,77.57,30.42
E02006827,Amber Valley 017,8090,1000,745,1240,1057,936,1170,860,722,298,62,1745,6345,1942,21.57,78.43,24.0
E02004045,Bolsover 001,9794,944,866,1188,1101,1313,1523,1282,1054,446,77,1810,7984,2859,18.48,81.52,29.19
E02004046,Bolsover 002,6307,596,479,778,690,789,1007,887,691,311,79,1075,5232,1968,17.04,82.96,31.2
E02004047,Bolsover 003,6292,845,560,919,891,772,793,692,559,229,32,1405,4887,1512,22.33,77.67,24.03
E02004048,Bolsover 004,6933,945,604,936,901,903,1044,766,566,231,37,1549,5384,1600,22.34,77.66,23.08
E02004049,Bolsover 005,7768,726,612,837,776,954,1274,1149,927,400,113,1338,6430,2589,17.22,82.78,33.33
E02004050,Bolsover 006,7886,976,763,1247,1006,939,1155,774,647,326,53,1739,6147,1800,22.05,77.95,22.83
E02004051,Bolsover 007,10145,1115,861,1630,1348,1233,1520,1120,903,346,69,1976,8169,2438,19.48,80.52,24.03
E02004052,Bolsover 008,8501,960,741,1109,981,1043,1370,1041,815,370,71,1701,6800,2297,20.01,79.99,27.02
E02004053,Bolsover 009,7874,900,789,1118,1018,1050,1150,865,684,261,39,1689,6185,1849,21.45,78.55,23.48
E02004054,Bolsover 010,9062,926,728,1224,1146,1228,1497,1037,844,371,61,1654,7408,2313,18.25,81.75,25.52
E02004055,Chesterfield 001,7185,725,549,977,860,893,1084,871,764,384,78,1274,5911,2097,17.73,82.27,29.19
E02004056,Chesterfield 002,7924,1056,869,1209,1022,996,1035,857,579,263,38,1925,5999,1737,24.29,75.71,21.92
E02004057,Chesterfield 003,7878,1007,752,1277,1071,1066,1110,833,520,217,25,1759,6119,1595,22.33,77.67,20.25
E02004058,Chesterfield 004,7762,916,677,1075,1023,925,1141,857,746,323,79,1593,6169,2005,20.52,79.48,25.83
E02004059,Chesterfield 005,7160,661,453,837,819,879,1196,975,824,436,80,1114,6046,2315,15.56,84.44,32.33
E02004060,Chesterfield 006,7628,820,779,996,795,967,1057,962,850,347,55,1599,6029,2214,20.96,79.04,29.02
E02004061,Chesterfield 007,7620,744,589,1154,918,927,1255,863,699,380,91,1333,6287,2033,17.49,82.51,26.68
E02004062,Chesterfield 008,7840,761,569,972,857,959,1256,1188,877,320,81,1330,6510,2466,16.96,83.04,31.45
E02004063,Chesterfield 009,7955,747,627,836,816,984,1282,1088,961,491,123,1374,6581,2663,17.27,82.73,33.48
E02004064,Chesterfield 010,9663,1154,776,1700,1706,1311,1287,877,497,278,77,1930,7733,1729,19.97,80.03,17.89
E02004065,Chesterfield 011,8129,698,601,774,654,981,1264,1307,1160,557,133,1299,6830,3157,15.98,84.02,38.84
E02004066,Chesterfield 012,11606,1130,850,1625,1477,1557,1740,1336,1187,562,142,1980,9626,3227,17.06,82.94,27.8
E02004067,Chesterfield 013,6550,789,561,926,796,795,974,809,593,240,67,1350,5200,1709,20.61,79.39,26.09
E02004068,Derbyshire Dales 001,7362,532,656,729,545,852,1422,1134,944,434,114,1188,6174,2626,16.14,83.86,35.67
E02004069,Derbyshire Dales 002,6326,457,530,553,439,710,1075,1046,995,441,80,987,5339,2562,15.6,84.4,40.5
E02004070,Derbyshire Dales 003,6193,496,447,552,440,663,993,1067,930,479,126,943,5250,2602,15.23,84.77,42.02
E02004071,Derbyshire Dales 004,5029,426,452,524,434,632,812,738,650,288,73,878,4151,1749,17.46,82.54,34.78
E02004072,Derbyshire Dales 005,9305,898,750,870,890,1192,1466,1329,1221,552,137,1648,7657,3239,17.71,82.29,34.81
E02004073,Derbyshire Dales 006,9193,818,698,1018,851,1071,1515,1447,1143,524,108,1516,7677,3222,16.49,83.51,35.05
E02004074,Derbyshire Dales 007,6118,547,532,699,528,714,1039,920,758,332,49,1079,5039,2059,17.64,82.36,33.65
E02004075,Derbyshire Dales 008,7215,545,575,756,502,828,1438,1167,954,381,69,1120,6095,2571,15.52,84.48,35.63
E02004076,Derbyshire Dales 009,7443,846,742,983,872,950,1094,804,713,345,94,1588,5855,1956,21.34,78.66,26.28
E02004077,Derbyshire Dales 010,8141,592,821,953,764,1008,1504,1079,928,424,68,1413,6728,2499,17.36,82.64,30.7
E02004078,Erewash 001,7171,962,676,1070,884,878,963,759,626,299,54,1638,5533,1738,22.84,77.16,24.24
E02004080,Erewash 003,9762,1204,760,1630,1284,1255,1360,954,774,424,117,1964,7798,2269,20.12,79.88,23.24
E02004081,Erewash 004,5960,563,577,582,480,850,936,878,684,339,71,1140,4820,1972,19.13,80.87,33.09
E02004082,Erewash 005,6213,559,474,595,611,700,1073,903,764,403,131,1033,5180,2201,16.63,83.37,35.43
E02004083,Erewash 006,8166,916,802,1134,1152,1116,1205,804,708,272,57,1718,6448,1841,21.04,78.96,22.54
E02004084,Erewash 007,6182,772,552,829,767,711,840,656,610,348,97,1324,4858,1711,21.42,78.58,27.68
E02004085,Erewash 008,9098,1031,850,1119,1079,1094,1351,995,913,527,139,1881,7217,2574,20.67,79.33,28.29
E02004086,Erewash 009,7348,773,634,698,842,968,1131,913,860,437,92,1407,5941,2302,19.15,80.85,31.33
E02004087,Erewash 010,7899,945,707,1092,1092,1034,1238,805,604,317,65,1652,6247,1791,20.91,79.09,22.67
E02004088,Erewash 011,7793,731,739,900,790,1042,1318,998,841,351,83,1470,6323,2273,18.86,81.14,29.17
E02004089,Erewash 012,7243,896,545,1314,1238,927,1020,598,427,225,53,1441,5802,1303,19.9,80.1,17.99
E02004090,Erewash 013,6227,607,484,742,716,734,1014,730,717,392,91,1091,5136,1930,17.52,82.48,30.99
E02004091,Erewash 014,9391,979,780,1178,1216,1237,1549,1046,915,420,71,1759,7632,2452,18.73,81.27,26.11
E02004092,Erewash 015,9927,1135,951,1332,1311,1274,1390,1042,987,440,65,2086,7841,2534,21.01,78.99,25.53
E02006828,Erewash 016,6991,750,654,1020,877,971,1132,777,561,209,40,1404,5587,1587,20.08,79.92,22.7
E02004093,High Peak 001,6358,674,604,832,831,802,1072,783,506,216,38,1278,5080,1543,20.1,79.9,24.27
E02004094,High Peak 002,7366,946,736,1128,921,910,1075,757,631,219,43,1682,5684,1650,22.83,77.17,22.4
E02004095,High Peak 003,10189,1113,783,1393,1330,1367,1704,1210,896,328,65,1896,8293,2499,18.61,81.39,24.53
E02004096,High Peak 004,9657,982,853,910,1014,1239,1600,1399,1105,466,89,1835,7822,3059,19.0,81.0,31.68
E02004097,High Peak 005,7860,725,577,884,898,1126,1341,1093,875,286,55,1302,6558,2309,16.56,83.44,29.38
E02004098,High Peak 006,7266,788,627,833,851,921,1117,962,804,303,60,1415,5851,2129,19.47,80.53,29.3
E02004100,High Peak 008,7933,738,698,893,806,940,1357,1178,849,380,94,1436,6497,2501,18.1,81.9,31.53
E02004102,High Peak 010,8458,606,633,1509,854,996,1336,1114,794,496,120,1239,7219,2524,14.65,85.35,29.84
E02004103,High Peak 011,7158,1009,740,1074,918,824,1015,712,552,263,51,1749,5409,1578,24.43,75.57,22.05
E02004104,High Peak 012,7377,757,682,818,758,963,1260,974,791,326,48,1439,5938,2139,19.51,80.49,29.0
E02006872,High Peak 013,13044,1288,1149,1487,1359,1524,2089,1843,1511,664,130,2437,10607,4148,18.68,81.32,31.8
E02004105,North East Derbyshire 001,9500,972,734,1358,1193,1111,1511,1319,881,356,65,1706,7794,2621,17.96,82.04,27.59
E02004106,North East Derbyshire 002,6747,500,518,686,559,793,1048,1051,1063,476,53,1018,5729,2643,15.09,84.91,39.17
E02004108,North East Derbyshire 004,7554,734,703,866,777,993,1213,806,889,479,94,1437,6117,2268,19.02,80.98,30.02
E02004109,North East Derbyshire 005,6713,654,535,501,571,743,1013,1004,1090,515,87,1189,5524,2696,17.71,82.29,40.16
E02004110,North East Derbyshire 006,7381,794,644,721,766,1015,978,986,1015,421,41,1438,5943,2463,19.48,80.52,33.37
E02004111,North East Derbyshire 007,5715,514,442,699,592,677,903,827,699,318,44,956,4759,1888,16.73,83.27,33.04
E02004112,North East Derbyshire 008,6469,496,439,478,516,732,1079,1061,1099,492,77,935,5534,2729,14.45,85.55,42.19
E02004113,North East Derbyshire 009,9950,1254,928,1593,1281,1193,1332,1110,800,376,83,2182,7768,2369,21.93,78.07,23.81
E02004114,North East Derbyshire 010,7751,689,528,819,676,880,1190,1240,1170,469,90,1217,6534,2969,15.7,84.3,38.3
E02004115,North East Derbyshire 011,9238,836,736,1184,1075,1150,1495,1280,1010,403,69,1572,7666,2762,17.02,82.98,29.9
E02004116,North East Derbyshire 012,8173,907,709,1110,1029,962,1216,977,830,355,78,1616,6557,2240,19.77,80.23,27.41
E02004117,North East Derbyshire 013,7862,903,657,865,906,929,1185,1049,917,401,50,1560,6302,2417,19.84,80.16,30.74
E02006804,North East Derbyshire 014,8409,938,822,1248,998,1066,1259,863,733,382,100,1760,6649,2078,20.93,79.07,24.71
E02004118,South Derbyshire 001,7304,716,659,949,873,1046,1220,883,597,302,59,1375,5929,1841,18.83,81.17,25.21
E02004119,South Derbyshire 002,11995,1547,1327,1636,1637,1865,1657,1028,847,397,54,2874,9121,2326,23.96,76.04,19.39
E02004120,South Derbyshire 003,9969,1282,865,1385,1512,1269,1337,1195,750,318,56,2147,7822,2319,21.54,78.46,23.26
E02004121,South Derbyshire 004,8383,952,739,959,1018,1092,1411,950,806,361,95,1691,6692,2212,20.17,79.83,26.39
E02004122,South Derbyshire 005,7061,542,976,1006,595,803,1081,904,776,307,71,1518,5543,2058,21.5,78.5,29.15
E02004123,South Derbyshire 006,6892,673,597,664,721,896,1240,956,693,378,74,1270,5622,2101,18.43,81.57,30.48
E02004124,South Derbyshire 007,7843,912,778,1056,952,975,1121,906,760,336,47,1690,6153,2049,21.55,78.45,26.13
E02004125,South Derbyshire 008,9240,1064,923,1262,1120,1181,1336,1116,833,347,58,1987,7253,2354,21.5,78.5,25.48
E02004126,South Derbyshire 009,7471,786,604,997,884,933,1187,961,719,318,82,1390,6081,2080,18.61,81.39,27.84
E02004128,South Derbyshire 011,11465,1179,917,1306,1420,1546,1825,1411,1306,442,113,2096,9369,3272,18.28,81.72,28.54
E02006919,South Derbyshire 012,11076,1570,974,1793,1815,1686,1362,938,632,253,53,2544,8532,1876,22.97,77.03,16.94
E02006920,South Derbyshire 013,8562,1191,850,1332,1337,1269,1179,718,507,157,22,2041,6521,1404,23.84,76.16,16.4
E02004129,East Devon 001,5806,514,480,445,473,611,984,884,947,382,86,994,4812,2299,17.12,82.88,39.6
E02004130,East Devon 002,6048,587,436,697,616,738,736,764,846,505,123,1023,5025,2238,16.91,83.09,37.0
E02004131,East Devon 003,5501,558,401,622,575,659,795,768,665,376,82,959,4542,1891,17.43,82.57,34.38
E02004132,East Devon 004,8760,921,841,723,776,1072,1447,1347,1081,444,108,1762,6998,2980,20.11,79.89,34.02
E02004133,East Devon 005,9319,931,734,983,980,980,1288,1339,1314,633,137,1665,7654,3423,17.87,82.13,36.73
E02004134,East Devon 006,13462,2323,1234,1653,2245,1777,1618,1209,909,407,87,3557,9905,2612,26.42,73.58,19.4
E02004135,East Devon 007,8350,634,686,575,569,814,1317,1504,1425,643,183,1320,7030,3755,15.81,84.19,44.97
E02004136,East Devon 008,8907,901,980,705,761,1083,1361,1215,1170,599,132,1881,7026,3116,21.12,78.88,34.98
E02004137,East Devon 009,5395,408,384,409,338,527,878,957,961,425,108,792,4603,2451,14.68,85.32,45.43
E02004138,East Devon 010,7535,470,443,545,457,662,1003,1248,1581,905,221,913,6622,3955,12.12,87.88,52.49
E02004139,East Devon 011,7031,632,583,618,517,707,1011,1009,1164,640,150,1215,5816,2963,17.28,82.72,42.14
E02004140,East Devon 012,5238,222,315,361,261,409,646,918,1039,815,252,537,4701,3024,10.25,89.75,57.73
E02004141,East Devon 013,6152,562,594,552,523,681,979,959,822,380,100,1156,4996,2261,18.79,81.21,36.75
E02004142,East Devon 014,6835,577,598,1367,696,670,877,874,743,357,76,1175,5660,2050,17.19,82.81,29.99
E02004143,East Devon 015,6476,645,497,565,711,764,932,960,932,409,61,1142,5334,2362,17.63,82.37,36.47
E02004144,East Devon 016,6936,656,626,646,613,810,948,1056,964,496,121,1282,5654,2637,18.48,81.52,38.02
E02004145,East Devon 017,6218,415,450,387,383,611,755,1091,1252,689,185,865,5353,3217,13.91,86.09,51.74
E02004146,East Devon 018,7414,913,660,811,866,968,1133,929,722,347,65,1573,5841,2063,21.22,78.78,27.83
E02004147,East Devon 019,7387,766,570,1170,995,956,1043,876,650,290,71,1336,6051,1887,18.09,81.91,25.54
E02004148,East Devon 020,7514,545,520,609,559,706,1005,1128,1320,803,319,1065,6449,3570,14.17,85.83,47.51
E02004149,Exeter 001,11630,562,439,6416,735,688,772,835,728,362,93,1001,10629,2018,8.61,91.39,17.35
E02004150,Exeter 002,7019,900,571,1859,962,751,781,616,372,180,27,1471,5548,1195,20.96,79.04,17.03
E02004151,Exeter 003,9368,1171,850,1405,1195,1210,1209,890,781,513,144,2021,7347,2328,21.57,78.43,24.85
E02004152,Exeter 004,9585,396,239,5963,845,571,478,428,331,237,97,635,8950,1093,6.62,93.38,11.4
E02004153,Exeter 005,7565,1005,715,1262,1177,1029,955,681,546,172,23,1720,5845,1422,22.74,77.26,18.8
E02004154,Exeter 006,8538,777,671,2848,1252,942,783,501,449,241,74,1448,7090,1265,16.96,83.04,14.82
E02004155,Exeter 007,7541,915,693,1109,972,821,1031,871,671,368,90,1608,5933,2000,21.32,78.68,26.52
E02004156,Exeter 008,12088,739,362,5755,1834,946,894,723,509,265,61,1101,10987,1558,9.11,90.89,12.89
E02004157,Exeter 009,6720,652,502,1467,961,820,768,615,507,284,144,1154,5566,1550,17.17,82.83,23.07
E02004158,Exeter 010,8183,991,657,1515,1466,1000,1030,664,519,253,88,1648,6535,1524,20.14,79.86,18.62
E02004159,Exeter 011,12550,1631,1189,2086,1981,1615,1533,1145,932,373,65,2820,9730,2515,22.47,77.53,20.04
E02004160,Exeter 012,7275,853,592,944,856,869,993,842,738,466,122,1445,5830,2168,19.86,80.14,29.8
E02004161,Exeter 013,8287,947,823,1355,1194,1046,1129,754,575,381,83,1770,6517,1793,21.36,78.64,21.64
E02004162,Exeter 014,7342,773,513,1235,1096,864,962,784,641,346,128,1286,6056,1899,17.52,82.48,25.86
E02004163,Exeter 015,7714,816,692,923,823,901,941,972,984,509,153,1508,6206,2618,19.55,80.45,33.94
E02004164,Mid Devon 001,6845,625,604,601,575,776,1137,1129,914,410,74,1229,5616,2527,17.95,82.05,36.92
E02004165,Mid Devon 002,8687,870,776,958,914,1003,1229,1138,1149,536,114,1646,7041,2937,18.95,81.05,33.81
E02004166,Mid Devon 003,6839,717,743,640,615,867,1108,958,787,336,68,1460,5379,2149,21.35,78.65,31.42
E02004167,Mid Devon 004,7439,927,998,1122,913,883,931,709,573,306,77,1925,5514,1665,25.88,74.12,22.38
E02004168,Mid Devon 005,6309,767,572,833,832,788,820,739,585,301,72,1339,4970,1697,21.22,78.78,26.9
E02004169,Mid Devon 006,7320,804,715,752,666,983,1218,952,770,369,91,1519,5801,2182,20.75,79.25,29.81
E02004170,Mid Devon 007,8795,1094,802,1168,1162,1070,1268,993,774,365,99,1896,6899,2231,21.56,78.44,25.37
E02004171,Mid Devon 008,8362,967,776,860,928,1073,1236,1102,920,408,92,1743,6619,2522,20.84,79.16,30.16
E02004172,Mid Devon 009,6370,609,569,676,534,723,1113,993,790,290,73,1178,5192,2146,18.49,81.51,33.69
E02004173,Mid Devon 010,7420,708,730,722,649,893,1271,1141,870,358,78,1438,5982,2447,19.38,80.62,32.98
E02004174,Mid Devon 011,7925,922,732,1013,897,988,1077,920,825,418,133,1654,6271,2296,20.87,79.13,28.97
E02004175,North Devon 001,5383,574,462,625,551,657,834,778,581,236,85,1036,4347,1680,19.25,80.75,31.21
E02004176,North Devon 002,5483,415,377,467,403,548,1042,988,823,337,83,792,4691,2231,14.44,85.56,40.69
E02004177,North Devon 003,5903,626,495,686,656,693,880,828,671,283,85,1121,4782,1867,18.99,81.01,31.63
E02004178,North Devon 004,5391,510,530,479,440,779,819,770,693,297,74,1040,4351,1834,19.29,80.71,34.02
E02004179,North Devon 005,9436,1135,801,1251,1106,1181,1186,1006,1080,562,128,1936,7500,2776,20.52,79.48,29.42
E02004180,North Devon 006,6150,617,605,593,498,792,972,971,724,309,69,1222,4928,2073,19.87,80.13,33.71
E02004181,North Devon 007,5830,617,525,651,747,712,836,698,620,354,70,1142,4688,1742,19.59,80.41,29.88
E02004182,North Devon 008,6343,794,539,1003,775,741,824,694,583,316,74,1333,5010,1667,21.02,78.98,26.28
E02004183,North Devon 009,5895,548,436,727,601,643,815,733,854,430,108,984,4911,2125,16.69,83.31,36.05
E02004184,North Devon 010,8891,1230,908,1223,1123,1137,1264,895,727,317,67,2138,6753,2006,24.05,75.95,22.56
E02004185,North Devon 011,6397,660,480,542,590,576,943,931,1008,528,139,1140,5257,2606,17.82,82.18,40.74
E02004186,North Devon 012,9246,1142,800,1019,1141,1101,1398,1098,1039,435,73,1942,7304,2645,21.0,79.0,28.61
E02004187,North Devon 013,9971,970,912,1055,1037,1102,1545,1394,1234,586,136,1882,8089,3350,18.87,81.13,33.6
E02004188,North Devon 014,6826,542,568,600,499,724,1255,1117,1003,414,104,1110,5716,2638,16.26,83.74,38.65
E02004189,South Hams 001,6135,550,499,924,732,714,1038,813,570,262,33,1049,5086,1678,17.1,82.9,27.35
E02004190,South Hams 002,8317,769,761,749,697,960,1490,1298,1028,467,98,1530,6787,2891,18.4,81.6,34.76
E02004191,South Hams 003,8844,803,783,926,866,1156,1356,1298,1052,472,132,1586,7258,2954,17.93,82.07,33.4
E02004192,South Hams 004,7493,602,621,528,543,821,1300,1363,1144,491,80,1223,6270,3078,16.32,83.68,41.08
E02004193,South Hams 005,11757,1285,1250,1385,1288,1416,1906,1456,1146,509,116,2535,9222,3227,21.56,78.44,27.45
E02004194,South Hams 006,7226,832,617,596,727,853,1161,1137,828,378,97,1449,5777,2440,20.05,79.95,33.77
E02004195,South Hams 007,5427,422,356,694,485,525,814,896,824,313,98,778,4649,2131,14.34,85.66,39.27
E02004196,South Hams 008,7706,778,714,582,644,940,1223,1235,1064,442,84,1492,6214,2825,19.36,80.64,36.66
E02004197,South Hams 009,6774,595,490,534,524,731,1025,1127,1141,520,87,1085,5689,2875,16.02,83.98,42.44
E02004198,South Hams 010,6496,624,566,658,658,707,966,907,814,463,133,1190,5306,2317,18.32,81.68,35.67
E02004199,South Hams 011,5664,472,407,377,375,508,871,1036,1068,481,69,879,4785,2654,15.52,84.48,46.86
E02004200,South Hams 012,5165,403,323,428,420,496,783,941,906,394,71,726,4439,2312,14.06,85.94,44.76
E02004201,Teignbridge 001,5383,485,387,422,480,587,859,915,830,348,70,872,4511,2163,16.2,83.8,40.18
E02004202,Teignbridge 002,8640,966,728,938,1019,1104,1309,1120,941,403,112,1694,6946,2576,19.61,80.39,29.81
E02004203,Teignbridge 003,5884,435,439,476,478,640,1080,1025,826,373,112,874,5010,2336,14.85,85.15,39.7
E02004204,Teignbridge 004,9755,1024,874,900,1020,1192,1497,1388,1166,575,119,1898,7857,3248,19.46,80.54,33.3
E02004205,Teignbridge 005,8499,891,709,873,869,941,1326,1337,1053,440,60,1600,6899,2890,18.83,81.17,34.0
E02004206,Teignbridge 006,6710,488,447,634,533,656,1019,1100,1119,536,178,935,5775,2933,13.93,86.07,43.71
E02004207,Teignbridge 007,6451,657,546,680,620,768,1008,878,819,409,66,1203,5248,2172,18.65,81.35,33.67
E02004208,Teignbridge 008,8468,758,748,698,745,993,1290,1353,1239,504,140,1506,6962,3236,17.78,82.22,38.21
E02004209,Teignbridge 009,8907,998,737,1097,1010,1091,1406,1027,979,431,131,1735,7172,2568,19.48,80.52,28.83
E02004210,Teignbridge 010,6808,655,473,829,735,786,981,952,758,457,182,1128,5680,2349,16.57,83.43,34.5
E02004211,Teignbridge 011,6698,525,462,444,478,687,1057,1225,1157,487,176,987,5711,3045,14.74,85.26,45.46
E02004212,Teignbridge 012,6150,655,554,769,743,764,971,767,626,239,62,1209,4941,1694,19.66,80.34,27.54
E02004213,Teignbridge 013,8388,1141,652,1108,1367,1033,1152,907,650,249,129,1793,6595,1935,21.38,78.62,23.07
E02004214,Teignbridge 014,6255,794,478,1029,880,716,884,629,528,245,72,1272,4983,1474,20.34,79.66,23.57
E02004215,Teignbridge 015,5768,528,536,781,686,680,841,696,574,312,134,1064,4704,1716,18.45,81.55,29.75
E02004216,Teignbridge 016,5603,536,449,623,570,593,907,824,694,342,65,985,4618,1925,17.58,82.42,34.36
E02004217,Teignbridge 017,8035,853,736,787,838,975,1290,1121,942,388,105,1589,6446,2556,19.78,80.22,31.81
E02004218,Teignbridge 018,6145,565,480,601,618,644,1021,949,812,386,69,1045,5100,2216,17.01,82.99,36.06
E02004219,Teignbridge 019,5616,471,477,483,426,629,968,831,830,405,96,948,4668,2162,16.88,83.12,38.5
E02004220,Torridge 001,6098,515,410,461,568,629,966,1059,968,441,81,925,5173,2549,15.17,84.83,41.8
E02004221,Torridge 002,6381,433,399,513,524,661,798,1118,1157,602,176,832,5549,3053,13.04,86.96,47.85
E02004222,Torridge 003,5959,625,521,757,621,739,955,806,594,279,62,1146,4813,1741,19.23,80.77,29.22
E02004223,Torridge 004,12814,1823,1175,1656,1602,1536,1735,1580,1154,478,75,2998,9816,3287,23.4,76.6,25.65
E02004224,Torridge 005,6508,531,515,642,470,703,1124,1092,958,364,109,1046,5462,2523,16.07,83.93,38.77
E02004225,Torridge 006,5980,678,546,782,646,712,810,748,651,316,91,1224,4756,1806,20.47,79.53,30.2
E02004226,Torridge 007,7312,568,548,646,536,767,1210,1409,1097,448,83,1116,6196,3037,15.26,84.74,41.53
E02004227,Torridge 008,10133,979,873,1028,880,1134,1661,1645,1276,547,110,1852,8281,3578,18.28,81.72,35.31
E02004228,Torridge 009,7082,540,637,601,586,740,1216,1312,996,394,60,1177,5905,2762,16.62,83.38,39.0
E02004229,West Devon 001,9647,1081,771,985,1073,1092,1542,1349,1140,495,119,1852,7795,3103,19.2,80.8,32.17
E02004230,West Devon 002,7609,808,735,910,818,920,1107,906,851,445,109,1543,6066,2311,20.28,79.72,30.37
E02004231,West Devon 003,6945,580,471,644,711,832,1233,1115,944,363,52,1051,5894,2474,15.13,84.87,35.62
E02004232,West Devon 004,6648,562,579,572,540,728,1220,1148,865,355,79,1141,5507,2447,17.16,82.84,36.81
E02004233,West Devon 005,12545,1200,1245,1256,1216,1313,1864,1763,1662,824,202,2445,10100,4451,19.49,80.51,35.48
E02004234,West Devon 006,6068,474,480,460,392,649,1075,1090,937,406,105,954,5114,2538,15.72,84.28,41.83
E02004235,West Devon 007,6334,484,536,490,537,663,1075,1036,990,422,101,1020,5314,2549,16.1,83.9,40.24
E02004356,Eastbourne 001,7463,976,761,1032,909,853,1097,827,639,289,80,1737,5726,1835,23.27,76.73,24.59
E02004357,Eastbourne 002,7860,1155,873,1036,990,950,1040,867,654,241,54,2028,5832,1816,25.8,74.2,23.1
E02004358,Eastbourne 003,7999,996,693,863,902,808,1028,987,1027,567,128,1689,6310,2709,21.12,78.88,33.87
E02004359,Eastbourne 004,8099,864,642,919,748,878,1199,1018,988,654,189,1506,6593,2849,18.59,81.41,35.18
E02004361,Eastbourne 006,8168,997,826,802,696,1027,1261,983,907,520,149,1823,6345,2559,22.32,77.68,31.33
E02004362,Eastbourne 007,8961,1183,875,1177,1146,1227,1261,926,696,380,90,2058,6903,2092,22.97,77.03,23.35
E02004363,Eastbourne 008,6979,543,417,968,786,816,992,840,797,565,255,960,6019,2457,13.76,86.24,35.21
E02004364,Eastbourne 009,8254,849,738,786,826,1060,1232,1021,945,616,181,1587,6667,2763,19.23,80.77,33.47
E02004365,Eastbourne 010,8392,1018,558,1849,1458,1149,1022,741,380,171,46,1576,6816,1338,18.78,81.22,15.94
E02004366,Eastbourne 011,7907,591,544,1393,1022,869,845,838,855,688,262,1135,6772,2643,14.35,85.65,33.43
E02004367,Eastbourne 012,7332,403,505,813,421,635,878,1031,1320,994,332,908,6424,3677,12.38,87.62,50.15
E02006857,Eastbourne 013,8958,1022,753,896,1052,1098,1221,1108,1153,521,134,1775,7183,2916,19.81,80.19,32.55
E02006858,Eastbourne 014,7373,680,537,860,766,882,1111,1095,1062,328,52,1217,6156,2537,16.51,83.49,34.41
E02004368,Hastings 001,8529,1001,824,1111,964,1077,1288,1062,852,285,65,1825,6704,2264,21.4,78.6,26.54
E02004369,Hastings 002,9690,846,725,881,735,1048,1475,1419,1572,779,210,1571,8119,3980,16.21,83.79,41.07
E02004370,Hastings 003,8009,1199,876,1077,1017,1006,1062,857,611,257,47,2075,5934,1772,25.91,74.09,22.13
E02004371,Hastings 004,7178,1020,639,1010,948,838,987,806,604,276,50,1659,5519,1736,23.11,76.89,24.19
E02004372,Hastings 005,7372,1299,851,1082,1085,827,935,625,437,204,27,2150,5222,1293,29.16,70.84,17.54
E02004373,Hastings 006,8844,1098,801,1197,1143,1067,1273,995,818,336,116,1899,6945,2265,21.47,78.53,25.61
E02004374,Hastings 007,7658,815,663,941,874,947,1296,956,735,299,132,1478,6180,2122,19.3,80.7,27.71
E02004375,Hastings 008,8580,896,757,1216,1049,1175,1412,1045,676,262,92,1653,6927,2075,19.27,80.73,24.18
E02004376,Hastings 009,7089,712,567,1279,1023,986,1047,751,471,176,77,1279,5810,1475,18.04,81.96,20.81
E02004377,Hastings 010,10944,1184,916,1256,1208,1327,1556,1399,1189,599,310,2100,8844,3497,19.19,80.81,31.95
E02004378,Hastings 011,8768,833,557,1268,1307,1300,1431,1016,673,294,89,1390,7378,2072,15.85,84.15,23.63
E02004379,Lewes 001,8014,805,937,800,653,1108,1297,1068,907,352,87,1742,6272,2414,21.74,78.26,30.12
E02004380,Lewes 002,9564,882,893,956,805,1191,1499,1327,1039,740,232,1775,7789,3338,18.56,81.44,34.9
E02004381,Lewes 003,10136,1020,1007,1183,1184,1363,1682,1189,916,464,128,2027,8109,2697,20.0,80.0,26.61
E02004382,Lewes 004,6642,653,592,564,649,865,903,915,871,491,139,1245,5397,2416,18.74,81.26,36.37
E02004383,Lewes 005,7807,766,964,902,734,1152,1296,852,722,347,72,1730,6077,1993,22.16,77.84,25.53
E02004384,Lewes 006,7875,850,686,813,860,1080,1223,985,808,436,134,1536,6339,2363,19.5,80.5,30.01
E02004385,Lewes 007,7665,807,629,939,884,851,1105,1024,895,428,103,1436,6229,2450,18.73,81.27,31.96
E02004386,Lewes 008,6729,758,559,746,831,768,1023,835,798,336,75,1317,5412,2044,19.57,80.43,30.38
E02004387,Lewes 009,6366,970,706,945,948,856,816,568,380,145,32,1676,4690,1125,26.33,73.67,17.67
E02004388,Lewes 010,7831,918,651,969,961,962,1013,911,868,458,120,1569,6262,2357,20.04,79.96,30.1
E02004389,Lewes 011,9778,732,718,847,750,897,1467,1511,1649,895,312,1450,8328,4367,14.83,85.17,44.66
E02004390,Lewes 012,8179,802,712,847,684,791,1094,1179,1261,672,137,1514,6665,3249,18.51,81.49,39.72
E02004391,Lewes 013,6682,540,427,719,766,744,950,921,881,540,194,967,5715,2536,14.47,85.53,37.95
E02004392,Rother 001,9452,1124,947,993,840,1140,1517,1270,1076,445,100,2071,7381,2891,21.91,78.09,30.59
E02004393,Rother 002,6495,520,488,537,453,658,1103,1131,1059,453,93,1008,5487,2736,15.52,84.48,42.12
E02004394,Rother 003,8078,641,738,816,621,872,1450,1231,1121,475,113,1379,6699,2940,17.07,82.93,36.4
E02004395,Rother 004,8332,768,593,816,749,860,1338,1280,1243,565,120,1361,6971,3208,16.33,83.67,38.5
E02004396,Rother 005,9158,636,685,817,566,853,1441,1669,1682,650,159,1321,7837,4160,14.42,85.58,45.42
E02004397,Rother 006,8735,915,993,919,797,977,1289,1182,980,555,128,1908,6827,2845,21.84,78.16,32.57
E02004398,Rother 007,9669,1298,1004,1341,1176,1050,1261,1005,928,452,154,2302,7367,2539,23.81,76.19,26.26
E02004399,Rother 008,8256,692,566,912,762,823,1125,1215,1274,684,203,1258,6998,3376,15.24,84.76,40.89
E02004400,Rother 009,10130,545,531,607,557,796,1455,1948,2228,1152,311,1076,9054,5639,10.62,89.38,55.67
E02004401,Rother 010,8134,572,467,656,579,659,1038,1340,1552,1010,261,1039,7095,4163,12.77,87.23,51.18
E02004402,Rother 011,9641,910,558,1289,1048,1047,1312,1293,1247,652,285,1468,8173,3477,15.23,84.77,36.06
E02004403,Wealden 001,6914,605,803,707,646,905,1160,944,770,310,64,1408,5506,2088,20.36,79.64,30.2
E02004404,Wealden 002,6574,661,709,565,553,924,1137,941,687,332,65,1370,5204,2025,20.84,79.16,30.8
E02004405,Wealden 003,6459,766,644,738,693,828,831,780,746,365,68,1410,5049,1959,21.83,78.17,30.33
E02004406,Wealden 004,7593,631,593,718,617,841,1187,1052,1134,629,191,1224,6369,3006,16.12,83.88,39.59
E02004407,Wealden 005,8094,740,819,774,558,971,1413,1134,1028,534,123,1559,6535,2819,19.26,80.74,34.83
E02004408,Wealden 006,8160,936,681,1018,1019,1149,1314,974,720,294,55,1617,6543,2043,19.82,80.18,25.04
E02004409,Wealden 007,5451,439,474,511,401,709,998,880,691,281,67,913,4538,1919,16.75,83.25,35.2
E02004410,Wealden 008,8405,714,773,776,659,1026,1503,1284,1105,430,135,1487,6918,2954,17.69,82.31,35.15
E02004411,Wealden 009,8642,943,824,960,1009,1086,1230,1116,980,396,98,1767,6875,2590,20.45,79.55,29.97
E02004412,Wealden 010,8160,774,716,974,834,1028,1205,1026,1038,455,110,1490,6670,2629,18.26,81.74,32.22
E02004413,Wealden 011,7105,680,610,728,553,807,1204,1010,928,458,127,1290,5815,2523,18.16,81.84,35.51
E02004414,Wealden 012,6466,663,601,872,764,963,1064,692,572,206,69,1264,5202,1539,19.55,80.45,23.8
E02004415,Wealden 013,7016,709,660,717,583,827,1239,1092,763,343,83,1369,5647,2281,19.51,80.49,32.51
E02004416,Wealden 014,6490,567,537,625,527,736,1116,1058,893,346,85,1104,5386,2382,17.01,82.99,36.7
E02004417,Wealden 015,6244,646,484,682,658,668,879,752,827,494,154,1130,5114,2227,18.1,81.9,35.67
E02004418,Wealden 016,5800,725,465,692,618,647,779,704,708,391,71,1190,4610,1874,20.52,79.48,32.31
E02004419,Wealden 017,6150,819,592,801,683,682,863,662,646,306,96,1411,4739,1710,22.94,77.06,27.8
E02004420,Wealden 018,13871,1438,1625,1338,1418,1370,1869,1946,1792,878,197,3063,10808,4813,22.08,77.92,34.7
E02004421,Wealden 019,9371,1109,704,910,1154,1080,1269,1145,1161,664,175,1813,7558,3145,19.35,80.65,33.56
E02004422,Wealden 020,10978,1209,902,1159,1071,1318,1629,1485,1376,695,134,2111,8867,3690,19.23,80.77,33.61
E02004423,Wealden 021,7532,559,536,652,592,862,1122,1119,1294,656,140,1095,6437,3209,14.54,85.46,42.6
E02004424,Basildon 001,7105,822,717,755,707,1066,1062,862,771,311,32,1539,5566,1976,21.66,78.34,27.81
E02004425,Basildon 002,7372,917,650,867,983,1078,1063,771,599,377,67,1567,5805,1814,21.26,78.74,24.61
E02004426,Basildon 003,8085,964,710,991,970,1190,1179,779,724,466,112,1674,6411,2081,20.71,79.29,25.74
E02004427,Basildon 004,7913,942,683,724,828,1033,1198,898,964,550,93,1625,6288,2505,20.54,79.46,31.66
E02004428,Basildon 005,6945,864,565,857,854,908,964,703,669,420,141,1429,5516,1933,20.58,79.42,27.83
E02004429,Basildon 006,7382,700,601,808,720,850,1135,934,1019,511,104,1301,6081,2568,17.62,82.38,34.79
E02004430,Basildon 007,8244,969,829,1076,959,1245,1212,888,705,294,67,1798,6446,1954,21.81,78.19,23.7
E02004431,Basildon 008,9831,1365,896,1491,1553,1395,1304,847,678,255,47,2261,7570,1827,23.0,77.0,18.58
E02004432,Basildon 009,6985,800,700,851,722,935,1010,851,734,326,56,1500,5485,1967,21.47,78.53,28.16
E02004433,Basildon 010,9018,1183,871,1284,1265,1181,1265,867,690,314,98,2054,6964,1969,22.78,77.22,21.83
E02004434,Basildon 011,8764,1204,790,1267,1344,1083,1183,942,642,259,50,1994,6770,1893,22.75,77.25,21.6
E02004435,Basildon 012,9339,1501,978,1338,1474,1157,1175,820,526,297,73,2479,6860,1716,26.54,73.46,18.37
E02004436,Basildon 013,8247,1315,966,1180,1178,1013,955,858,536,190,56,2281,5966,1640,27.66,72.34,19.89
E02004437,Basildon 014,9336,1291,830,1268,1471,1155,1180,974,769,335,63,2121,7215,2141,22.72,77.28,22.93
E02004438,Basildon 015,9746,1529,939,1430,1615,1139,1127,804,528,488,147,2468,7278,1967,25.32,74.68,20.18
E02004439,Basildon 016,10123,1794,1295,1640,1613,1360,1124,638,429,205,25,3089,7034,1297,30.51,69.49,12.81
E02004440,Basildon 017,8475,1267,844,1157,1342,1120,1155,662,517,372,39,2111,6364,1590,24.91,75.09,18.76
E02004441,Basildon 018,7738,954,813,1065,989,945,1020,930,708,272,42,1767,5971,1952,22.84,77.16,25.23
E02004442,Basildon 019,8737,1478,1111,1327,1229,1062,1057,756,475,205,37,2589,6148,1473,29.63,70.37,16.86
E02004443,Basildon 020,9969,1436,736,1685,1679,1163,1283,854,639,426,68,2172,7797,1987,21.79,78.21,19.93
E02004444,Basildon 021,9224,1126,841,1250,1196,1251,1423,1026,750,297,64,1967,7257,2137,21.32,78.68,23.17
E02004445,Basildon 022,8621,1177,833,1354,1267,1096,1090,825,646,281,52,2010,6611,1804,23.32,76.68,20.93
E02004446,Braintree 001,6867,647,684,700,596,882,1243,1010,747,301,57,1331,5536,2115,19.38,80.62,30.8
E02004447,Braintree 002,5915,415,552,534,433,731,1122,978,802,295,53,967,4948,2128,16.35,83.65,35.98
E02004448,Braintree 003,7191,800,672,743,828,886,1135,944,805,315,63,1472,5719,2127,20.47,79.53,29.58
E02004449,Braintree 004,8570,1107,806,1080,1038,1173,1214,913,785,361,93,1913,6657,2152,22.32,77.68,25.11
E02004450,Braintree 005,6354,574,531,589,560,796,1158,986,785,311,64,1105,5249,2146,17.39,82.61,33.77
E02004451,Braintree 006,8854,950,873,898,830,1151,1359,1138,1023,517,115,1823,7031,2793,20.59,79.41,31.55
E02004452,Braintree 007,9281,991,897,1014,1071,1215,1313,1122,1007,450,201,1888,7393,2780,20.34,79.66,29.95
E02004453,Braintree 008,7290,1044,735,987,992,894,965,707,618,288,60,1779,5511,1673,24.4,75.6,22.95
E02004454,Braintree 009,9467,1156,675,1566,1523,1220,1183,907,726,409,102,1831,7636,2144,19.34,80.66,22.65
E02004455,Braintree 010,7872,877,864,891,904,1108,1236,872,803,272,45,1741,6131,1992,22.12,77.88,25.3
E02004456,Braintree 011,9984,1433,966,1408,1505,1340,1342,920,685,319,66,2399,7585,1990,24.03,75.97,19.93
E02004457,Braintree 012,10347,1343,1026,1370,1359,1371,1476,1059,841,394,108,2369,7978,2402,22.9,77.1,23.21
E02004458,Braintree 013,9680,1168,1176,1099,1136,1419,1417,979,822,359,105,2344,7336,2265,24.21,75.79,23.4
E02004459,Braintree 014,10626,1123,1060,1080,1067,1533,1602,1330,1161,543,127,2183,8443,3161,20.54,79.46,29.75
E02004460,Braintree 015,9177,1205,840,1232,1291,1098,1261,1027,880,300,43,2045,7132,2250,22.28,77.72,24.52
E02004461,Braintree 016,5895,863,684,837,858,843,752,499,407,108,44,1547,4348,1058,26.24,73.76,17.95
E02004462,Braintree 017,11233,1406,889,1654,1856,1416,1414,1068,924,475,131,2295,8938,2598,20.43,79.57,23.13
E02004463,Braintree 018,8001,930,683,804,940,1057,1183,1045,815,410,134,1613,6388,2404,20.16,79.84,30.05
E02004464,Brentwood 001,10115,1023,964,1188,806,1201,1698,1318,1182,588,147,1987,8128,3235,19.64,80.36,31.98
E02004465,Brentwood 002,6260,583,595,679,557,772,1108,718,695,471,82,1178,5082,1966,18.82,81.18,31.41
E02004466,Brentwood 003,8222,998,885,1008,1014,1133,1200,834,620,409,121,1883,6339,1984,22.9,77.1,24.13
E02004467,Brentwood 004,8345,1194,873,1065,1210,1079,1099,786,672,290,77,2067,6278,1825,24.77,75.23,21.87
E02004468,Brentwood 005,10511,1181,1024,1048,955,1506,1731,1107,1061,715,183,2205,8306,3066,20.98,79.02,29.17
E02004469,Brentwood 006,7005,871,667,750,751,956,1069,812,693,376,60,1538,5467,1941,21.96,78.04,27.71
E02004470,Brentwood 007,11901,1452,942,2000,2258,1708,1348,846,750,439,158,2394,9507,2193,20.12,79.88,18.43
E02004471,Brentwood 008,8523,1016,787,1137,1169,1124,1198,941,637,400,114,1803,6720,2092,21.15,78.85,24.55
E02004472,Brentwood 009,6139,590,539,791,642,818,1023,749,570,344,73,1129,5010,1736,18.39,81.61,28.28
E02004473,Castle Point 001,7921,885,764,1011,907,993,1038,884,941,450,48,1649,6272,2323,20.82,79.18,29.33
E02004474,Castle Point 002,7747,826,642,899,820,876,1114,966,985,531,88,1468,6279,2570,18.95,81.05,33.17
E02004475,Castle Point 003,6786,706,623,888,693,824,1062,804,792,333,61,1329,5457,1990,19.58,80.42,29.33
E02004476,Castle Point 004,8113,750,791,1013,811,1039,1222,969,1008,442,68,1541,6572,2487,18.99,81.01,30.65
E02004477,Castle Point 005,6049,553,389,632,566,621,896,897,897,520,78,942,5107,2392,15.57,84.43,39.54
E02004478,Castle Point 006,6541,650,594,845,702,748,1022,729,729,417,105,1244,5297,1980,19.02,80.98,30.27
E02004479,Castle Point 007,8370,885,676,1104,919,1010,1265,957,952,489,113,1561,6809,2511,18.65,81.35,30.0
E02004480,Castle Point 008,7184,951,703,1008,916,899,935,886,666,185,35,1654,5530,1772,23.02,76.98,24.67
E02004481,Castle Point 009,6832,606,493,744,607,602,861,995,1279,583,62,1099,5733,2919,16.09,83.91,42.73
E02004482,Castle Point 010,8551,1111,975,1290,994,1033,1141,910,727,309,61,2086,6465,2007,24.39,75.61,23.47
E02004483,Castle Point 011,8344,796,605,1015,912,911,1169,1263,1127,475,71,1401,6943,2936,16.79,83.21,35.19
E02004484,Castle Point 012,7938,748,630,968,821,899,1169,1147,1076,411,69,1378,6560,2703,17.36,82.64,34.05
E02004485,Chelmsford 001,8405,1150,944,829,1066,1240,1157,897,732,325,65,2094,6311,2019,24.91,75.09,24.02
E02004486,Chelmsford 002,8718,1017,863,878,1131,1237,1166,936,912,490,88,1880,6838,2426,21.56,78.44,27.83
E02004487,Chelmsford 003,7624,1036,848,918,963,990,991,853,650,295,80,1884,5740,1878,24.71,75.29,24.63
E02004488,Chelmsford 004,9135,1208,842,1085,1308,1308,1127,1026,751,392,88,2050,7085,2257,22.44,77.56,24.71
E02004489,Chelmsford 005,9269,1135,1253,1003,1132,1443,1349,902,716,298,38,2388,6881,1954,25.76,74.24,21.08
E02004490,Chelmsford 006,8275,1147,973,1282,1186,1077,1041,686,559,259,65,2120,6155,1569,25.62,74.38,18.96
E02004491,Chelmsford 007,7779,923,763,1003,1004,1072,1178,792,627,361,56,1686,6093,1836,21.67,78.33,23.6
E02004492,Chelmsford 008,9415,1210,870,1396,1494,1515,1330,804,510,230,56,2080,7335,1600,22.09,77.91,16.99
E02004493,Chelmsford 009,10526,1343,927,1812,1775,1469,1325,834,586,349,106,2270,8256,1875,21.57,78.43,17.81
E02004494,Chelmsford 010,12745,1322,611,3506,2723,1649,1119,690,570,413,142,1933,10812,1815,15.17,84.83,14.24
E02004495,Chelmsford 011,8512,842,689,1034,867,1060,1239,1024,1005,638,114,1531,6981,2781,17.99,82.01,32.67
E02004496,Chelmsford 012,8082,1110,845,931,1090,1274,989,692,662,390,99,1955,6127,1843,24.19,75.81,22.8
E02004497,Chelmsford 013,7810,730,738,776,781,1040,1143,950,982,552,118,1468,6342,2602,18.8,81.2,33.32
E02004498,Chelmsford 014,10009,1199,988,1257,1465,1397,1374,923,891,426,89,2187,7822,2329,21.85,78.15,23.27
E02004499,Chelmsford 015,6808,812,625,834,841,945,989,739,680,282,61,1437,5371,1762,21.11,78.89,25.88
E02004500,Chelmsford 016,9149,971,921,882,862,1175,1461,1161,1101,537,78,1892,7257,2877,20.68,79.32,31.45
E02004501,Chelmsford 017,7088,864,609,790,752,842,1043,883,841,409,55,1473,5615,2188,20.78,79.22,30.87
E02004502,Chelmsford 018,7091,680,656,645,669,949,1192,951,858,420,71,1336,5755,2300,18.84,81.16,32.44
E02004503,Chelmsford 019,7982,1006,752,989,938,1064,1053,992,821,292,75,1758,6224,2180,22.02,77.98,27.31
E02004504,Chelmsford 020,7996,885,741,1065,1011,1027,1255,1104,620,211,77,1626,6370,2012,20.34,79.66,25.16
E02004505,Chelmsford 021,5970,603,427,642,640,687,916,782,795,411,67,1030,4940,2055,17.25,82.75,34.42
E02004506,Colchester 001,7149,738,644,726,711,968,1178,947,817,348,72,1382,5767,2184,19.33,80.67,30.55
E02004507,Colchester 002,9933,1362,1126,1484,1490,1592,1329,807,491,216,36,2488,7445,1550,25.05,74.95,15.6
E02004508,Colchester 003,6511,653,627,580,671,923,1042,832,795,338,50,1280,5231,2015,19.66,80.34,30.95
E02004509,Colchester 004,14885,2324,1393,2566,2835,2250,1683,881,625,266,62,3717,11168,1834,24.97,75.03,12.32
E02004512,Colchester 007,11610,1369,838,2226,2134,1610,1186,876,777,455,139,2207,9403,2247,19.01,80.99,19.35
E02004513,Colchester 008,13590,1484,865,6001,1591,1095,948,723,614,235,34,2349,11241,1606,17.28,82.72,11.82
E02004514,Colchester 009,5668,637,656,642,536,790,824,583,578,331,91,1293,4375,1583,22.81,77.19,27.93
E02004515,Colchester 010,8669,1093,809,1016,952,1200,1302,1027,861,329,80,1902,6767,2297,21.94,78.06,26.5
E02004516,Colchester 011,14094,2053,1063,3646,2902,1700,1330,735,468,175,22,3116,10978,1400,22.11,77.89,9.93
E02004517,Colchester 012,9136,1067,828,1169,1212,1158,1196,959,937,508,102,1895,7241,2506,20.74,79.26,27.43
E02004518,Colchester 013,7869,1173,828,1164,1183,1216,992,602,450,222,39,2001,5868,1313,25.43,74.57,16.69
E02004519,Colchester 014,7314,697,711,781,693,869,1072,977,852,566,96,1408,5906,2491,19.25,80.75,34.06
E02004520,Colchester 015,9529,1826,928,1673,1783,1145,980,555,426,177,36,2754,6775,1194,28.9,71.1,12.53
E02004521,Colchester 016,9189,1168,734,1439,1277,1175,1385,964,658,328,61,1902,7287,2011,20.7,79.3,21.88
E02004522,Colchester 017,12010,789,700,4943,1062,1087,1069,973,980,327,80,1489,10521,2360,12.4,87.6,19.65
E02004523,Colchester 018,10335,1537,988,1758,1570,1212,1361,927,622,295,65,2525,7810,1909,24.43,75.57,18.47
E02004524,Colchester 019,8390,813,811,838,687,1148,1429,1212,994,401,57,1624,6766,2664,19.36,80.64,31.75
E02004525,Colchester 020,7597,723,612,902,777,841,1109,1025,1092,446,70,1335,6262,2633,17.57,82.43,34.66
E02004526,Colchester 021,7285,516,560,625,515,757,1144,1138,1262,631,137,1076,6209,3168,14.77,85.23,43.49
E02006922,Colchester 022,13943,1493,1162,1987,1640,1677,1933,1609,1531,767,144,2655,11288,4051,19.04,80.96,29.05
E02004527,Epping Forest 001,8851,911,806,1111,993,1211,1399,1038,888,436,58,1717,7134,2420,19.4,80.6,27.34
E02004528,Epping Forest 002,8427,813,663,944,864,1060,1391,1136,987,488,81,1476,6951,2692,17.52,82.48,31.94
E02004529,Epping Forest 003,6837,645,592,861,633,778,1259,919,759,313,78,1237,5600,2069,18.09,81.91,30.26
E02004530,Epping Forest 004,6555,839,586,732,672,776,978,770,683,438,81,1425,5130,1972,21.74,78.26,30.08
E02004531,Epping Forest 005,7078,1016,586,675,890,999,1002,751,651,384,124,1602,5476,1910,22.63,77.37,26.99
E02004532,Epping Forest 006,6375,705,551,714,874,944,850,700,592,375,70,1256,5119,1737,19.7,80.3,27.25
E02004533,Epping Forest 007,7503,1002,662,1023,894,915,1070,785,670,373,109,1664,5839,1937,22.18,77.82,25.82
E02004534,Epping Forest 008,9044,1302,870,1358,1260,1281,1222,748,664,278,61,2172,6872,1751,24.02,75.98,19.36
E02004535,Epping Forest 009,5924,623,473,738,721,716,911,730,629,329,54,1096,4828,1742,18.5,81.5,29.41
E02004536,Epping Forest 010,6263,664,563,730,626,786,927,802,687,362,116,1227,5036,1967,19.59,80.41,31.41
E02004537,Epping Forest 011,9217,1265,839,1461,1449,1231,1289,813,527,264,79,2104,7113,1683,22.83,77.17,18.26
E02004538,Epping Forest 012,9797,1177,942,1338,1267,1313,1483,928,781,457,111,2119,7678,2277,21.63,78.37,23.24
E02004539,Epping Forest 013,8008,1120,753,1135,1205,1094,1046,731,549,298,77,1873,6135,1655,23.39,76.61,20.67
E02004540,Epping Forest 014,6066,760,571,758,772,837,935,648,457,267,61,1331,4735,1433,21.94,78.06,23.62
E02004541,Epping Forest 015,11782,1516,1085,1416,1585,1738,1667,1085,1011,531,148,2601,9181,2775,22.08,77.92,23.55
E02004542,Epping Forest 016,6641,678,554,873,776,844,1083,826,582,333,92,1232,5409,1833,18.55,81.45,27.6
E02004543,Epping Forest 017,7321,980,700,1119,1046,945,901,726,519,295,90,1680,5641,1630,22.95,77.05,22.26
E02004544,Harlow 001,8885,1444,734,1042,1360,1163,1128,893,684,354,83,2178,6707,2014,24.51,75.49,22.67
E02004545,Harlow 002,7657,1113,757,1204,1083,933,975,769,451,284,88,1870,5787,1592,24.42,75.58,20.79
E02004546,Harlow 003,8016,1163,776,1143,1281,1007,1014,784,459,313,76,1939,6077,1632,24.19,75.81,20.36
E02004547,Harlow 004,9286,1539,807,1462,1553,1205,1080,801,412,343,84,2346,6940,1640,25.26,74.74,17.66
E02004548,Harlow 005,8706,1350,957,1116,1299,1348,1290,659,498,161,28,2307,6399,1346,26.5,73.5,15.46
E02004549,Harlow 006,7837,1192,803,1086,1131,939,1073,762,439,336,76,1995,5842,1613,25.46,74.54,20.58
E02004550,Harlow 007,8451,1308,823,1157,1357,1045,968,728,545,433,87,2131,6320,1793,25.22,74.78,21.22
E02004551,Harlow 008,7420,1148,727,868,1126,891,938,776,546,333,67,1875,5545,1722,25.27,74.73,23.21
E02004552,Harlow 009,6361,783,558,838,842,760,901,813,605,229,32,1341,5020,1679,21.08,78.92,26.4
E02004553,Harlow 010,7170,1119,745,970,1146,807,915,629,495,306,38,1864,5306,1468,26.0,74.0,20.47
E02004554,Harlow 011,7278,1029,792,943,1089,904,993,724,548,217,39,1821,5457,1528,25.02,74.98,20.99
E02004555,Maldon 001,6435,620,539,670,558,834,1008,997,836,308,65,1159,5276,2206,18.01,81.99,34.28
E02004556,Maldon 002,7491,734,673,609,589,895,1324,1060,1085,439,83,1407,6084,2667,18.78,81.22,35.6
E02004557,Maldon 003,8548,929,801,1045,992,1183,1229,1086,858,347,78,1730,6818,2369,20.24,79.76,27.71
E02004558,Maldon 004,6939,669,543,865,723,794,1072,779,824,538,132,1212,5727,2273,17.47,82.53,32.76
E02004559,Maldon 005,7711,677,710,912,707,920,1257,1066,943,455,64,1387,6324,2528,17.99,82.01,32.78
E02004560,Maldon 006,9177,996,820,1006,931,1119,1528,1271,1020,368,118,1816,7361,2777,19.79,80.21,30.26
E02004561,Maldon 007,10667,960,924,1255,883,1333,1862,1580,1277,528,65,1884,8783,3450,17.66,82.34,32.34
E02004562,Maldon 008,7958,763,602,811,656,1035,1223,1262,1075,444,87,1365,6593,2868,17.15,82.85,36.04
E02004563,Rochford 001,6559,488,488,695,497,743,1026,1019,1079,451,73,976,5583,2622,14.88,85.12,39.98
E02004564,Rochford 002,8254,760,717,1018,807,1006,1333,1149,936,455,73,1477,6777,2613,17.89,82.11,31.66
E02004565,Rochford 003,16008,1629,1426,2013,1687,2001,2450,1933,1838,882,149,3055,12953,4802,19.08,80.92,30.0
E02004566,Rochford 004,5990,757,587,864,758,758,883,595,463,243,82,1344,4646,1383,22.44,77.56,23.09
E02004567,Rochford 005,8260,803,798,890,811,1180,1216,987,941,543,91,1601,6659,2562,19.38,80.62,31.02
E02004568,Rochford 006,9213,1159,938,1246,1250,1402,1312,845,720,275,66,2097,7116,1906,22.76,77.24,20.69
E02004569,Rochford 007,8055,914,663,1119,1062,1089,1114,868,743,419,64,1577,6478,2094,19.58,80.42,26.0
E02004570,Rochford 008,8934,905,847,1036,968,1215,1222,1024,1031,559,127,1752,7182,2741,19.61,80.39,30.68
E02004571,Rochford 009,8190,767,768,936,796,1050,1222,1021,988,528,114,1535,6655,2651,18.74,81.26,32.37
E02004572,Rochford 010,7905,801,755,1008,827,941,1263,1075,857,317,61,1556,6349,2310,19.68,80.32,29.22
E02004573,Tendring 001,6529,884,595,1015,735,713,872,782,553,305,75,1479,5050,1715,22.65,77.35,26.27
E02004574,Tendring 002,7824,1064,822,1063,898,859,959,855,847,385,72,1886,5938,2159,24.11,75.89,27.59
E02004575,Tendring 003,11687,1237,956,1262,1231,1471,1860,1563,1323,648,136,2193,9494,3670,18.76,81.24,31.4
E02004576,Tendring 004,9110,892,805,898,836,1023,1343,1358,1238,589,128,1697,7413,3313,18.63,81.37,36.37
E02004577,Tendring 005,5680,602,484,639,557,667,988,834,599,261,49,1086,4594,1743,19.12,80.88,30.69
E02004578,Tendring 006,7331,600,493,658,494,614,967,1208,1391,711,195,1093,6238,3505,14.91,85.09,47.81
E02004579,Tendring 007,7266,654,552,603,597,775,1165,1242,1160,455,63,1206,6060,2920,16.6,83.4,40.19
E02004580,Tendring 008,12194,882,911,1031,789,1114,1661,1987,2345,1197,277,1793,10401,5806,14.7,85.3,47.61
E02004581,Tendring 009,7917,738,679,807,692,928,1212,1127,1137,480,117,1417,6500,2861,17.9,82.1,36.14
E02004582,Tendring 010,7003,546,483,717,505,610,950,1155,1326,597,114,1029,5974,3192,14.69,85.31,45.58
E02004583,Tendring 011,8853,906,730,1003,795,1024,1248,1230,1272,534,111,1636,7217,3147,18.48,81.52,35.55
E02004584,Tendring 012,6692,403,348,504,376,512,844,1207,1600,739,159,751,5941,3705,11.22,88.78,55.36
E02004585,Tendring 013,8674,1031,759,1184,919,877,1140,1096,1148,436,84,1790,6884,2764,20.64,79.36,31.87
E02004586,Tendring 014,8369,892,657,1090,707,757,1172,1132,1160,655,147,1549,6820,3094,18.51,81.49,36.97
E02004587,Tendring 015,8118,1174,817,1143,820,819,1029,1003,864,372,77,1991,6127,2316,24.53,75.47,28.53
E02004588,Tendring 016,7179,847,614,1185,792,754,1046,791,622,390,138,1461,5718,1941,20.35,79.65,27.04
E02004589,Tendring 017,7733,929,675,1046,706,743,1119,974,928,469,144,1604,6129,2515,20.74,79.26,32.52
E02004590,Tendring 018,8402,666,561,773,592,828,1321,1433,1529,608,91,1227,7175,3661,14.6,85.4,43.57
E02004591,Uttlesford 001,7434,799,789,768,703,1051,1246,947,701,333,97,1588,5846,2078,21.36,78.64,27.95
E02004592,Uttlesford 002,13668,1566,1381,1476,1767,1901,1903,1455,1243,736,240,2947,10721,3674,21.56,78.44,26.88
E02004593,Uttlesford 003,8709,983,898,761,775,1220,1480,1166,938,401,87,1881,6828,2592,21.6,78.4,29.76
E02004594,Uttlesford 004,8716,976,831,1123,1029,1164,1309,969,873,348,94,1807,6909,2284,20.73,79.27,26.2
E02004595,Uttlesford 005,14491,1957,1316,1570,1919,2046,2209,1538,1235,558,143,3273,11218,3474,22.59,77.41,23.97
E02004596,Uttlesford 006,10604,1639,1053,1248,1485,1545,1468,1019,774,313,60,2692,7912,2166,25.39,74.61,20.43
E02004597,Uttlesford 007,8641,1064,774,1056,1070,1170,1358,965,730,366,88,1838,6803,2149,21.27,78.73,24.87
E02004598,Uttlesford 008,11206,1351,1364,1269,1097,1536,1706,1251,1007,512,113,2715,8491,2883,24.23,75.77,25.73
E02004599,Uttlesford 009,7815,855,817,822,697,1140,1354,930,777,338,85,1672,6143,2130,21.39,78.61,27.26
E02004600,Cheltenham 001,5447,661,396,630,890,620,812,671,540,194,33,1057,4390,1438,19.41,80.59,26.4
E02004601,Cheltenham 002,5377,535,378,344,563,634,789,778,812,450,94,913,4464,2134,16.98,83.02,39.69
E02004602,Cheltenham 003,6392,940,595,844,1023,763,765,662,503,238,59,1535,4857,1462,24.01,75.99,22.87
E02004603,Cheltenham 004,8265,785,495,3172,1123,770,703,567,391,211,48,1280,6985,1217,15.49,84.51,14.72
E02004604,Cheltenham 005,8114,1308,815,1188,1317,971,1027,730,459,239,60,2123,5991,1488,26.16,73.84,18.34
E02004605,Cheltenham 006,5615,786,557,757,821,672,762,601,456,169,34,1343,4272,1260,23.92,76.08,22.44
E02004606,Cheltenham 007,10067,1157,749,1988,1817,1164,1242,891,573,368,118,1906,8161,1950,18.93,81.07,19.37
E02004607,Cheltenham 008,9458,871,501,1967,1630,1160,1221,984,677,329,118,1372,8086,2108,14.51,85.49,22.29
E02004608,Cheltenham 009,10290,477,1285,2376,1425,1090,1217,942,758,515,205,1762,8528,2420,17.12,82.88,23.52
E02004609,Cheltenham 010,7012,817,541,873,886,935,1021,730,778,377,54,1358,5654,1939,19.37,80.63,27.65
E02004610,Cheltenham 011,7724,629,774,1161,815,856,1046,879,883,556,125,1403,6321,2443,18.16,81.84,31.63
E02004611,Cheltenham 012,11499,1378,1481,1105,1260,1807,1719,1127,948,563,111,2859,8640,2749,24.86,75.14,23.91
E02004612,Cheltenham 013,9101,1010,777,872,1044,1253,1404,1083,971,583,104,1787,7314,2741,19.64,80.36,30.12
E02004613,Cheltenham 014,6470,705,706,445,524,877,1102,825,775,410,101,1411,5059,2111,21.81,78.19,32.63
E02004614,Cheltenham 015,5475,709,474,399,598,781,789,648,569,389,119,1183,4292,1725,21.61,78.39,31.51
E02004615,Cotswold 001,8478,675,738,616,612,950,1467,1353,1258,662,147,1413,7065,3420,16.67,83.33,40.34
E02004616,Cotswold 002,9651,904,678,932,887,1198,1522,1349,1280,737,164,1582,8069,3530,16.39,83.61,36.58
E02004617,Cotswold 003,9206,1019,829,848,971,1240,1413,1175,1089,518,104,1848,7358,2886,20.07,79.93,31.35
E02004618,Cotswold 004,7298,708,700,693,630,912,1315,1176,803,291,70,1408,5890,2340,19.29,80.71,32.06
E02004619,Cotswold 005,7366,652,606,613,602,948,1297,1215,942,411,80,1258,6108,2648,17.08,82.92,35.95
E02004620,Cotswold 006,8324,960,871,927,920,1159,1301,1027,787,311,61,1831,6493,2186,22.0,78.0,26.26
E02004621,Cotswold 007,6551,531,394,1251,657,761,794,657,742,594,170,925,5626,2163,14.12,85.88,33.02
E02004622,Cotswold 008,7586,768,626,1301,1058,872,982,761,701,388,129,1394,6192,1979,18.38,81.62,26.09
E02004623,Cotswold 009,9101,999,770,823,819,1126,1440,1321,1144,551,108,1769,7332,3124,19.44,80.56,34.33
E02004624,Cotswold 010,6595,704,600,662,567,838,1171,907,783,304,59,1304,5291,2053,19.77,80.23,31.13
E02004625,Cotswold 011,9706,1069,805,932,971,1245,1525,1406,1176,490,87,1874,7832,3159,19.31,80.69,32.55
E02004626,Forest of Dean 001,10308,801,1077,1804,731,1013,1591,1435,1208,565,83,1878,8430,3291,18.22,81.78,31.93
E02004627,Forest of Dean 002,6187,669,408,807,696,702,896,820,767,330,92,1077,5110,2009,17.41,82.59,32.47
E02004628,Forest of Dean 003,8053,875,739,921,775,1058,1267,1100,884,357,77,1614,6439,2418,20.04,79.96,30.03
E02004629,Forest of Dean 004,13098,1550,1098,1677,1529,1609,1929,1729,1282,567,128,2648,10450,3706,20.22,79.78,28.29
E02004630,Forest of Dean 005,6614,587,524,675,556,742,1142,1013,863,411,101,1111,5503,2388,16.8,83.2,36.11
E02004631,Forest of Dean 006,5099,400,439,401,310,623,1057,871,712,238,48,839,4260,1869,16.45,83.55,36.65
E02004632,Forest of Dean 007,10893,1139,965,1274,1178,1237,1671,1491,1216,584,138,2104,8789,3429,19.32,80.68,31.48
E02004633,Forest of Dean 008,8486,806,742,881,763,1054,1458,1300,1042,375,65,1548,6938,2782,18.24,81.76,32.78
E02004634,Forest of Dean 009,10614,1178,925,1418,1039,1219,1640,1317,1214,556,108,2103,8511,3195,19.81,80.19,30.1
E02004635,Forest of Dean 010,7439,807,576,956,756,863,1069,1011,906,423,72,1383,6056,2412,18.59,81.41,32.42
E02004636,Gloucester 001,7928,806,658,1116,848,940,1321,928,825,395,91,1464,6464,2239,18.47,81.53,28.24
E02004637,Gloucester 002,9144,838,663,1807,1177,1148,1137,993,743,478,160,1501,7643,2374,16.42,83.58,25.96
E02004638,Gloucester 003,5746,669,560,683,681,818,846,633,532,247,77,1229,4517,1489,21.39,78.61,25.91
E02004639,Gloucester 004,10088,980,683,2306,1830,1193,1184,813,649,314,136,1663,8425,1912,16.48,83.52,18.95
E02004640,Gloucester 005,8223,1291,1031,1296,1368,1093,925,653,366,166,34,2322,5901,1219,28.24,71.76,14.82
E02004641,Gloucester 006,7371,729,537,678,731,881,1085,929,1112,583,106,1266,6105,2730,17.18,82.82,37.04
E02004642,Gloucester 007,11963,1595,1348,1531,1562,1630,1748,1306,813,363,67,2943,9020,2549,24.6,75.4,21.31
E02004643,Gloucester 008,7975,1221,972,1199,1228,973,1127,646,358,226,25,2193,5782,1255,27.5,72.5,15.74
E02004644,Gloucester 009,8914,1295,792,1287,1276,1129,1317,863,593,298,64,2087,6827,1818,23.41,76.59,20.39
E02004645,Gloucester 010,9135,1053,763,1166,1114,1147,1501,1155,837,345,54,1816,7319,2391,19.88,80.12,26.17
E02004646,Gloucester 011,8924,1347,803,1134,1251,1062,1236,983,705,331,72,2150,6774,2091,24.09,75.91,23.43
E02004647,Gloucester 012,5958,679,538,704,603,632,948,771,645,353,85,1217,4741,1854,20.43,79.57,31.12
E02004648,Gloucester 013,5747,615,452,703,623,592,812,716,853,335,46,1067,4680,1950,18.57,81.43,33.93
E02004649,Gloucester 014,7301,955,676,1113,1135,1052,1075,631,401,181,82,1631,5670,1295,22.34,77.66,17.74
E02004650,Gloucester 015,14711,2670,1572,2363,2670,2123,1607,958,531,196,21,4242,10469,1706,28.84,71.16,11.6
E02004651,Stroud 001,10045,1579,908,1299,1476,1392,1256,1022,760,315,38,2487,7558,2135,24.76,75.24,21.25
E02004652,Stroud 002,6599,534,622,500,431,858,1097,1011,1001,458,87,1156,5443,2557,17.52,82.48,38.75
E02004653,Stroud 003,6861,674,633,695,683,880,1171,982,749,336,58,1307,5554,2125,19.05,80.95,30.97
E02004654,Stroud 004,11870,1315,1151,1324,1400,1681,1779,1424,1148,530,118,2466,9404,3220,20.78,79.22,27.13
E02004655,Stroud 005,8031,873,918,997,920,1023,1173,991,728,353,55,1791,6240,2127,22.3,77.7,26.48
E02004656,Stroud 006,11687,1187,1050,1643,1400,1674,1902,1379,882,472,98,2237,9450,2831,19.14,80.86,24.22
E02004657,Stroud 007,6817,637,705,707,629,1006,1221,887,687,300,38,1342,5475,1912,19.69,80.31,28.05
E02004658,Stroud 008,6260,571,675,686,527,928,1096,736,669,337,35,1246,5014,1777,19.9,80.1,28.39
E02004659,Stroud 009,6911,731,578,675,647,851,1071,1045,886,381,46,1309,5602,2358,18.94,81.06,34.12
E02004660,Stroud 010,6685,601,633,504,448,784,1057,964,989,599,106,1234,5451,2658,18.46,81.54,39.76
E02004661,Stroud 011,8617,857,703,945,882,1130,1349,1157,1040,479,75,1560,7057,2751,18.1,81.9,31.93
E02004662,Stroud 012,6454,640,533,718,700,858,1079,885,679,329,33,1173,5281,1926,18.17,81.83,29.84
E02004663,Stroud 013,6602,663,566,670,657,937,1041,957,712,329,70,1229,5373,2068,18.62,81.38,31.32
E02004664,Stroud 014,7650,1051,720,947,1006,1064,1031,777,612,366,76,1771,5879,1831,23.15,76.85,23.93
E02004665,Stroud 015,8875,906,907,941,778,1192,1339,1215,1056,450,91,1813,7062,2812,20.43,79.57,31.68
E02004666,Tewkesbury 001,12345,1544,1249,1557,1798,1807,1728,1279,905,367,111,2793,9552,2662,22.62,77.38,21.56
E02004667,Tewkesbury 002,11447,1147,821,1375,1314,1351,1751,1511,1368,659,150,1968,9479,3688,17.19,82.81,32.22
E02004668,Tewkesbury 003,9179,918,719,744,857,1031,1453,1427,1324,577,129,1637,7542,3457,17.83,82.17,37.66
E02004669,Tewkesbury 004,7496,798,642,680,622,955,1171,1156,946,433,93,1440,6056,2628,19.21,80.79,35.06
E02004670,Tewkesbury 005,15710,2184,1436,1740,2138,2009,2170,1564,1443,827,199,3620,12090,4033,23.04,76.96,25.67
E02004671,Tewkesbury 006,7033,789,619,692,736,846,1101,1108,803,286,53,1408,5625,2250,20.02,79.98,31.99
E02004672,Tewkesbury 007,13226,1578,1198,1777,1663,1735,1873,1369,1229,672,132,2776,10450,3402,20.99,79.01,25.72
E02004673,Tewkesbury 008,6902,831,560,759,758,816,1051,858,798,401,70,1391,5511,2127,20.15,79.85,30.82
E02004674,Tewkesbury 009,11681,1735,1027,1572,1890,1373,1493,1211,867,403,110,2762,8919,2591,23.65,76.35,22.18
E02004675,Basingstoke and Deane 001,7338,891,729,814,911,942,1145,830,708,320,48,1620,5718,1906,22.08,77.92,25.97
E02004676,Basingstoke and Deane 002,7708,771,672,755,706,985,1345,1064,904,449,57,1443,6265,2474,18.72,81.28,32.1
E02004677,Basingstoke and Deane 003,7584,918,898,676,646,1034,1323,957,745,325,62,1816,5768,2089,23.95,76.05,27.54
E02004678,Basingstoke and Deane 004,7259,712,686,691,643,969,1340,970,822,359,67,1398,5861,2218,19.26,80.74,30.56
E02004679,Basingstoke and Deane 005,9445,1183,927,1055,1193,1322,1540,1013,782,357,73,2110,7335,2225,22.34,77.66,23.56
E02004680,Basingstoke and Deane 006,7665,1170,625,962,1261,1320,1050,744,393,120,20,1795,5870,1277,23.42,76.58,16.66
E02004681,Basingstoke and Deane 007,13913,2312,1454,2170,2616,1976,1461,884,749,228,63,3766,10147,1924,27.07,72.93,13.83
E02004682,Basingstoke and Deane 008,8314,1150,746,1119,1222,1272,1240,844,509,177,35,1896,6418,1565,22.8,77.2,18.82
E02004683,Basingstoke and Deane 009,7459,933,682,1171,1202,1008,1025,572,475,316,75,1615,5844,1438,21.65,78.35,19.28
E02004684,Basingstoke and Deane 010,10513,1585,961,1542,1882,1499,1339,745,646,273,41,2546,7967,1705,24.22,75.78,16.22
E02004685,Basingstoke and Deane 011,7705,884,497,1324,1625,1038,944,612,459,263,59,1381,6324,1393,17.92,82.08,18.08
E02004686,Basingstoke and Deane 012,8476,1090,649,1409,1648,1173,1002,671,493,273,68,1739,6737,1505,20.52,79.48,17.76
E02004687,Basingstoke and Deane 013,7527,1167,884,1023,1137,1046,1010,595,472,179,14,2051,5476,1260,27.25,72.75,16.74
E02004688,Basingstoke and Deane 014,7797,1005,662,1097,1098,995,1143,731,631,357,78,1667,6130,1797,21.38,78.62,23.05
E02004689,Basingstoke and Deane 015,5435,521,446,414,437,680,792,812,870,364,99,967,4468,2145,17.79,82.21,39.47
E02004690,Basingstoke and Deane 016,7833,929,705,1085,1073,1059,1210,840,598,275,59,1634,6199,1772,20.86,79.14,22.62
E02004691,Basingstoke and Deane 017,7736,790,637,685,636,966,1400,1096,917,480,129,1427,6309,2622,18.45,81.55,33.89
E02004692,Basingstoke and Deane 018,7079,641,611,507,585,908,1118,1072,1092,477,68,1252,5827,2709,17.69,82.31,38.27
E02004693,Basingstoke and Deane 019,7225,1093,695,940,1033,1001,1010,761,477,176,39,1788,5437,1453,24.75,75.25,20.11
E02004694,Basingstoke and Deane 020,7134,856,678,710,762,1021,1092,825,756,349,85,1534,5600,2015,21.5,78.5,28.25
E02004695,Basingstoke and Deane 021,8609,1229,1079,1075,1116,1587,1385,661,373,97,7,2308,6301,1138,26.81,73.19,13.22
E02004696,Basingstoke and Deane 022,6828,833,615,681,661,1006,1033,842,746,324,87,1448,5380,1999,21.21,78.79,29.28
E02004697,East Hampshire 001,6769,721,736,730,516,932,1098,848,729,336,123,1457,5312,2036,21.52,78.48,30.08
E02004698,East Hampshire 002,6300,834,588,929,799,796,768,571,547,357,111,1422,4878,1586,22.57,77.43,25.17
E02004699,East Hampshire 003,10846,1050,985,1215,1183,1418,1655,1293,1208,672,167,2035,8811,3340,18.76,81.24,30.79
E02004700,East Hampshire 004,5642,879,540,815,920,769,850,433,300,102,34,1419,4223,869,25.15,74.85,15.4
E02004702,East Hampshire 006,8157,939,763,1102,1019,1136,1257,914,678,314,35,1702,6455,1941,20.87,79.13,23.8
E02004703,East Hampshire 007,12287,1222,1238,1170,918,1627,2057,1702,1567,643,143,2460,9827,4055,20.02,79.98,33.0
E02004704,East Hampshire 008,5589,593,494,562,548,772,997,736,600,241,46,1087,4502,1623,19.45,80.55,29.04
E02004705,East Hampshire 009,9341,1094,1000,1034,831,1388,1380,1023,949,526,116,2094,7247,2614,22.42,77.58,27.98
E02004706,East Hampshire 010,7786,835,748,764,669,1074,1178,1018,891,466,143,1583,6203,2518,20.33,79.67,32.34
E02004707,East Hampshire 011,11523,1059,1479,1207,822,1449,1822,1546,1285,680,174,2538,8985,3685,22.03,77.97,31.98
E02004708,East Hampshire 012,9219,1093,823,1098,1141,1156,1253,1037,977,517,124,1916,7303,2655,20.78,79.22,28.8
E02004709,East Hampshire 013,8409,969,746,871,842,1031,1394,1183,912,411,50,1715,6694,2556,20.39,79.61,30.4
E02004710,East Hampshire 014,6458,708,589,717,593,802,1111,870,751,269,48,1297,5161,1938,20.08,79.92,30.01
E02006829,East Hampshire 016,7096,625,587,629,644,858,1117,1011,923,556,146,1212,5884,2636,17.08,82.92,37.15
E02006838,East Hampshire 017,6886,538,553,638,477,811,1229,1013,983,517,127,1091,5795,2640,15.84,84.16,38.34
E02004712,Eastleigh 001,9007,957,1148,750,699,1313,1322,922,1106,635,155,2105,6902,2818,23.37,76.63,31.29
E02004713,Eastleigh 002,8042,899,785,819,964,1050,1043,1055,910,394,123,1684,6358,2482,20.94,79.06,30.86
E02004714,Eastleigh 003,7723,770,629,839,905,1043,1060,1043,919,419,96,1399,6324,2477,18.11,81.89,32.07
E02004715,Eastleigh 004,9314,1204,830,1361,1586,1060,1135,984,707,347,100,2034,7280,2138,21.84,78.16,22.95
E02004716,Eastleigh 005,8903,1099,840,1093,1193,1107,1293,1040,808,355,75,1939,6964,2278,21.78,78.22,25.59
E02004717,Eastleigh 006,11968,1650,1228,1887,2007,1617,1456,905,678,439,101,2878,9090,2123,24.05,75.95,17.74
E02004718,Eastleigh 007,9292,1189,799,1680,1718,1257,1160,786,427,203,73,1988,7304,1489,21.39,78.61,16.02
E02004719,Eastleigh 008,10689,1187,1095,1224,1167,1502,1669,1292,1015,426,112,2282,8407,2845,21.35,78.65,26.62
E02004720,Eastleigh 009,11063,1064,840,1333,1314,1344,1706,1463,1213,626,160,1904,9159,3462,17.21,82.79,31.29
E02004721,Eastleigh 010,10819,1773,1268,1433,1717,1752,1343,824,479,199,31,3041,7778,1533,28.11,71.89,14.17
E02004722,Eastleigh 011,7182,845,641,872,813,858,1010,899,751,393,100,1486,5696,2143,20.69,79.31,29.84
E02004723,Eastleigh 012,9919,1076,903,1117,1166,1298,1438,1205,1064,551,101,1979,7940,2921,19.95,80.05,29.45
E02004724,Eastleigh 013,8408,1055,740,1175,1200,1075,1217,923,660,315,48,1795,6613,1946,21.35,78.65,23.14
E02004725,Eastleigh 014,5439,585,407,570,636,692,824,715,562,335,113,992,4447,1725,18.24,81.76,31.72
E02004726,Eastleigh 015,5816,631,493,636,657,792,936,733,622,284,32,1124,4692,1671,19.33,80.67,28.73
E02004727,Fareham 001,9958,1318,1112,1133,1296,1559,1598,906,684,301,51,2430,7528,1942,24.4,75.6,19.5
E02004728,Fareham 002,9275,1054,887,1229,1151,1233,1422,1004,788,384,123,1941,7334,2299,20.93,79.07,24.79
E02004729,Fareham 003,7456,806,664,1049,1001,927,1036,780,788,334,71,1470,5986,1973,19.72,80.28,26.46
E02004730,Fareham 004,8928,758,740,875,833,1052,1506,1154,1130,721,159,1498,7430,3164,16.78,83.22,35.44
E02004731,Fareham 005,8007,757,719,1000,870,964,1283,1062,831,412,109,1476,6531,2414,18.43,81.57,30.15
E02004732,Fareham 006,8617,967,779,968,982,1101,1318,1072,873,463,94,1746,6871,2502,20.26,79.74,29.04
E02004733,Fareham 007,8083,868,727,992,1003,1018,1249,1027,775,349,75,1595,6488,2226,19.73,80.27,27.54
E02004734,Fareham 008,10669,965,917,1480,1372,1386,1621,1219,1032,534,143,1882,8787,2928,17.64,82.36,27.44
E02004735,Fareham 009,7592,724,544,785,767,873,1099,1035,1073,592,100,1268,6324,2800,16.7,83.3,36.88
E02004736,Fareham 010,7948,719,640,744,762,991,1178,1125,1169,514,106,1359,6589,2914,17.1,82.9,36.66
E02004737,Fareham 011,7976,989,709,1279,1227,952,1015,707,634,372,92,1698,6278,1805,21.29,78.71,22.63
E02004738,Fareham 012,7455,717,583,869,787,967,1115,1005,872,441,99,1300,6155,2417,17.44,82.56,32.42
E02004739,Fareham 013,6985,557,499,759,621,732,1036,1002,1047,619,113,1056,5929,2781,15.12,84.88,39.81
E02004740,Fareham 014,7284,654,562,610,638,855,1103,1058,1094,591,119,1216,6068,2862,16.69,83.31,39.29
E02004741,Gosport 001,7891,802,800,1001,913,943,1110,997,868,386,71,1602,6289,2322,20.3,79.7,29.43
E02004742,Gosport 002,7521,831,633,966,857,845,1107,1055,796,372,59,1464,6057,2282,19.47,80.53,30.34
E02004743,Gosport 003,7456,796,677,969,965,1018,1152,896,673,265,45,1473,5983,1879,19.76,80.24,25.2
E02004744,Gosport 004,9838,1860,1147,1795,1707,1120,1033,668,337,152,19,3007,6831,1176,30.57,69.43,11.95
E02004745,Gosport 005,9043,1069,809,1567,1240,1203,1335,876,670,237,37,1878,7165,1820,20.77,79.23,20.13
E02004746,Gosport 006,11239,1080,1187,1068,1068,1525,1552,1439,1476,684,160,2267,8972,3759,20.17,79.83,33.45
E02004747,Gosport 007,6838,744,552,1094,876,808,1028,804,587,296,49,1296,5542,1736,18.95,81.05,25.39
E02004748,Gosport 008,10054,1098,844,1774,1436,1187,1427,1025,809,391,63,1942,8112,2288,19.32,80.68,22.76
E02004749,Gosport 009,7247,601,675,659,613,810,1042,1017,986,656,188,1276,5971,2847,17.61,82.39,39.29
E02004750,Gosport 010,7711,699,576,949,845,915,1287,1028,812,457,143,1275,6436,2440,16.53,83.47,31.64
E02004751,Hart 001,8051,809,744,841,870,1112,1216,977,950,438,94,1553,6498,2459,19.29,80.71,30.54
E02004752,Hart 002,8062,877,850,748,911,1172,1302,1035,852,289,26,1727,6335,2202,21.42,78.58,27.31
E02004753,Hart 003,10619,1154,988,1377,1373,1451,1497,1158,1086,470,65,2142,8477,2779,20.17,79.83,26.17
E02004754,Hart 004,7183,952,704,554,769,1027,1048,841,831,375,82,1656,5527,2129,23.05,76.95,29.64
E02004755,Hart 005,12398,1682,1272,1462,1846,2255,1615,884,735,494,153,2954,9444,2266,23.83,76.17,18.28
E02004756,Hart 006,8610,1001,931,872,977,1316,1467,978,709,280,79,1932,6678,2046,22.44,77.56,23.76
E02004757,Hart 007,7938,843,794,668,672,1172,1260,934,1003,499,93,1637,6301,2529,20.62,79.38,31.86
E02004758,Hart 008,8953,1062,879,857,906,1382,1409,957,890,478,133,1941,7012,2458,21.68,78.32,27.45
E02004759,Hart 009,8511,1015,914,766,889,1301,1343,845,879,451,108,1929,6582,2283,22.66,77.34,26.82
E02004760,Hart 010,9986,1635,1107,1028,1491,1531,1328,779,641,342,104,2742,7244,1866,27.46,72.54,18.69
E02004761,Hart 011,6762,789,648,1090,990,830,864,635,569,277,70,1437,5325,1551,21.25,78.75,22.94
E02004764,Havant 003,8260,638,625,987,686,801,1362,1142,1205,705,109,1263,6997,3161,15.29,84.71,38.27
E02004765,Havant 004,6095,587,457,860,649,725,962,801,701,293,60,1044,5051,1855,17.13,82.87,30.43
E02004766,Havant 005,7056,894,627,1049,887,820,980,719,610,370,100,1521,5535,1799,21.56,78.44,25.5
E02004767,Havant 006,6362,1079,746,987,903,694,807,548,388,180,30,1825,4537,1146,28.69,71.31,18.01
E02004768,Havant 007,5610,672,543,864,664,650,832,712,438,192,43,1215,4395,1385,21.66,78.34,24.69
E02004769,Havant 008,6371,1026,739,1100,882,713,812,556,345,155,43,1765,4606,1099,27.7,72.3,17.25
E02004770,Havant 009,7077,1054,756,1116,978,805,968,672,443,264,21,1810,5267,1400,25.58,74.42,19.78
E02004771,Havant 010,9399,1314,1082,1510,1295,1085,1246,881,610,306,70,2396,7003,1867,25.49,74.51,19.86
E02004772,Havant 011,9580,900,824,1227,999,1253,1521,1252,998,513,93,1724,7856,2856,18.0,82.0,29.81
E02004774,Havant 013,10038,894,777,838,829,1133,1450,1547,1428,881,261,1671,8367,4117,16.65,83.35,41.01
E02004775,Havant 014,10098,980,874,1211,1188,1243,1497,1304,1075,567,159,1854,8244,3105,18.36,81.64,30.75
E02004776,Havant 015,6068,420,446,581,389,600,946,1070,1037,478,101,866,5202,2686,14.27,85.73,44.26
E02004777,Havant 016,5599,459,386,630,418,547,761,813,960,487,138,845,4754,2398,15.09,84.91,42.83
E02004778,Havant 017,6241,466,354,644,469,585,1016,1015,1081,497,114,820,5421,2707,13.14,86.86,43.37
E02006822,Havant 018,9181,908,778,1196,1032,1009,1547,1146,886,559,120,1686,7495,2711,18.36,81.64,29.53
E02006830,Havant 019,6873,952,724,1149,899,823,855,664,548,217,42,1676,5197,1471,24.39,75.61,21.4
E02006831,Havant 020,6312,534,491,757,646,678,932,888,813,456,117,1025,5287,2274,16.24,83.76,36.03
E02004779,New Forest 001,10763,955,901,944,846,1160,1796,1748,1425,766,222,1856,8907,4161,17.24,82.76,38.66
E02004780,New Forest 002,6008,710,511,749,737,682,848,750,633,299,89,1221,4787,1771,20.32,79.68,29.48
E02004781,New Forest 003,8406,985,763,1134,1081,1158,1332,931,613,330,79,1748,6658,1953,20.79,79.21,23.23
E02004782,New Forest 004,7997,883,725,1085,878,1021,1108,910,794,471,122,1608,6389,2297,20.11,79.89,28.72
E02004783,New Forest 005,7322,864,688,932,932,990,1125,804,585,324,78,1552,5770,1791,21.2,78.8,24.46
E02004784,New Forest 006,5743,457,409,496,389,673,1005,862,813,492,147,866,4877,2314,15.08,84.92,40.29
E02004785,New Forest 007,5666,437,417,518,406,695,922,884,841,433,113,854,4812,2271,15.07,84.93,40.08
E02004786,New Forest 008,8636,1066,770,1210,1244,1023,1257,1037,718,240,71,1836,6800,2066,21.26,78.74,23.92
E02004787,New Forest 009,7443,648,509,722,633,748,1069,1109,1184,653,168,1157,6286,3114,15.54,84.46,41.84
E02004788,New Forest 010,7171,666,784,658,515,945,1171,1014,921,412,85,1450,5721,2432,20.22,79.78,33.91
E02004789,New Forest 011,10693,1238,991,1269,1133,1148,1599,1331,1133,677,174,2229,8464,3315,20.85,79.15,31.0
E02004790,New Forest 012,8099,942,725,963,877,968,1086,919,880,609,130,1667,6432,2538,20.58,79.42,31.34
E02004791,New Forest 013,5608,714,679,669,687,703,729,668,510,205,44,1393,4215,1427,24.84,75.16,25.45
E02004792,New Forest 014,8439,811,607,855,766,870,1340,1358,1181,542,109,1418,7021,3190,16.8,83.2,37.8
E02004793,New Forest 015,7567,559,608,665,480,834,1243,1191,1182,609,196,1167,6400,3178,15.42,84.58,42.0
E02004794,New Forest 016,6963,636,640,575,566,814,1072,1162,966,404,128,1276,5687,2660,18.33,81.67,38.2
E02004795,New Forest 017,9411,648,757,1086,739,1125,1441,1348,1286,770,211,1405,8006,3615,14.93,85.07,38.41
E02004796,New Forest 018,9827,718,762,843,646,975,1478,1607,1779,849,170,1480,8347,4405,15.06,84.94,44.83
E02004797,New Forest 019,8213,899,747,992,880,969,1232,1102,869,420,103,1646,6567,2494,20.04,79.96,30.37
E02004798,New Forest 020,6330,718,628,802,676,743,884,705,710,392,72,1346,4984,1879,21.26,78.74,29.68
E02004799,New Forest 021,8143,724,506,876,763,808,993,1024,1334,831,284,1230,6913,3473,15.1,84.9,42.65
E02004800,New Forest 022,7664,328,336,457,386,552,1031,1454,1780,1009,331,664,7000,4574,8.66,91.34,59.68
E02004801,New Forest 023,7974,463,502,498,444,661,1057,1350,1697,961,341,965,7009,4349,12.1,87.9,54.54
E02004802,Rushmoor 001,6621,874,570,979,840,787,979,701,544,271,76,1444,5177,1592,21.81,78.19,24.04
E02004803,Rushmoor 002,7310,975,729,1079,1035,1065,1064,637,507,174,45,1704,5606,1363,23.31,76.69,18.65
E02004804,Rushmoor 003,6927,810,646,813,900,1040,1055,749,647,225,42,1456,5471,1663,21.02,78.98,24.01
E02004805,Rushmoor 004,8164,888,730,980,1135,1227,1205,921,678,277,123,1618,6546,1999,19.82,80.18,24.49
E02004806,Rushmoor 005,7900,1083,778,898,1046,1256,1277,826,496,196,44,1861,6039,1562,23.56,76.44,19.77
E02004807,Rushmoor 006,9189,1210,786,1112,1378,1343,1341,835,713,394,77,1996,7193,2019,21.72,78.28,21.97
E02004808,Rushmoor 007,11357,1695,1081,1666,1969,1778,1425,804,548,322,69,2776,8581,1743,24.44,75.56,15.35
E02004809,Rushmoor 008,9447,1680,662,2234,2284,1074,617,379,349,143,25,2342,7105,896,24.79,75.21,9.48
E02004810,Rushmoor 009,7585,992,708,1194,1308,1169,1063,556,397,162,36,1700,5885,1151,22.41,77.59,15.17
E02004811,Rushmoor 010,7532,758,588,940,1031,1096,1170,816,665,356,112,1346,6186,1949,17.87,82.13,25.88
E02004812,Rushmoor 011,6494,752,598,837,864,946,1068,693,515,193,28,1350,5144,1429,20.79,79.21,22.0
E02004813,Rushmoor 012,6073,762,562,749,820,839,963,590,465,253,70,1324,4749,1378,21.8,78.2,22.69
E02004814,Test Valley 001,7053,707,619,856,659,1011,1304,879,692,278,48,1326,5727,1897,18.8,81.2,26.9
E02004815,Test Valley 002,7668,1155,930,1180,1185,1081,967,604,419,134,13,2085,5583,1170,27.19,72.81,15.26
E02004816,Test Valley 003,16965,2977,1484,2400,2931,2224,2057,1294,1001,496,101,4461,12504,2892,26.3,73.7,17.05
E02004817,Test Valley 004,8009,897,718,1101,1064,1097,1183,820,687,356,86,1615,6394,1949,20.16,79.84,24.34
E02004818,Test Valley 005,10103,1127,864,1005,1233,1439,1529,1104,1144,561,97,1991,8112,2906,19.71,80.29,28.76
E02004819,Test Valley 006,8059,816,659,1093,882,1082,1311,841,751,490,134,1475,6584,2216,18.3,81.7,27.5
E02004820,Test Valley 007,7254,824,658,739,936,990,1126,882,718,316,65,1482,5772,1981,20.43,79.57,27.31
E02004821,Test Valley 008,5265,505,450,466,424,661,871,763,767,297,61,955,4310,1888,18.14,81.86,35.86
E02004822,Test Valley 009,7774,727,696,647,608,953,1405,1196,978,477,87,1423,6351,2738,18.3,81.7,35.22
E02004823,Test Valley 010,8654,905,709,797,879,1138,1282,1179,1133,542,90,1614,7040,2944,18.65,81.35,34.02
E02004824,Test Valley 011,5968,523,365,637,521,621,795,784,891,674,157,888,5080,2506,14.88,85.12,41.99
E02004825,Test Valley 012,10748,1146,966,1016,1085,1342,1540,1470,1421,599,163,2112,8636,3653,19.65,80.35,33.99
E02004826,Test Valley 013,8492,1042,821,780,870,1077,1217,1098,1007,431,149,1863,6629,2685,21.94,78.06,31.62
E02004827,Test Valley 014,7496,945,829,813,827,1272,1256,839,476,189,50,1774,5722,1554,23.67,76.33,20.73
E02004828,Test Valley 015,6652,649,596,705,652,850,1003,1011,715,389,82,1245,5407,2197,18.72,81.28,33.03
E02004829,Winchester 001,5878,737,568,569,647,875,834,743,592,243,70,1305,4573,1648,22.2,77.8,28.04
E02004830,Winchester 002,6876,849,651,681,679,1010,1102,856,726,271,51,1500,5376,1904,21.82,78.18,27.69
E02004831,Winchester 003,9705,1211,1027,981,949,1346,1243,970,993,738,247,2238,7467,2948,23.06,76.94,30.38
E02004832,Winchester 004,8461,703,885,785,569,1101,1363,1163,1166,585,141,1588,6873,3055,18.77,81.23,36.11
E02004833,Winchester 005,9967,1203,971,1812,958,1432,1278,930,771,462,150,2174,7793,2313,21.81,78.19,23.21
E02004834,Winchester 006,8146,818,780,1872,998,964,955,683,630,334,112,1598,6548,1759,19.62,80.38,21.59
E02004835,Winchester 007,10996,960,1287,2329,1323,1349,1293,936,864,487,168,2247,8749,2455,20.43,79.57,22.33
E02004836,Winchester 008,6782,614,631,2751,528,629,649,417,336,182,45,1245,5537,980,18.36,81.64,14.45
E02004837,Winchester 009,8176,898,870,1165,741,1076,1167,950,827,390,92,1768,6408,2259,21.62,78.38,27.63
E02004838,Winchester 010,9526,1134,1064,783,917,1363,1467,1188,1033,448,129,2198,7328,2798,23.07,76.93,29.37
E02004839,Winchester 011,8707,890,869,686,727,1060,1501,1363,1053,502,56,1759,6948,2974,20.2,79.8,34.16
E02004840,Winchester 012,9675,1040,835,995,954,1184,1529,1297,1145,570,126,1875,7800,3138,19.38,80.62,32.43
E02004841,Winchester 013,11708,1422,1120,1426,1464,1627,1770,1269,963,544,103,2542,9166,2879,21.71,78.29,24.59
E02004842,Winchester 014,10256,1256,848,1259,1197,1228,1510,1264,1020,510,164,2104,8152,2958,20.51,79.49,28.84
E02004843,Broxbourne 001,6960,760,741,851,745,944,976,724,772,378,69,1501,5459,1943,21.57,78.43,27.92
E02004844,Broxbourne 002,7318,1009,759,998,1023,1020,974,687,479,301,68,1768,5550,1535,24.16,75.84,20.98
E02004845,Broxbourne 003,7985,1043,614,1082,1136,1052,1062,741,724,444,87,1657,6328,1996,20.75,79.25,25.0
E02004846,Broxbourne 004,6184,661,641,677,512,839,1017,717,702,347,71,1302,4882,1837,21.05,78.95,29.71
E02004847,Broxbourne 005,10661,1686,1071,1480,1609,1431,1308,972,720,322,62,2757,7904,2076,25.86,74.14,19.47
E02004848,Broxbourne 006,7662,1105,734,1028,1026,944,1093,798,610,277,47,1839,5823,1732,24.0,76.0,22.61
E02004849,Broxbourne 007,6761,693,605,935,671,837,1222,819,634,297,48,1298,5463,1798,19.2,80.8,26.59
E02004850,Broxbourne 008,7505,925,714,1006,1035,980,1118,743,567,361,56,1639,5866,1727,21.84,78.16,23.01
E02004851,Broxbourne 009,5929,784,605,756,733,754,824,651,520,247,55,1389,4540,1473,23.43,76.57,24.84
E02004852,Broxbourne 010,7795,1062,716,1041,1129,1028,972,723,609,452,63,1778,6017,1847,22.81,77.19,23.69
E02004853,Broxbourne 011,6639,909,696,879,863,821,896,646,538,326,65,1605,5034,1575,24.18,75.82,23.72
E02004854,Broxbourne 012,7730,993,668,1082,1192,919,1119,661,578,422,96,1661,6069,1757,21.49,78.51,22.73
E02004855,Broxbourne 013,8150,1189,780,1289,1473,1102,1017,605,447,217,31,1969,6181,1300,24.16,75.84,15.95
E02004856,Dacorum 001,5688,679,543,540,769,820,921,696,494,187,39,1222,4466,1416,21.48,78.52,24.89
E02004857,Dacorum 002,5977,645,700,657,601,848,947,687,527,292,73,1345,4632,1579,22.5,77.5,26.42
E02004858,Dacorum 003,5154,634,565,641,613,728,744,545,446,203,35,1199,3955,1229,23.26,76.74,23.85
E02004859,Dacorum 004,5259,579,532,414,515,774,870,684,572,279,40,1111,4148,1575,21.13,78.87,29.95
E02004860,Dacorum 005,6003,916,519,861,1117,926,722,591,273,70,8,1435,4568,942,23.9,76.1,15.69
E02004861,Dacorum 006,5492,527,544,468,462,732,856,741,653,399,110,1071,4421,1903,19.5,80.5,34.65
E02004862,Dacorum 007,7994,1145,786,987,1330,1045,918,1001,552,193,37,1931,6063,1783,24.16,75.84,22.3
E02004863,Dacorum 008,8029,1285,778,1035,1375,1031,973,693,435,329,95,2063,5966,1552,25.69,74.31,19.33
E02004864,Dacorum 009,6547,773,554,576,860,1026,967,760,558,374,99,1327,5220,1791,20.27,79.73,27.36
E02004865,Dacorum 010,5681,751,486,777,822,735,888,553,379,226,64,1237,4444,1222,21.77,78.23,21.51
E02004866,Dacorum 011,6760,918,679,827,914,907,955,709,476,270,105,1597,5163,1560,23.62,76.38,23.08
E02004867,Dacorum 012,6657,948,784,636,705,1083,911,659,535,334,62,1732,4925,1590,26.02,73.98,23.88
E02004868,Dacorum 013,7243,1243,645,942,1188,876,849,615,447,327,111,1888,5355,1500,26.07,73.93,20.71
E02004869,Dacorum 014,5792,809,581,524,738,984,857,574,433,230,62,1390,4402,1299,24.0,76.0,22.43
E02004870,Dacorum 015,11353,1620,997,1726,1959,1554,1374,990,633,383,117,2617,8736,2123,23.05,76.95,18.7
E02004871,Dacorum 016,5196,681,467,683,786,685,736,549,369,175,65,1148,4048,1158,22.09,77.91,22.29
E02004872,Dacorum 017,7414,902,673,956,882,942,1059,813,686,444,57,1575,5839,2000,21.24,78.76,26.98
E02004873,Dacorum 018,11528,1425,965,1529,1921,1783,1555,1131,775,375,69,2390,9138,2350,20.73,79.27,20.39
E02004874,Dacorum 019,6224,822,591,782,936,831,903,685,416,196,62,1413,4811,1359,22.7,77.3,21.83
E02004875,Dacorum 020,10166,1514,1129,1393,1673,1380,1238,860,571,304,104,2643,7523,1839,26.0,74.0,18.09
E02004876,Dacorum 021,9349,923,809,1259,1058,1319,1403,1096,967,440,75,1732,7617,2578,18.53,81.47,27.58
E02004877,Dacorum 022,5257,612,510,528,544,773,819,614,514,283,60,1122,4135,1471,21.34,78.66,27.98
E02004896,Hertsmere 001,8319,829,639,1199,833,888,1199,881,957,660,234,1468,6851,2732,17.65,82.35,32.84
E02004897,Hertsmere 002,6695,741,801,894,640,849,972,755,652,332,59,1542,5153,1798,23.03,76.97,26.86
E02004898,Hertsmere 003,7637,898,736,1064,931,923,1087,877,641,346,134,1634,6003,1998,21.4,78.6,26.16
E02004899,Hertsmere 004,5455,741,624,564,621,774,814,598,420,215,84,1365,4090,1317,25.02,74.98,24.14
E02004900,Hertsmere 005,8108,935,936,812,791,1128,1285,896,761,476,88,1871,6237,2221,23.08,76.92,27.39
E02004901,Hertsmere 006,9145,1350,1022,1171,1385,1216,1270,782,586,261,102,2372,6773,1731,25.94,74.06,18.93
E02004902,Hertsmere 007,8433,1475,970,1018,1299,1161,1009,738,466,248,49,2445,5988,1501,28.99,71.01,17.8
E02004903,Hertsmere 008,7680,992,908,1032,1075,1132,1089,648,495,240,69,1900,5780,1452,24.74,75.26,18.91
E02004904,Hertsmere 009,6426,975,632,807,1067,971,831,588,380,140,35,1607,4819,1143,25.01,74.99,17.79
E02004905,Hertsmere 010,6580,829,757,750,769,912,955,709,560,263,76,1586,4994,1608,24.1,75.9,24.44
E02004906,Hertsmere 011,10465,1697,1043,1361,1779,1456,1264,898,622,279,66,2740,7725,1865,26.18,73.82,17.82
E02004907,Hertsmere 012,10071,1357,1036,1143,1220,1420,1394,1041,900,474,86,2393,7678,2501,23.76,76.24,24.83
E02004908,Hertsmere 013,9905,1189,936,973,1016,1334,1373,1075,1179,722,108,2125,7780,3084,21.45,78.55,31.14
E02004909,North Hertfordshire 001,5782,825,459,736,969,799,763,544,409,217,61,1284,4498,1231,22.21,77.79,21.29
E02004910,North Hertfordshire 002,11260,1465,911,1212,1573,1579,1478,1188,1138,603,113,2376,8884,3042,21.1,78.9,27.02
E02004911,North Hertfordshire 003,6727,883,631,804,873,850,963,716,511,408,88,1514,5213,1723,22.51,77.49,25.61
E02004912,North Hertfordshire 004,10624,1177,1046,1235,1390,1602,1627,1099,804,523,121,2223,8401,2547,20.92,79.08,23.97
E02004913,North Hertfordshire 005,15391,1935,1659,1707,2025,2379,2259,1571,1179,531,146,3594,11797,3427,23.35,76.65,22.27
E02004914,North Hertfordshire 006,8231,1177,777,1054,1324,1229,981,715,570,327,77,1954,6277,1689,23.74,76.26,20.52
E02004915,North Hertfordshire 007,5714,709,563,708,847,835,797,542,440,232,41,1272,4442,1255,22.26,77.74,21.96
E02004916,North Hertfordshire 008,7439,805,772,829,694,1035,1028,827,884,472,93,1577,5862,2276,21.2,78.8,30.6
E02004917,North Hertfordshire 009,6392,811,542,746,688,778,924,717,722,372,92,1353,5039,1903,21.17,78.83,29.77
E02004918,North Hertfordshire 010,8522,1045,685,1426,1599,1308,1081,661,414,256,47,1730,6792,1378,20.3,79.7,16.17
E02004919,North Hertfordshire 011,7823,1084,729,885,1210,1227,980,794,568,290,56,1813,6010,1708,23.18,76.82,21.83
E02004920,North Hertfordshire 012,11669,1357,1113,1423,1491,1622,1596,1191,991,679,206,2470,9199,3067,21.17,78.83,26.28
E02004921,North Hertfordshire 013,7904,1014,777,833,1029,1280,1084,759,677,389,62,1791,6113,1887,22.66,77.34,23.87
E02004922,North Hertfordshire 014,9858,1091,997,906,967,1329,1694,1241,1042,493,98,2088,7770,2874,21.18,78.82,29.15
E02004923,North Hertfordshire 015,10234,1238,871,1111,1146,1294,1590,1351,1048,489,96,2109,8125,2984,20.61,79.39,29.16
E02004956,Three Rivers 001,9009,1049,782,1161,1099,1215,1384,953,833,427,106,1831,7178,2319,20.32,79.68,25.74
E02004957,Three Rivers 002,10582,1549,1175,1303,1504,1652,1461,976,663,228,71,2724,7858,1938,25.74,74.26,18.31
E02004958,Three Rivers 003,7923,994,767,894,833,1051,1283,852,745,398,106,1761,6162,2101,22.23,77.77,26.52
E02004959,Three Rivers 004,6119,510,656,726,611,847,935,694,552,415,173,1166,4953,1834,19.06,80.94,29.97
E02004960,Three Rivers 005,5757,619,759,556,476,913,893,645,554,292,50,1378,4379,1541,23.94,76.06,26.77
E02004961,Three Rivers 006,9729,1281,1085,998,1116,1525,1480,998,764,422,60,2366,7363,2244,24.32,75.68,23.07
E02004962,Three Rivers 007,8954,1171,961,955,1228,1358,1300,813,666,397,105,2132,6822,1981,23.81,76.19,22.12
E02004963,Three Rivers 008,7401,1021,835,986,1005,1065,974,789,500,189,37,1856,5545,1515,25.08,74.92,20.47
E02004964,Three Rivers 009,5549,734,541,660,834,792,779,549,403,205,52,1275,4274,1209,22.98,77.02,21.79
E02004965,Three Rivers 010,6954,784,610,896,837,902,936,725,737,446,81,1394,5560,1989,20.05,79.95,28.6
E02004966,Three Rivers 011,7529,782,653,867,914,1069,1068,904,739,447,86,1435,6094,2176,19.06,80.94,28.9
E02004967,Three Rivers 012,7817,1186,809,1153,1261,1124,981,682,352,213,56,1995,5822,1303,25.52,74.48,16.67
E02004968,Watford 001,7436,1073,768,906,1125,1088,1008,652,476,281,59,1841,5595,1468,24.76,75.24,19.74
E02004969,Watford 002,7091,887,816,848,931,995,1050,700,478,339,47,1703,5388,1564,24.02,75.98,22.06
E02004970,Watford 003,8180,1313,847,977,1201,1122,986,738,562,350,84,2160,6020,1734,26.41,73.59,21.2
E02004971,Watford 004,7939,1203,930,1078,1287,1147,1009,590,409,231,55,2133,5806,1285,26.87,73.13,16.19
E02004972,Watford 005,5844,707,579,681,844,888,748,655,464,237,41,1286,4558,1397,22.01,77.99,23.9
E02004973,Watford 006,7943,1290,714,1268,1644,1164,933,511,274,124,21,2004,5939,930,25.23,74.77,11.71
E02004974,Watford 007,8774,1225,742,1157,1451,1266,987,741,637,413,155,1967,6807,1946,22.42,77.58,22.18
E02004975,Watford 008,8032,952,1000,981,996,1252,1105,763,594,327,62,1952,6080,1746,24.3,75.7,21.74
E02004976,Watford 009,10425,1589,655,1898,2587,1516,997,566,359,203,55,2244,8181,1183,21.53,78.47,11.35
E02004977,Watford 010,8723,1342,1011,1244,1633,1472,948,537,330,164,42,2353,6370,1073,26.97,73.03,12.3
E02004978,Watford 011,9390,1470,1071,1393,1805,1419,958,647,369,204,54,2541,6849,1274,27.06,72.94,13.57
E02004979,Watford 012,6800,871,703,773,954,1025,906,745,535,242,46,1574,5226,1568,23.15,76.85,23.06
E02004996,Ashford 001,8396,1059,840,776,872,1293,1223,976,840,423,94,1899,6497,2333,22.62,77.38,27.79
E02004997,Ashford 002,7971,735,715,711,665,962,1403,1146,1070,458,106,1450,6521,2780,18.19,81.81,34.88
E02004998,Ashford 003,6731,742,734,731,634,934,1052,772,721,359,52,1476,5255,1904,21.93,78.07,28.29
E02004999,Ashford 004,15341,2206,1631,2052,2218,2114,1942,1358,1182,491,147,3837,11504,3178,25.01,74.99,20.72
E02005000,Ashford 005,11844,1858,1240,1960,1898,1584,1387,896,677,290,54,3098,8746,1917,26.16,73.84,16.19
E02005001,Ashford 006,9030,989,947,1036,1037,1298,1363,1032,888,360,80,1936,7094,2360,21.44,78.56,26.14
E02005002,Ashford 007,9535,1488,908,1363,1380,1192,1285,892,666,314,47,2396,7139,1919,25.13,74.87,20.13
E02005003,Ashford 008,9781,1620,1220,1787,1455,1127,1193,667,498,177,37,2840,6941,1379,29.04,70.96,14.1
E02005004,Ashford 009,12425,1855,1376,1929,1796,1814,1867,896,603,244,45,3231,9194,1788,26.0,74.0,14.39
E02005005,Ashford 010,9672,1312,927,1016,1097,1205,1472,1171,1018,366,88,2239,7433,2643,23.15,76.85,27.33
E02005006,Ashford 011,5860,575,569,569,463,698,1009,790,774,314,99,1144,4716,1977,19.52,80.48,33.74
E02005007,Ashford 012,9259,995,927,1044,964,1229,1438,1127,1008,420,107,1922,7337,2662,20.76,79.24,28.75
E02005008,Ashford 013,8332,676,662,720,602,836,1298,1184,1394,763,197,1338,6994,3538,16.06,83.94,42.46
E02005009,Ashford 014,5855,587,597,516,520,680,925,838,836,294,62,1184,4671,2030,20.22,79.78,34.67
E02005010,Canterbury 001,8067,982,644,1285,946,837,1045,1007,740,378,203,1626,6441,2328,20.16,79.84,28.86
E02005011,Canterbury 002,7658,624,574,803,585,702,1071,1236,1279,622,162,1198,6460,3299,15.64,84.36,43.08
E02005012,Canterbury 003,8942,959,839,1136,931,944,1289,1155,1087,504,98,1798,7144,2844,20.11,79.89,31.8
E02005013,Canterbury 004,8421,825,709,1013,760,895,1338,1099,1119,533,130,1534,6887,2881,18.22,81.78,34.21
E02005014,Canterbury 005,8784,670,662,839,628,852,1368,1482,1440,671,172,1332,7452,3765,15.16,84.84,42.86
E02005015,Canterbury 006,9671,1250,945,1354,1151,1091,1326,1110,980,375,89,2195,7476,2554,22.7,77.3,26.41
E02005016,Canterbury 007,7939,786,716,860,709,941,1296,1112,927,467,125,1502,6437,2631,18.92,81.08,33.14
E02005017,Canterbury 008,6916,716,552,765,708,982,1141,868,722,345,117,1268,5648,2052,18.33,81.67,29.67
E02005018,Canterbury 009,8971,924,786,921,935,1012,1351,1195,1230,512,105,1710,7261,3042,19.06,80.94,33.91
E02005019,Canterbury 010,6510,737,595,823,745,740,911,876,644,313,126,1332,5178,1959,20.46,79.54,30.09
E02005020,Canterbury 011,7516,809,769,1087,869,855,995,886,781,395,70,1578,5938,2132,21.0,79.0,28.37
E02005021,Canterbury 012,11991,649,829,6000,715,803,825,823,917,367,63,1478,10513,2170,12.33,87.67,18.1
E02005022,Canterbury 013,9138,661,528,4652,663,611,724,562,456,230,51,1189,7949,1299,13.01,86.99,14.22
E02005023,Canterbury 014,10363,1169,815,4374,1176,866,742,554,369,231,67,1984,8379,1221,19.15,80.85,11.78
E02005025,Canterbury 016,11072,757,865,4539,994,847,947,851,759,422,91,1622,9450,2123,14.65,85.35,19.17
E02005026,Canterbury 017,8081,1044,794,1036,988,1016,1147,954,701,308,93,1838,6243,2056,22.74,77.26,25.44
E02005027,Canterbury 018,5553,473,501,626,491,614,949,741,663,377,118,974,4579,1899,17.54,82.46,34.2
E02006855,Canterbury 019,7070,782,554,2356,1127,739,633,421,276,137,45,1336,5734,879,18.9,81.1,12.43
E02006856,Canterbury 020,12731,1007,1216,4784,1615,1117,938,803,660,449,142,2223,10508,2054,17.46,82.54,16.13
E02005028,Dartford 001,12829,2834,1307,1731,2833,1719,1052,649,371,259,74,4141,8688,1353,32.28,67.72,10.55
E02005029,Dartford 002,13019,2274,1156,2093,2880,1960,1329,756,369,167,35,3430,9589,1327,26.35,73.65,10.19
E02005030,Dartford 003,11462,1658,1283,1497,2171,1710,1461,848,506,279,49,2941,8521,1682,25.66,74.34,14.67
E02005031,Dartford 004,8608,1343,799,1285,1614,1239,1093,613,375,212,35,2142,6466,1235,24.88,75.12,14.35
E02005032,Dartford 005,10125,1470,923,1560,1985,1453,1325,712,442,224,31,2393,7732,1409,23.63,76.37,13.92
E02005033,Dartford 006,7525,1104,711,1114,1344,1041,979,599,448,138,47,1815,5710,1232,24.12,75.88,16.37
E02005034,Dartford 007,7559,836,836,903,919,1080,1160,831,641,302,51,1672,5887,1825,22.12,77.88,24.14
E02005035,Dartford 008,8505,1104,914,1081,1216,1179,1166,753,635,378,79,2018,6487,1845,23.73,76.27,21.69
E02005036,Dartford 009,6610,978,803,873,954,956,827,553,428,205,33,1781,4829,1219,26.94,73.06,18.44
E02005037,Dartford 010,7155,786,747,792,734,904,1136,755,733,474,94,1533,5622,2056,21.43,78.57,28.74
E02005038,Dartford 011,5836,586,581,631,602,754,849,739,614,359,121,1167,4669,1833,20.0,80.0,31.41
E02005039,Dartford 012,6782,871,670,757,858,860,1015,770,623,297,61,1541,5241,1751,22.72,77.28,25.82
E02005040,Dartford 013,6591,706,529,622,613,752,1041,934,803,475,116,1235,5356,2328,18.74,81.26,35.32
E02005041,Dover 001,7211,612,736,711,670,898,1174,1079,897,347,87,1348,5863,2410,18.69,81.31,33.42
E02005042,Dover 002,9194,740,881,913,719,1034,1485,1387,1283,616,136,1621,7573,3422,17.63,82.37,37.22
E02005043,Dover 003,7513,654,573,837,674,844,1218,1130,985,465,133,1227,6286,2713,16.33,83.67,36.11
E02005044,Dover 004,6607,433,432,699,595,791,1125,1078,966,409,79,865,5742,2532,13.09,86.91,38.32
E02005045,Dover 005,9440,1174,898,1200,1142,1138,1336,1178,900,397,77,2072,7368,2552,21.95,78.05,27.03
E02005046,Dover 006,7928,1165,818,1098,1130,883,1071,761,714,250,38,1983,5945,1763,25.01,74.99,22.24
E02005047,Dover 007,7767,777,668,841,724,870,1191,1072,962,520,142,1445,6322,2696,18.6,81.4,34.71
E02005048,Dover 008,6783,570,556,640,549,720,1184,1150,917,384,113,1126,5657,2564,16.6,83.4,37.8
E02005049,Dover 009,7055,494,464,477,531,654,1116,1332,1296,520,171,958,6097,3319,13.58,86.42,47.04
E02005050,Dover 010,9747,999,810,1089,1073,1193,1397,1294,1130,615,147,1809,7938,3186,18.56,81.44,32.69
E02005051,Dover 011,14181,2217,1521,2388,1959,1804,1803,1215,855,344,75,3738,10443,2489,26.36,73.64,17.55
E02005052,Dover 012,8123,847,688,1258,1136,1022,1054,976,710,355,77,1535,6588,2118,18.9,81.1,26.07
E02005053,Dover 013,9839,1369,1070,1696,1519,1210,1181,950,550,237,57,2439,7400,1794,24.79,75.21,18.23
E02005054,Dover 014,6743,556,480,662,602,767,1196,1125,933,362,60,1036,5707,2480,15.36,84.64,36.78
E02005055,Gravesham 001,8816,1696,932,1374,1520,1169,971,575,396,165,18,2628,6188,1154,29.81,70.19,13.09
E02005056,Gravesham 002,10847,1493,859,1845,2015,1553,1243,855,541,338,105,2352,8495,1839,21.68,78.32,16.95
E02005057,Gravesham 003,11688,1808,1203,1791,1839,1626,1482,871,636,375,57,3011,8677,1939,25.76,74.24,16.59
E02005058,Gravesham 004,8132,1318,862,1057,1341,1109,979,698,471,239,58,2180,5952,1466,26.81,73.19,18.03
E02005059,Gravesham 005,9749,1113,927,1266,1259,1256,1534,1115,758,416,105,2040,7709,2394,20.93,79.07,24.56
E02005060,Gravesham 006,8084,1047,912,1074,1017,1038,1055,785,638,423,95,1959,6125,1941,24.23,75.77,24.01
E02005061,Gravesham 007,7270,964,935,943,834,1020,981,687,586,265,55,1899,5371,1593,26.12,73.88,21.91
E02005062,Gravesham 008,6986,887,809,806,797,853,1019,750,648,363,54,1696,5290,1815,24.28,75.72,25.98
E02005063,Gravesham 009,6861,875,714,786,812,895,1033,794,578,311,63,1589,5272,1746,23.16,76.84,25.45
E02005064,Gravesham 010,6687,633,653,743,582,850,1007,923,835,392,69,1286,5401,2219,19.23,80.77,33.18
E02005065,Gravesham 011,8305,1351,900,1147,1182,1076,1094,681,505,288,81,2251,6054,1555,27.1,72.9,18.72
E02005066,Gravesham 012,7692,765,601,732,632,913,1267,1074,1090,511,107,1366,6326,2782,17.76,82.24,36.17
E02005067,Gravesham 013,5822,592,576,599,502,722,982,784,736,283,46,1168,4654,1849,20.06,79.94,31.76
E02005068,Maidstone 001,7106,767,668,908,873,980,1211,835,596,221,47,1435,5671,1699,20.19,79.81,23.91
E02005069,Maidstone 002,9104,1157,842,1064,1245,1288,1224,942,823,434,85,1999,7105,2284,21.96,78.04,25.09
E02005070,Maidstone 003,9306,894,867,865,921,1125,1385,1102,1256,763,128,1761,7545,3249,18.92,81.08,34.91
E02005071,Maidstone 004,11981,1709,785,2622,2465,1567,1257,746,452,299,79,2494,9487,1576,20.82,79.18,13.15
E02005072,Maidstone 005,7642,880,824,648,741,1116,1156,987,914,315,61,1704,5938,2277,22.3,77.7,29.8
E02005073,Maidstone 006,12490,1623,933,2421,2347,1731,1529,900,565,351,90,2556,9934,1906,20.46,79.54,15.26
E02005074,Maidstone 007,8176,869,824,756,846,1107,1111,1034,1021,502,106,1693,6483,2663,20.71,79.29,32.57
E02005075,Maidstone 008,10787,1539,1204,1491,1590,1572,1473,863,654,342,59,2743,8044,1918,25.43,74.57,17.78
E02005076,Maidstone 009,10076,1571,1001,1615,1769,1369,1239,717,451,289,55,2572,7504,1512,25.53,74.47,15.01
E02005077,Maidstone 010,8193,1084,905,1039,999,1038,1163,820,723,357,65,1989,6204,1965,24.28,75.72,23.98
E02005078,Maidstone 011,9165,964,775,806,894,1109,1488,1356,1121,535,117,1739,7426,3129,18.97,81.03,34.14
E02005079,Maidstone 012,8878,1108,899,947,956,1086,1265,984,1032,490,111,2007,6871,2617,22.61,77.39,29.48
E02005080,Maidstone 013,12509,2251,1456,1857,1728,1432,1405,912,911,462,95,3707,8802,2380,29.63,70.37,19.03
E02005081,Maidstone 014,6612,616,587,566,490,808,1069,1010,946,434,86,1203,5409,2476,18.19,81.81,37.45
E02005082,Maidstone 015,11441,1508,1000,1486,1668,1362,1716,1217,977,407,100,2508,8933,2701,21.92,78.08,23.61
E02005083,Maidstone 016,7354,786,635,868,739,948,1097,908,888,426,59,1421,5933,2281,19.32,80.68,31.02
E02005084,Maidstone 017,7419,860,725,792,800,898,1204,927,782,366,65,1585,5834,2140,21.36,78.64,28.84
E02005085,Maidstone 018,7348,894,678,792,879,913,1265,937,626,314,50,1572,5776,1927,21.39,78.61,26.22
E02005086,Maidstone 019,6239,687,664,669,629,810,937,819,659,288,77,1351,4888,1843,21.65,78.35,29.54
E02005087,Sevenoaks 001,7192,800,623,896,821,862,1077,910,786,375,42,1423,5769,2113,19.79,80.21,29.38
E02005088,Sevenoaks 002,9671,1366,921,1320,1335,1196,1238,1037,728,441,89,2287,7384,2295,23.65,76.35,23.73
E02005089,Sevenoaks 003,6577,765,536,858,875,764,975,692,683,373,56,1301,5276,1804,19.78,80.22,27.43
E02005090,Sevenoaks 004,5942,525,493,571,485,688,919,748,954,463,96,1018,4924,2261,17.13,82.87,38.05
E02005091,Sevenoaks 005,6983,762,582,803,782,919,1012,895,737,408,83,1344,5639,2123,19.25,80.75,30.4
E02005093,Sevenoaks 007,5976,551,432,604,500,677,916,912,903,414,67,983,4993,2296,16.45,83.55,38.42
E02005094,Sevenoaks 008,9481,1323,861,1034,1322,1377,1337,945,806,408,68,2184,7297,2227,23.04,76.96,23.49
E02005095,Sevenoaks 009,7502,986,758,675,671,1038,1139,866,824,462,83,1744,5758,2235,23.25,76.75,29.79
E02005096,Sevenoaks 010,10132,1540,1042,1070,1409,1616,1246,891,737,432,149,2582,7550,2209,25.48,74.52,21.8
E02005097,Sevenoaks 011,10067,1448,1368,779,929,1747,1427,983,801,455,130,2816,7251,2369,27.97,72.03,23.53
E02005098,Sevenoaks 012,10451,1106,1491,1095,1053,1463,1519,1007,854,613,250,2597,7854,2724,24.85,75.15,26.06
E02005099,Sevenoaks 013,7888,924,786,776,738,1060,1346,1017,830,330,81,1710,6178,2258,21.68,78.32,28.63
E02005100,Sevenoaks 014,9765,1305,898,1115,1260,1315,1377,1028,898,456,113,2203,7562,2495,22.56,77.44,25.55
E02005101,Sevenoaks 015,7079,844,709,615,673,1002,1249,938,703,295,51,1553,5526,1987,21.94,78.06,28.07
E02006832,Sevenoaks 016,6044,827,571,716,711,729,786,842,657,170,35,1398,4646,1704,23.13,76.87,28.19
E02005102,Shepway 001,6394,467,435,510,540,727,1120,1072,994,434,95,902,5492,2595,14.11,85.89,40.58
E02005103,Shepway 002,10322,1307,1162,1434,1325,1518,1362,928,893,334,59,2469,7853,2214,23.92,76.08,21.45
E02005104,Shepway 003,8155,980,858,1021,914,1001,1221,998,790,314,58,1838,6317,2160,22.54,77.46,26.49
E02005105,Shepway 004,7962,1203,906,1188,1255,1025,1025,714,420,182,44,2109,5853,1360,26.49,73.51,17.08
E02005106,Shepway 005,9747,1324,944,1328,1348,1189,1391,1027,820,306,70,2268,7479,2223,23.27,76.73,22.81
E02005107,Shepway 006,13136,1530,1063,1680,1428,1616,1910,1650,1495,597,167,2593,10543,3909,19.74,80.26,29.76
E02005109,Shepway 008,6821,458,497,455,472,755,1067,1091,1208,591,227,955,5866,3117,14.0,86.0,45.7
E02005110,Shepway 009,7027,617,506,610,594,773,1248,1139,1034,416,90,1123,5904,2679,15.98,84.02,38.12
E02005111,Shepway 010,7490,589,484,612,586,846,1131,1170,1214,650,208,1073,6417,3242,14.33,85.67,43.28
E02005112,Shepway 011,7176,535,516,592,589,703,1179,1289,1203,451,119,1051,6125,3062,14.65,85.35,42.67
E02005113,Shepway 012,7382,673,552,734,601,689,1175,1146,1145,528,139,1225,6157,2958,16.59,83.41,40.07
E02005114,Shepway 013,6630,715,576,720,679,724,991,970,856,341,58,1291,5339,2225,19.47,80.53,33.56
E02006879,Shepway 014,7589,805,646,1312,1176,1058,1075,724,469,254,70,1451,6138,1517,19.12,80.88,19.99
E02006880,Shepway 015,7165,589,411,1204,955,934,924,818,709,431,190,1000,6165,2148,13.96,86.04,29.98
E02005115,Swale 001,6677,1265,729,1140,949,732,857,544,311,124,26,1994,4683,1005,29.86,70.14,15.05
E02005116,Swale 002,6741,1121,822,1001,821,667,893,640,509,232,35,1943,4798,1416,28.82,71.18,21.01
E02005117,Swale 003,6388,557,494,724,548,669,1026,989,993,335,53,1051,5337,2370,16.45,83.55,37.1
E02005118,Swale 004,10797,1564,1063,1472,1392,1294,1594,1097,888,363,70,2627,8170,2418,24.33,75.67,22.4
E02005119,Swale 005,6305,829,593,836,698,608,903,813,696,284,45,1422,4883,1838,22.55,77.45,29.15
E02005120,Swale 006,8656,755,626,1168,1079,982,1390,1279,1002,328,47,1381,7275,2656,15.95,84.05,30.68
E02005121,Swale 007,14213,2231,1595,2124,2030,2088,1861,1201,764,267,52,3826,10387,2284,26.92,73.08,16.07
E02005122,Swale 008,7348,736,610,958,755,857,1232,941,808,370,81,1346,6002,2200,18.32,81.68,29.94
E02005123,Swale 009,12708,1752,1265,1933,1796,1715,1537,1230,984,393,103,3017,9691,2710,23.74,76.26,21.33
E02005124,Swale 010,8961,1352,881,1579,1230,1021,1041,768,659,353,77,2233,6728,1857,24.92,75.08,20.72
E02005125,Swale 011,8500,1219,874,1209,1253,1017,1090,893,640,260,45,2093,6407,1838,24.62,75.38,21.62
E02005126,Swale 012,8205,948,797,1086,920,954,1081,884,964,482,89,1745,6460,2419,21.27,78.73,29.48
E02005127,Swale 013,8921,912,927,1035,856,1170,1396,1068,988,446,123,1839,7082,2625,20.61,79.39,29.42
E02005128,Swale 014,8651,1025,855,1074,937,1116,1226,1002,951,396,69,1880,6771,2418,21.73,78.27,27.95
E02005129,Swale 015,11454,1327,1072,1374,1504,1327,1641,1368,1175,535,131,2399,9055,3209,20.94,79.06,28.02
E02005130,Swale 016,8938,1048,838,1161,975,1007,1424,1133,885,392,75,1886,7052,2485,21.1,78.9,27.8
E02005131,Swale 017,6619,602,537,576,953,1102,1005,819,712,268,45,1139,5480,1844,17.21,82.79,27.86
E02005132,Thanet 001,11444,1849,1221,1904,1639,1308,1316,1016,678,385,128,3070,8374,2207,26.83,73.17,19.29
E02005133,Thanet 002,8604,731,667,805,648,834,1252,1389,1439,681,158,1398,7206,3667,16.25,83.75,42.62
E02005134,Thanet 003,8051,1248,788,1354,1109,1089,1022,724,492,192,33,2036,6015,1441,25.29,74.71,17.9
E02005135,Thanet 004,8066,1106,795,1252,1130,905,1061,820,631,278,88,1901,6165,1817,23.57,76.43,22.53
E02005136,Thanet 005,7860,834,756,895,897,918,1158,1080,864,376,82,1590,6270,2402,20.23,79.77,30.56
E02005137,Thanet 006,8094,1348,855,1038,1021,934,1035,849,699,275,40,2203,5891,1863,27.22,72.78,23.02
E02005138,Thanet 007,9264,971,736,1144,1021,999,1308,1204,1178,568,135,1707,7557,3085,18.43,81.57,33.3
E02005139,Thanet 008,8725,623,568,693,587,754,1202,1555,1688,838,217,1191,7534,4298,13.65,86.35,49.26
E02005140,Thanet 009,7612,654,652,662,582,858,1109,1069,1263,602,161,1306,6306,3095,17.16,82.84,40.66
E02005141,Thanet 010,7367,664,620,777,652,880,1057,1126,1009,466,116,1284,6083,2717,17.43,82.57,36.88
E02005142,Thanet 011,7396,692,668,878,716,796,1043,1054,974,493,82,1360,6036,2603,18.39,81.61,35.19
E02005143,Thanet 012,8353,1103,850,1024,973,1061,1160,943,775,385,79,1953,6400,2182,23.38,76.62,26.12
E02005144,Thanet 013,8901,1333,1030,1297,1167,1016,1123,924,656,289,66,2363,6538,1935,26.55,73.45,21.74
E02005145,Thanet 014,7591,728,681,780,741,918,1190,1111,986,377,79,1409,6182,2553,18.56,81.44,33.63
E02005146,Thanet 015,8227,1114,1063,1175,1063,1111,1099,829,547,191,35,2177,6050,1602,26.46,73.54,19.47
E02005147,Thanet 016,8770,1020,691,1270,1114,1100,1229,1119,825,321,81,1711,7059,2346,19.51,80.49,26.75
E02005148,Thanet 017,7597,618,615,691,703,830,1121,1215,1182,519,103,1233,6364,3019,16.23,83.77,39.74
E02005149,Tonbridge and Malling 001,11044,1312,1016,1353,1424,1566,1694,1205,993,417,64,2328,8716,2679,21.08,78.92,24.26
E02005150,Tonbridge and Malling 002,11873,1636,1054,1734,1870,1602,1558,1155,820,374,70,2690,9183,2419,22.66,77.34,20.37
E02005151,Tonbridge and Malling 003,12825,1649,1282,1534,1582,1649,1918,1432,1235,483,61,2931,9894,3211,22.85,77.15,25.04
E02005153,Tonbridge and Malling 005,9602,1293,876,1252,1183,1261,1184,1016,971,491,75,2169,7433,2553,22.59,77.41,26.59
E02005154,Tonbridge and Malling 006,11961,1447,1337,1230,1146,1722,1842,1397,1135,550,155,2784,9177,3237,23.28,76.72,27.06
E02005155,Tonbridge and Malling 007,12826,1870,1796,1259,1465,2254,1870,1084,875,312,41,3666,9160,2312,28.58,71.42,18.03
E02005156,Tonbridge and Malling 008,7272,708,755,909,643,888,1197,911,815,381,65,1463,5809,2172,20.12,79.88,29.87
E02005157,Tonbridge and Malling 009,6938,844,759,831,706,844,1001,747,728,406,72,1603,5335,1953,23.1,76.9,28.15
E02005158,Tonbridge and Malling 010,6808,761,793,618,626,1038,1032,791,690,372,87,1554,5254,1940,22.83,77.17,28.5
E02005159,Tonbridge and Malling 011,7827,946,831,804,666,979,1167,859,936,560,79,1777,6050,2434,22.7,77.3,31.1
E02005160,Tonbridge and Malling 012,12560,1615,1440,1926,1893,1788,1543,895,822,523,115,3055,9505,2355,24.32,75.68,18.75
E02005161,Tonbridge and Malling 013,8631,1036,946,1166,1296,1287,1271,792,507,262,68,1982,6649,1629,22.96,77.04,18.87
E02006833,Tonbridge and Malling 014,11986,1453,1029,1353,1389,1610,1752,1521,1189,537,153,2482,9504,3400,20.71,79.29,28.37
E02005162,Tunbridge Wells 001,10486,1156,1070,1135,1116,1492,1549,1288,1094,471,115,2226,8260,2968,21.23,78.77,28.3
E02005163,Tunbridge Wells 002,8255,992,1045,847,951,1298,1286,800,670,285,81,2037,6218,1836,24.68,75.32,22.24
E02005164,Tunbridge Wells 003,8530,1095,909,965,1248,1343,1173,752,647,300,98,2004,6526,1797,23.49,76.51,21.07
E02005165,Tunbridge Wells 004,7712,763,814,734,752,1004,1190,1000,898,430,127,1577,6135,2455,20.45,79.55,31.83
E02005166,Tunbridge Wells 005,7282,1084,864,912,1188,1010,908,612,447,198,59,1948,5334,1316,26.75,73.25,18.07
E02005167,Tunbridge Wells 006,7862,952,895,626,656,1140,1235,970,830,423,135,1847,6015,2358,23.49,76.51,29.99
E02005168,Tunbridge Wells 007,7907,957,935,776,1055,1270,1144,721,534,386,129,1892,6015,1770,23.93,76.07,22.39
E02005169,Tunbridge Wells 008,9939,1085,706,1586,2194,1641,1181,735,493,262,56,1791,8148,1546,18.02,81.98,15.55
E02005170,Tunbridge Wells 009,10194,1357,1007,1112,1513,1504,1398,860,730,530,183,2364,7830,2303,23.19,76.81,22.59
E02005171,Tunbridge Wells 010,6476,888,666,740,886,948,877,579,516,264,112,1554,4922,1471,24.0,76.0,22.71
E02005172,Tunbridge Wells 011,8733,998,1009,797,808,1244,1567,1035,854,333,88,2007,6726,2310,22.98,77.02,26.45
E02005173,Tunbridge Wells 012,8694,971,782,792,1034,1347,1333,986,858,459,132,1753,6941,2435,20.16,79.84,28.01
E02005174,Tunbridge Wells 013,7679,799,957,776,655,869,1228,963,829,483,120,1756,5923,2395,22.87,77.13,31.19
E02005175,Tunbridge Wells 014,8975,914,1299,831,741,1042,1420,1113,992,511,112,2213,6762,2728,24.66,75.34,30.4
E02005176,Burnley 001,8762,1117,896,1111,1040,1081,1193,998,872,373,81,2013,6749,2324,22.97,77.03,26.52
E02005177,Burnley 002,5944,863,607,810,797,723,653,607,473,308,103,1470,4474,1491,24.73,75.27,25.08
E02005178,Burnley 003,10315,1982,1476,1778,1717,1295,864,652,321,206,24,3458,6857,1203,33.52,66.48,11.66
E02005179,Burnley 004,8962,1175,819,1279,1089,1032,1346,1000,816,321,85,1994,6968,2222,22.25,77.75,24.79
E02005180,Burnley 005,6701,723,596,740,717,785,1051,927,710,371,81,1319,5382,2089,19.68,80.32,31.17
E02005181,Burnley 006,6331,881,531,982,860,757,810,701,530,227,52,1412,4919,1510,22.3,77.7,23.85
E02005182,Burnley 007,6025,787,595,846,878,735,750,645,492,217,80,1382,4643,1434,22.94,77.06,23.8
E02005183,Burnley 008,5930,620,545,718,667,653,872,771,715,306,63,1165,4765,1855,19.65,80.35,31.28
E02005184,Burnley 009,5022,451,363,497,437,571,860,802,775,221,45,814,4208,1843,16.21,83.79,36.7
E02005185,Burnley 010,8968,1439,844,1527,1240,1049,1143,861,591,224,50,2283,6685,1726,25.46,74.54,19.25
E02005186,Burnley 011,5884,568,519,743,693,749,1045,740,609,181,37,1087,4797,1567,18.47,81.53,26.63
E02006881,Burnley 014,10076,1325,918,1348,1311,1154,1399,1136,995,386,104,2243,7833,2621,22.26,77.74,26.01
E02005189,Chorley 001,5593,683,532,759,822,694,754,659,450,193,47,1215,4378,1349,21.72,78.28,24.12
E02005190,Chorley 002,6137,549,542,642,605,871,1073,901,675,248,31,1091,5046,1855,17.78,82.22,30.23
E02005191,Chorley 003,9340,1089,855,992,1151,1238,1461,1181,977,336,60,1944,7396,2554,20.81,79.19,27.34
E02005192,Chorley 004,8993,1030,854,1126,1243,1440,1449,930,645,244,32,1884,7109,1851,20.95,79.05,20.58
E02005193,Chorley 005,8373,815,792,819,883,1136,1282,1146,1078,342,80,1607,6766,2646,19.19,80.81,31.6
E02005194,Chorley 006,7936,856,694,852,977,1025,1230,974,851,403,74,1550,6386,2302,19.53,80.47,29.01
E02005195,Chorley 007,8072,576,641,980,1092,1263,1402,956,784,280,98,1217,6855,2118,15.08,84.92,26.24
E02005196,Chorley 008,10773,1549,936,1227,1659,1392,1178,1145,1102,482,103,2485,8288,2832,23.07,76.93,26.29
E02005197,Chorley 009,7356,948,673,1103,1036,988,1015,746,582,220,45,1621,5735,1593,22.04,77.96,21.66
E02005198,Chorley 010,9847,1261,875,1481,1437,1324,1287,927,834,364,57,2136,7711,2182,21.69,78.31,22.16
E02005199,Chorley 011,7656,729,647,778,735,1059,1245,993,1035,399,36,1376,6280,2463,17.97,82.03,32.17
E02005200,Chorley 012,9439,1354,1017,1533,1353,1311,1296,764,503,266,42,2371,7068,1575,25.12,74.88,16.69
E02005201,Chorley 013,8370,963,767,1131,1106,1104,1149,984,789,319,58,1730,6640,2150,20.67,79.33,25.69
E02005202,Chorley 014,10331,1092,882,1124,1229,1368,1546,1297,1196,482,115,1974,8357,3090,19.11,80.89,29.91
E02005203,Fylde 001,7952,863,683,772,884,878,1272,1147,995,402,56,1546,6406,2600,19.44,80.56,32.7
E02005204,Fylde 002,12018,1373,1100,1500,1483,1552,1806,1427,1232,462,83,2473,9545,3204,20.58,79.42,26.66
E02005205,Fylde 003,6925,679,606,834,911,820,1063,892,796,280,44,1285,5640,2012,18.56,81.44,29.05
E02005206,Fylde 004,7348,797,680,753,828,740,1138,1032,879,414,87,1477,5871,2412,20.1,79.9,32.83
E02005207,Fylde 005,8493,676,752,716,688,991,1295,1334,1252,665,124,1428,7065,3375,16.81,83.19,39.74
E02005208,Fylde 006,10185,784,700,1069,927,1175,1695,1431,1296,844,264,1484,8701,3835,14.57,85.43,37.65
E02005209,Fylde 007,8416,794,715,937,909,893,1392,1174,1070,465,67,1509,6907,2776,17.93,82.07,32.98
E02005210,Fylde 008,10337,765,753,792,704,1155,1707,1568,1615,1020,258,1518,8819,4461,14.69,85.31,43.16
E02005211,Fylde 009,9106,701,733,819,866,1092,1524,1288,1247,675,161,1434,7672,3371,15.75,84.25,37.02
E02005212,Hyndburn 001,10990,1315,1015,1478,1310,1399,1546,1235,1118,503,71,2330,8660,2927,21.2,78.8,26.63
E02005213,Hyndburn 002,11340,1447,1087,1524,1453,1497,1608,1249,963,391,121,2534,8806,2724,22.35,77.65,24.02
E02005214,Hyndburn 003,6424,740,573,976,694,788,983,708,657,263,42,1313,5111,1670,20.44,79.56,26.0
E02005215,Hyndburn 004,12372,1611,1157,1732,1594,1482,1729,1320,1073,550,124,2768,9604,3067,22.37,77.63,24.79
E02005216,Hyndburn 005,5413,776,568,765,713,610,763,565,477,162,14,1344,4069,1218,24.83,75.17,22.5
E02005217,Hyndburn 006,12743,2461,1841,2143,2063,1495,1043,800,569,264,64,4302,8441,1697,33.76,66.24,13.32
E02005218,Hyndburn 007,7297,907,664,1005,980,864,1039,745,712,321,60,1571,5726,1838,21.53,78.47,25.19
E02005219,Hyndburn 008,8398,933,680,1177,1014,1076,1264,1007,856,335,56,1613,6785,2254,19.21,80.79,26.84
E02005220,Hyndburn 009,6066,520,462,748,550,705,1039,846,816,328,52,982,5084,2042,16.19,83.81,33.66
E02005221,Lancaster 001,9886,889,856,1109,849,1080,1546,1502,1313,596,146,1745,8141,3557,17.65,82.35,35.98
E02005222,Lancaster 002,6320,598,512,656,476,672,1089,951,898,391,77,1110,5210,2317,17.56,82.44,36.66
E02005223,Lancaster 003,7140,602,597,666,508,806,1101,1127,1057,527,149,1199,5941,2860,16.79,83.21,40.06
E02005224,Lancaster 004,5239,404,345,460,317,483,754,787,900,608,181,749,4490,2476,14.3,85.7,47.26
E02005225,Lancaster 005,5666,648,478,602,553,667,848,756,710,348,56,1126,4540,1870,19.87,80.13,33.0
E02005226,Lancaster 006,7878,1079,745,1331,976,842,1028,867,622,302,86,1824,6054,1877,23.15,76.85,23.83
E02005228,Lancaster 008,6001,844,538,830,704,692,809,699,524,290,71,1382,4619,1584,23.03,76.97,26.4
E02005229,Lancaster 009,5868,759,552,985,738,760,894,582,405,161,32,1311,4557,1180,22.34,77.66,20.11
E02005230,Lancaster 010,6718,855,598,942,701,693,843,880,798,363,45,1453,5265,2086,21.63,78.37,31.05
E02005231,Lancaster 011,8168,1092,667,1547,1121,971,1121,839,558,216,36,1759,6409,1649,21.54,78.46,20.19
E02005233,Lancaster 013,7607,912,657,1497,1145,1050,961,730,431,178,46,1569,6038,1385,20.63,79.37,18.21
E02005234,Lancaster 014,9112,557,552,4320,1041,802,773,535,301,186,45,1109,8003,1067,12.17,87.83,11.71
E02005235,Lancaster 015,6031,457,309,2877,648,513,504,316,234,149,24,766,5265,723,12.7,87.3,11.99
E02005236,Lancaster 016,13784,1857,1204,1924,1554,1554,1998,1585,1428,568,112,3061,10723,3693,22.21,77.79,26.79
E02005237,Lancaster 017,10823,1163,1048,2358,1268,1197,1433,1050,798,404,104,2211,8612,2356,20.43,79.57,21.77
E02005238,Lancaster 018,5856,709,506,1057,783,654,729,582,501,270,65,1215,4641,1418,20.75,79.25,24.21
E02005239,Lancaster 019,11919,651,566,6441,582,779,967,858,724,305,46,1217,10702,1933,10.21,89.79,16.22
E02006871,Lancaster 020,12022,1441,1122,1573,1272,1355,1775,1473,1239,652,120,2563,9459,3484,21.32,78.68,28.98
E02005240,Pendle 001,5364,686,420,672,723,706,763,633,489,232,40,1106,4258,1394,20.62,79.38,25.99
E02005241,Pendle 002,5530,624,398,694,741,673,812,703,602,233,50,1022,4508,1588,18.48,81.52,28.72
E02005242,Pendle 003,6168,696,537,706,668,773,915,854,672,300,47,1233,4935,1873,19.99,80.01,30.37
E02005243,Pendle 004,4933,589,365,628,628,567,756,611,467,259,63,954,3979,1400,19.34,80.66,28.38
E02005244,Pendle 005,5971,877,616,810,851,639,791,645,472,228,42,1493,4478,1387,25.0,75.0,23.23
E02005245,Pendle 006,6854,651,503,726,719,876,1176,1045,785,311,62,1154,5700,2203,16.84,83.16,32.14
E02005246,Pendle 007,5208,651,419,817,668,634,789,590,430,164,46,1070,4138,1230,20.55,79.45,23.62
E02005247,Pendle 008,9671,955,717,979,1017,1249,1485,1386,1259,522,102,1672,7999,3269,17.29,82.71,33.8
E02005248,Pendle 009,6927,1159,901,1076,1087,891,621,627,375,159,31,2060,4867,1192,29.74,70.26,17.21
E02005249,Pendle 010,10311,1697,1179,1668,1675,1237,1112,874,580,235,54,2876,7435,1743,27.89,72.11,16.9
E02005250,Pendle 011,8512,1494,1188,1365,1449,1070,729,612,351,217,37,2682,5830,1217,31.51,68.49,14.3
E02005251,Pendle 012,7205,1025,765,869,998,796,884,768,682,322,96,1790,5415,1868,24.84,75.16,25.93
E02005252,Pendle 013,9458,1396,1028,1274,1357,1098,1058,1038,805,350,54,2424,7034,2247,25.63,74.37,23.76
E02005253,Preston 001,6419,796,578,775,704,727,1014,760,704,291,70,1374,5045,1825,21.41,78.59,28.43
E02005254,Preston 002,7311,896,782,822,672,898,1187,914,753,342,45,1678,5633,2054,22.95,77.05,28.09
E02005255,Preston 003,8854,1033,841,1100,903,1153,1249,996,952,528,99,1874,6980,2575,21.17,78.83,29.08
E02005256,Preston 004,6613,719,612,896,706,947,1152,743,464,299,75,1331,5282,1581,20.13,79.87,23.91
E02005257,Preston 005,6022,848,537,820,855,638,761,710,511,288,54,1385,4637,1563,23.0,77.0,25.95
E02005258,Preston 006,7878,895,782,1036,898,955,1055,916,814,470,57,1677,6201,2257,21.29,78.71,28.65
E02005259,Preston 007,10172,1559,1119,1527,1309,1204,1272,999,690,420,73,2678,7494,2182,26.33,73.67,21.45
E02005260,Preston 008,6599,791,576,898,706,670,1013,775,680,390,100,1367,5232,1945,20.72,79.28,29.47
E02005261,Preston 009,10221,1758,1323,1507,1436,1245,1258,930,467,259,38,3081,7140,1694,30.14,69.86,16.57
E02005262,Preston 010,6514,816,540,1130,871,854,1103,614,394,167,25,1356,5158,1200,20.82,79.18,18.42
E02005263,Preston 011,7142,992,732,1900,1112,853,702,454,257,123,17,1724,5418,851,24.14,75.86,11.92
E02005264,Preston 012,12578,1414,834,4617,1814,1269,1129,770,487,209,35,2248,10330,1501,17.87,82.13,11.93
E02005265,Preston 013,10664,1439,1026,1686,1450,1272,1466,1062,743,430,90,2465,8199,2325,23.12,76.88,21.8
E02005266,Preston 014,8694,1549,873,1822,1436,1098,864,556,317,154,25,2422,6272,1052,27.86,72.14,12.1
E02005267,Preston 015,7217,750,686,2956,754,763,567,407,215,103,16,1436,5781,741,19.9,80.1,10.27
E02005268,Preston 016,9333,1605,1113,1616,1370,1165,985,754,440,253,32,2718,6615,1479,29.12,70.88,15.85
E02005269,Preston 017,10904,887,670,3853,1823,1229,1102,751,376,170,43,1557,9347,1340,14.28,85.72,12.29
E02005270,Ribble Valley 001,7285,510,811,695,503,832,1384,1183,929,388,50,1321,5964,2550,18.13,81.87,35.0
E02005271,Ribble Valley 002,7924,781,800,1005,875,955,1234,887,805,447,135,1581,6343,2274,19.95,80.05,28.7
E02005272,Ribble Valley 003,8729,1019,804,1103,1158,1150,1173,990,779,422,131,1823,6906,2322,20.88,79.12,26.6
E02005273,Ribble Valley 004,5892,510,540,703,506,730,989,846,680,319,69,1050,4842,1914,17.82,82.18,32.48
E02005274,Ribble Valley 005,7532,708,732,785,709,1002,1292,938,937,350,79,1440,6092,2304,19.12,80.88,30.59
E02005275,Ribble Valley 006,5807,709,544,753,629,666,830,724,559,331,62,1253,4554,1676,21.58,78.42,28.86
E02005276,Ribble Valley 007,9118,868,925,1079,846,1308,1551,1173,892,411,65,1793,7325,2541,19.66,80.34,27.87
E02005277,Ribble Valley 008,8601,669,835,821,643,1027,1481,1254,1208,539,124,1504,7097,3125,17.49,82.51,36.33
E02005278,Rossendale 001,8019,867,753,935,898,1225,1289,1070,712,229,41,1620,6399,2052,20.2,79.8,25.59
E02005279,Rossendale 002,10482,1407,1106,1482,1450,1298,1443,1041,775,400,80,2513,7969,2296,23.97,76.03,21.9
E02005280,Rossendale 003,11000,1473,1158,1356,1463,1477,1603,1243,814,341,72,2631,8369,2470,23.92,76.08,22.45
E02005281,Rossendale 004,8980,1160,914,1248,1241,1117,1231,987,691,320,71,2074,6906,2069,23.1,76.9,23.04
E02005284,Rossendale 007,6146,635,599,630,666,850,942,755,699,283,87,1234,4912,1824,20.08,79.92,29.68
E02005285,Rossendale 008,6426,680,548,670,737,853,1047,803,672,332,84,1228,5198,1891,19.11,80.89,29.43
E02005286,Rossendale 009,7885,906,730,1025,917,1051,1257,928,741,279,51,1636,6249,1999,20.75,79.25,25.35
E02006884,Rossendale 010,12544,1554,1190,1656,1584,1644,1837,1484,1119,397,79,2744,9800,3079,21.88,78.12,24.55
E02005287,South Ribble 001,5361,605,526,506,566,713,864,681,539,303,58,1131,4230,1581,21.1,78.9,29.49
E02005288,South Ribble 002,6133,559,493,689,578,722,1018,839,805,336,94,1052,5081,2074,17.15,82.85,33.82
E02005289,South Ribble 003,5931,510,478,613,578,762,926,901,758,352,53,988,4943,2064,16.66,83.34,34.8
E02005290,South Ribble 004,7237,793,662,981,854,1052,1175,831,593,251,45,1455,5782,1720,20.11,79.89,23.77
E02005291,South Ribble 005,5639,613,550,724,721,716,864,663,547,218,23,1163,4476,1451,20.62,79.38,25.73
E02005292,South Ribble 006,5835,744,558,790,774,673,740,662,525,271,98,1302,4533,1556,22.31,77.69,26.67
E02005293,South Ribble 007,5453,595,451,741,667,632,748,614,626,323,56,1046,4407,1619,19.18,80.82,29.69
E02005294,South Ribble 008,6812,854,682,1030,933,913,935,639,509,287,30,1536,5276,1465,22.55,77.45,21.51
E02005295,South Ribble 009,7377,806,672,982,927,957,1148,848,664,301,72,1478,5899,1885,20.04,79.96,25.55
E02005296,South Ribble 010,5979,546,526,632,455,761,937,796,837,399,90,1072,4907,2122,17.93,82.07,35.49
E02005297,South Ribble 011,8342,785,689,789,840,953,1418,1134,1102,555,77,1474,6868,2868,17.67,82.33,34.38
E02005298,South Ribble 012,7649,893,623,998,959,1048,1089,940,732,318,49,1516,6133,2039,19.82,80.18,26.66
E02005299,South Ribble 013,7694,1048,736,1282,1183,1058,987,656,493,200,51,1784,5910,1400,23.19,76.81,18.2
E02005300,South Ribble 014,5116,569,502,606,574,669,825,727,500,127,17,1071,4045,1371,20.93,79.07,26.8
E02005301,South Ribble 015,6389,693,593,836,755,757,961,759,636,320,79,1286,5103,1794,20.13,79.87,28.08
E02005302,South Ribble 016,7515,946,707,826,1068,1025,935,829,787,315,77,1653,5862,2008,22.0,78.0,26.72
E02005303,South Ribble 017,6326,789,715,873,797,746,830,744,544,238,50,1504,4822,1576,23.77,76.23,24.91
E02005304,West Lancashire 001,8674,825,795,1035,782,1073,1364,1184,1085,447,84,1620,7054,2800,18.68,81.32,32.28
E02005305,West Lancashire 002,7587,707,554,797,618,801,1308,1247,1060,398,97,1261,6326,2802,16.62,83.38,36.93
E02005306,West Lancashire 003,7288,552,615,823,580,811,1235,1198,989,412,73,1167,6121,2672,16.01,83.99,36.66
E02005307,West Lancashire 004,9306,1047,865,1208,978,1250,1323,1055,996,475,109,1912,7394,2635,20.55,79.45,28.32
E02005308,West Lancashire 005,6711,613,583,705,532,829,1131,886,942,379,111,1196,5515,2318,17.82,82.18,34.54
E02005309,West Lancashire 006,8321,832,722,1250,798,905,1242,1021,933,516,102,1554,6767,2572,18.68,81.32,30.91
E02005310,West Lancashire 007,9286,590,577,3748,687,687,841,806,751,497,102,1167,8119,2156,12.57,87.43,23.22
E02005311,West Lancashire 008,6561,423,459,1773,431,569,911,833,741,349,72,882,5679,1995,13.44,86.56,30.41
E02005312,West Lancashire 009,5911,566,517,802,662,709,955,870,544,257,29,1083,4828,1700,18.32,81.68,28.76
E02005313,West Lancashire 010,8791,1373,1001,1451,1252,1092,1114,737,523,201,47,2374,6417,1508,27.0,73.0,17.15
E02005314,West Lancashire 011,6405,668,628,1051,734,783,935,714,576,279,37,1296,5109,1606,20.23,79.77,25.07
E02005315,West Lancashire 012,8016,779,685,861,544,899,1275,1071,1112,640,150,1464,6552,2973,18.26,81.74,37.09
E02005316,West Lancashire 013,6639,1068,705,1075,868,830,883,547,431,198,34,1773,4866,1210,26.71,73.29,18.23
E02005317,West Lancashire 014,7251,1161,800,1290,924,849,934,625,465,164,39,1961,5290,1293,27.04,72.96,17.83
E02005318,West Lancashire 015,7559,756,680,986,696,979,1200,947,775,460,80,1436,6123,2262,19.0,81.0,29.92
E02005319,Wyre 001,8020,833,652,1226,953,947,1206,1010,782,356,55,1485,6535,2203,18.52,81.48,27.47
E02005320,Wyre 002,5968,680,602,710,670,676,876,735,586,371,62,1282,4686,1754,21.48,78.52,29.39
E02005321,Wyre 003,6271,666,638,775,565,616,800,808,891,413,99,1304,4967,2211,20.79,79.21,35.26
E02005322,Wyre 004,10311,814,750,1055,825,997,1455,1651,1765,829,170,1564,8747,4415,15.17,84.83,42.82
E02005323,Wyre 005,7509,908,848,990,848,861,1080,916,742,253,63,1756,5753,1974,23.39,76.61,26.29
E02005324,Wyre 006,6871,587,602,937,606,771,1177,951,774,359,107,1189,5682,2191,17.3,82.7,31.89
E02005325,Wyre 007,9334,801,720,915,867,967,1305,1389,1481,739,150,1521,7813,3759,16.3,83.7,40.27
E02005326,Wyre 008,8524,686,594,904,720,886,1377,1249,1229,721,158,1280,7244,3357,15.02,84.98,39.38
E02005327,Wyre 009,6464,626,507,687,570,680,1161,956,865,344,68,1133,5331,2233,17.53,82.47,34.55
E02005328,Wyre 010,7614,574,516,751,752,768,1216,1229,1156,572,80,1090,6524,3037,14.32,85.68,39.89
E02005329,Wyre 011,9578,1123,816,1255,1262,1113,1375,1097,963,469,105,1939,7639,2634,20.24,79.76,27.5
E02005330,Wyre 012,9152,804,815,929,890,1075,1394,1312,1275,558,100,1619,7533,3245,17.69,82.31,35.46
E02005331,Wyre 013,7934,667,645,842,869,925,1150,1087,1018,551,180,1312,6622,2836,16.54,83.46,35.74
E02005332,Wyre 014,8541,724,714,895,796,924,1400,1228,1106,642,112,1438,7103,3088,16.84,83.16,36.16
E02005334,Blaby 002,6092,728,553,841,860,780,833,640,470,306,81,1281,4811,1497,21.03,78.97,24.57
E02005335,Blaby 003,7316,760,750,711,747,939,1166,865,791,490,97,1510,5806,2243,20.64,79.36,30.66
E02005336,Blaby 004,7462,1022,703,1119,1378,1133,888,599,385,203,32,1725,5737,1219,23.12,76.88,16.34
E02005337,Blaby 005,9962,1144,899,1335,1447,1252,1376,1078,853,497,81,2043,7919,2509,20.51,79.49,25.19
E02005338,Blaby 006,10883,1341,1084,1436,1431,1413,1568,1122,911,473,104,2425,8458,2610,22.28,77.72,23.98
E02005339,Blaby 007,8676,967,854,1074,1129,1147,1322,997,797,339,50,1821,6855,2183,20.99,79.01,25.16
E02005340,Blaby 008,8907,957,758,1213,1065,1046,1275,1071,972,433,117,1715,7192,2593,19.25,80.75,29.11
E02005341,Blaby 009,7825,999,770,1121,1063,1038,1206,701,593,275,59,1769,6056,1628,22.61,77.39,20.81
E02005342,Blaby 010,7263,909,651,776,825,905,1092,934,818,300,53,1560,5703,2105,21.48,78.52,28.98
E02005343,Blaby 011,7715,899,751,838,867,940,1129,1013,857,359,62,1650,6065,2291,21.39,78.61,29.7
E02005344,Blaby 012,8772,1148,752,917,1156,1131,1164,1039,1006,383,76,1900,6872,2504,21.66,78.34,28.55
E02006820,Blaby 013,10653,1086,998,1184,1319,1301,1563,1320,1105,663,114,2084,8569,3202,19.56,80.44,30.06
E02005345,Charnwood 001,6646,759,484,903,985,847,922,844,644,213,45,1243,5403,1746,18.7,81.3,26.27
E02005346,Charnwood 002,13138,1571,1117,3227,2201,1694,1367,1004,545,332,80,2688,10450,1961,20.46,79.54,14.93
E02005347,Charnwood 003,11275,645,562,6236,984,728,750,642,427,238,63,1207,10068,1370,10.71,89.29,12.15
E02005348,Charnwood 004,5668,425,366,927,638,604,780,857,747,268,56,791,4877,1928,13.96,86.04,34.02
E02005349,Charnwood 005,7451,892,635,1045,966,897,1011,860,739,327,79,1527,5924,2005,20.49,79.51,26.91
E02005350,Charnwood 006,6608,698,500,893,815,791,998,865,702,277,69,1198,5410,1913,18.13,81.87,28.95
E02005351,Charnwood 007,12798,678,621,7943,966,629,653,569,461,216,62,1299,11499,1308,10.15,89.85,10.22
E02005352,Charnwood 008,6452,667,700,656,609,834,1086,891,637,306,66,1367,5085,1900,21.19,78.81,29.45
E02005353,Charnwood 009,10778,1307,1049,2405,1548,1349,1194,896,687,293,50,2356,8422,1926,21.86,78.14,17.87
E02005354,Charnwood 010,10314,1089,965,1534,1147,1310,1453,1155,919,628,114,2054,8260,2816,19.91,80.09,27.3
E02005355,Charnwood 011,7385,852,695,919,860,994,1014,892,767,325,67,1547,5838,2051,20.95,79.05,27.77
E02005356,Charnwood 012,7378,822,665,816,709,1065,1175,881,796,357,92,1487,5891,2126,20.15,79.85,28.82
E02005357,Charnwood 013,8530,1106,781,1384,1232,1106,1186,842,571,270,52,1887,6643,1735,22.12,77.88,20.34
E02005358,Charnwood 014,11664,1470,1066,1569,1502,1592,1803,1132,959,475,96,2536,9128,2662,21.74,78.26,22.82
E02005359,Charnwood 015,7116,859,637,967,739,886,1004,848,806,312,58,1496,5620,2024,21.02,78.98,28.44
E02005360,Charnwood 016,6692,646,714,763,557,778,1040,927,782,386,99,1360,5332,2194,20.32,79.68,32.79
E02005361,Charnwood 017,6739,686,545,1111,811,894,998,800,564,260,70,1231,5508,1694,18.27,81.73,25.14
E02005362,Charnwood 018,7436,1010,626,989,1044,951,995,790,666,313,52,1636,5800,1821,22.0,78.0,24.49
E02005363,Charnwood 019,8806,1114,741,1199,1179,1029,1122,900,869,544,109,1855,6951,2422,21.07,78.93,27.5
E02005364,Charnwood 020,5348,611,531,754,611,700,856,589,438,215,43,1142,4206,1285,21.35,78.65,24.03
E02005365,Charnwood 021,10266,1162,867,1476,1367,1175,1430,1259,975,451,104,2029,8237,2789,19.76,80.24,27.17
E02005366,Charnwood 022,7363,877,627,967,932,915,1046,800,768,361,70,1504,5859,1999,20.43,79.57,27.15
E02005368,Harborough 002,6350,530,663,558,457,859,1216,921,772,327,47,1193,5157,2067,18.79,81.21,32.55
E02005369,Harborough 003,12122,1503,1241,1279,1327,1657,1744,1395,1231,630,115,2744,9378,3371,22.64,77.36,27.81
E02005370,Harborough 004,9220,1037,1056,1131,988,1302,1531,1105,751,269,50,2093,7127,2175,22.7,77.3,23.59
E02005371,Harborough 005,10252,1010,1014,1117,960,1426,1758,1322,1136,401,108,2024,8228,2967,19.74,80.26,28.94
E02005372,Harborough 006,9777,911,890,959,796,1288,1921,1414,1055,440,103,1801,7976,3012,18.42,81.58,30.81
E02005373,Harborough 007,11385,1272,1007,1108,1272,1747,1700,1418,1268,518,75,2279,9106,3279,20.02,79.98,28.8
E02005374,Harborough 008,6883,674,736,950,808,774,956,722,631,486,146,1410,5473,1985,20.49,79.51,28.84
E02005375,Harborough 009,9673,1184,909,1150,1241,1411,1329,966,905,469,109,2093,7580,2449,21.64,78.36,25.32
E02005376,Harborough 010,10389,1171,1042,1176,1161,1437,1588,1138,1076,477,123,2213,8176,2814,21.3,78.7,27.09
E02006816,Harborough 011,7756,818,743,894,854,891,1213,1008,781,459,95,1561,6195,2343,20.13,79.87,30.21
E02005377,Hinckley and Bosworth 001,8795,971,813,1002,978,1062,1321,1099,1010,472,67,1784,7011,2648,20.28,79.72,30.11
E02005378,Hinckley and Bosworth 002,5348,622,441,612,668,721,754,696,537,259,38,1063,4285,1530,19.88,80.12,28.61
E02005379,Hinckley and Bosworth 003,6327,722,570,757,722,765,947,802,683,303,56,1292,5035,1844,20.42,79.58,29.14
E02005380,Hinckley and Bosworth 004,8953,859,817,889,816,1143,1468,1299,1152,410,100,1676,7277,2961,18.72,81.28,33.07
E02005381,Hinckley and Bosworth 005,8705,934,797,882,905,1024,1270,1257,1076,467,93,1731,6974,2893,19.89,80.11,33.23
E02005382,Hinckley and Bosworth 006,10878,1261,912,1569,1461,1336,1509,1251,1022,455,102,2173,8705,2830,19.98,80.02,26.02
E02005383,Hinckley and Bosworth 007,9238,957,820,1294,1161,1175,1348,1068,945,360,110,1777,7461,2483,19.24,80.76,26.88
E02005384,Hinckley and Bosworth 008,7400,773,733,746,760,953,1356,917,745,349,68,1506,5894,2079,20.35,79.65,28.09
E02005385,Hinckley and Bosworth 009,6485,688,524,673,738,834,1018,855,772,316,67,1212,5273,2010,18.69,81.31,30.99
E02005386,Hinckley and Bosworth 010,9030,980,710,1519,1263,1289,1232,841,693,374,129,1690,7340,2037,18.72,81.28,22.56
E02005387,Hinckley and Bosworth 011,10092,1301,879,1406,1601,1322,1429,1035,816,268,35,2180,7912,2154,21.6,78.4,21.34
E02005388,Hinckley and Bosworth 012,6141,779,534,885,787,809,853,653,522,265,54,1313,4828,1494,21.38,78.62,24.33
E02005389,Hinckley and Bosworth 013,5875,558,555,564,597,782,820,749,701,423,126,1113,4762,1999,18.94,81.06,34.03
E02005390,Hinckley and Bosworth 014,9869,1128,812,970,1121,1349,1512,1356,1104,448,69,1940,7929,2977,19.66,80.34,30.17
E02005391,Melton 001,9730,890,988,906,689,1233,1853,1442,1174,448,107,1878,7852,3171,19.3,80.7,32.59
E02005392,Melton 002,9101,1007,850,1151,989,1138,1403,1061,948,478,76,1857,7244,2563,20.4,79.6,28.16
E02005393,Melton 003,7170,777,544,786,724,892,1285,1025,751,311,75,1321,5849,2162,18.42,81.58,30.15
E02005394,Melton 004,9766,1321,927,1328,1339,1142,1249,1108,869,366,117,2248,7518,2460,23.02,76.98,25.19
E02005395,Melton 005,8803,954,691,1020,1057,1050,1477,1133,922,399,100,1645,7158,2554,18.69,81.31,29.01
E02005396,Melton 006,6639,529,609,615,453,825,1273,1032,873,355,75,1138,5501,2335,17.14,82.86,35.17
E02005397,North West Leicestershire 001,9198,990,780,1085,1061,1312,1484,1144,952,321,69,1770,7428,2486,19.24,80.76,27.03
E02005398,North West Leicestershire 002,6628,638,456,1268,701,788,956,799,674,290,58,1094,5534,1821,16.51,83.49,27.47
E02005399,North West Leicestershire 003,8160,1004,909,983,1115,1132,1072,887,701,292,65,1913,6247,1945,23.44,76.56,23.84
E02005400,North West Leicestershire 004,5843,613,467,575,669,680,870,868,754,290,57,1080,4763,1969,18.48,81.52,33.7
E02005401,North West Leicestershire 005,6419,617,661,601,635,849,1128,886,693,267,82,1278,5141,1928,19.91,80.09,30.04
E02005402,North West Leicestershire 006,6690,701,710,625,738,906,956,814,788,352,100,1411,5279,2054,21.09,78.91,30.7
E02005403,North West Leicestershire 007,6853,612,566,865,798,841,1050,863,812,375,71,1178,5675,2121,17.19,82.81,30.95
E02005404,North West Leicestershire 008,8450,975,807,1079,908,1160,1397,1016,745,289,74,1782,6668,2124,21.09,78.91,25.14
E02005405,North West Leicestershire 009,7019,768,734,876,792,880,963,844,763,328,71,1502,5517,2006,21.4,78.6,28.58
E02005406,North West Leicestershire 010,8182,1096,711,1390,1228,1125,1143,700,491,207,91,1807,6375,1489,22.09,77.91,18.2
E02005407,North West Leicestershire 011,10237,1276,926,1491,1472,1492,1494,958,786,300,42,2202,8035,2086,21.51,78.49,20.38
E02005408,North West Leicestershire 012,8031,895,736,1036,935,1064,1272,1011,771,262,49,1631,6400,2093,20.31,79.69,26.06
E02005409,North West Leicestershire 013,11901,1503,1070,1541,1472,1655,1830,1280,1054,420,76,2573,9328,2830,21.62,78.38,23.78
E02005412,Oadby and Wigston 003,8722,964,880,1057,966,1043,1140,1000,863,646,163,1844,6878,2672,21.14,78.86,30.64
E02005414,Oadby and Wigston 005,8162,1015,731,1148,974,962,1074,847,681,524,206,1746,6416,2258,21.39,78.61,27.66
E02005415,Oadby and Wigston 006,8055,1074,631,1237,1186,959,1079,749,666,410,64,1705,6350,1889,21.17,78.83,23.45
E02005416,Oadby and Wigston 007,8416,804,742,973,842,923,1251,1172,1178,448,83,1546,6870,2881,18.37,81.63,34.23
E02006818,Oadby and Wigston 008,8205,934,746,913,1012,998,1159,936,778,607,122,1680,6525,2443,20.48,79.52,29.77
E02006911,Oadby and Wigston 009,15455,1667,1580,3190,1580,1850,2102,1520,1154,649,163,3247,12208,3486,21.01,78.99,22.56
E02005417,Boston 001,7468,670,549,752,670,846,1289,1193,987,426,86,1219,6249,2692,16.32,83.68,36.05
E02005418,Boston 002,11622,1751,1094,1862,1940,1551,1314,1043,640,369,58,2845,8777,2110,24.48,75.52,18.16
E02005419,Boston 003,9097,1163,692,1614,1648,1253,1242,724,437,244,80,1855,7242,1485,20.39,79.61,16.32
E02005420,Boston 004,8850,1213,799,1208,1346,1029,1064,900,806,378,107,2012,6838,2191,22.73,77.27,24.76
E02005422,Boston 006,6258,706,521,681,640,688,881,931,810,322,78,1227,5031,2141,19.61,80.39,34.21
E02005423,Boston 007,10122,1352,893,1138,1218,1066,1309,1382,1131,511,122,2245,7877,3146,22.18,77.82,31.08
E02006864,Boston 008,8613,1078,777,985,946,980,1187,1097,1029,441,93,1855,6758,2660,21.54,78.46,30.88
E02006865,Boston 009,8143,981,643,998,1061,927,997,1015,949,467,105,1624,6519,2536,19.94,80.06,31.14
E02005424,East Lindsey 001,10196,822,823,980,854,1124,1677,1721,1552,539,104,1645,8551,3916,16.13,83.87,38.41
E02005425,East Lindsey 002,6452,550,511,552,559,698,1060,1155,927,392,48,1061,5391,2522,16.44,83.56,39.09
E02005426,East Lindsey 003,10319,1346,973,1140,1189,1241,1396,1238,1106,552,138,2319,8000,3034,22.47,77.53,29.4
E02005427,East Lindsey 004,7094,706,585,937,748,864,981,978,800,398,97,1291,5803,2273,18.2,81.8,32.04
E02005428,East Lindsey 005,8245,670,510,702,622,720,1340,1592,1466,545,78,1180,7065,3681,14.31,85.69,44.65
E02005429,East Lindsey 006,6443,366,288,395,267,427,958,1467,1580,603,92,654,5789,3742,10.15,89.85,58.08
E02005430,East Lindsey 007,7151,591,523,618,576,737,1245,1223,1082,457,99,1114,6037,2861,15.58,84.42,40.01
E02005431,East Lindsey 008,8710,772,669,886,748,813,1365,1461,1343,544,109,1441,7269,3457,16.54,83.46,39.69
E02005432,East Lindsey 009,7694,575,542,666,569,791,1394,1461,1204,416,76,1117,6577,3157,14.52,85.48,41.03
E02005433,East Lindsey 010,7023,410,384,649,489,555,1132,1447,1352,536,69,794,6229,3404,11.31,88.69,48.47
E02005434,East Lindsey 011,7379,683,606,838,744,841,1151,913,997,505,101,1289,6090,2516,17.47,82.53,34.1
E02005435,East Lindsey 012,7335,716,573,788,689,718,1060,1174,1122,423,72,1289,6046,2791,17.57,82.43,38.05
E02005436,East Lindsey 013,8212,893,617,836,723,877,1158,1325,1173,506,104,1510,6702,3108,18.39,81.61,37.85
E02005437,East Lindsey 014,5948,586,508,773,707,687,950,844,564,250,79,1094,4854,1737,18.39,81.61,29.2
E02005438,East Lindsey 015,7075,760,646,751,681,809,990,1000,897,441,100,1406,5669,2438,19.87,80.13,34.46
E02005439,East Lindsey 016,12342,1528,937,1795,1441,1224,1538,1505,1451,761,162,2465,9877,3879,19.97,80.03,31.43
E02005440,East Lindsey 017,5434,527,477,516,424,587,850,942,749,304,58,1004,4430,2053,18.48,81.52,37.78
E02005441,East Lindsey 018,8675,742,746,785,685,975,1505,1432,1187,531,87,1488,7187,3237,17.15,82.85,37.31
E02005442,Lincoln 001,6115,870,583,989,838,616,857,623,439,235,65,1453,4662,1362,23.76,76.24,22.27
E02005443,Lincoln 002,7275,993,566,1187,965,802,940,732,660,355,75,1559,5716,1822,21.43,78.57,25.04
E02005444,Lincoln 003,12246,1194,778,2956,1697,1350,1454,1192,951,536,138,1972,10274,2817,16.1,83.9,23.0
E02005445,Lincoln 004,12153,1639,1133,3060,1864,1459,1292,908,527,215,56,2772,9381,1706,22.81,77.19,14.04
E02005446,Lincoln 005,10958,318,261,7629,700,494,570,484,313,148,41,579,10379,986,5.28,94.72,9.0
E02005447,Lincoln 006,7573,725,478,2659,1210,801,710,443,269,196,82,1203,6370,990,15.89,84.11,13.07
E02005448,Lincoln 007,7091,1140,702,1221,1062,757,871,642,487,185,24,1842,5249,1338,25.98,74.02,18.87
E02005449,Lincoln 008,9273,778,537,3631,1038,795,983,648,541,254,68,1315,7958,1511,14.18,85.82,16.29
E02005450,Lincoln 009,7982,767,599,1043,912,877,1127,1111,889,470,187,1366,6616,2657,17.11,82.89,33.29
E02005451,Lincoln 010,7731,1152,652,1414,1134,919,1001,711,457,251,40,1804,5927,1459,23.33,76.67,18.87
E02005452,Lincoln 011,10902,1264,1010,1340,1149,1313,1637,1332,1125,622,110,2274,8628,3189,20.86,79.14,29.25
E02005453,North Kesteven 001,11029,941,998,1163,1059,1428,1807,1421,1459,640,113,1939,9090,3633,17.58,82.42,32.94
E02005455,North Kesteven 003,14187,1669,1244,1631,1907,1903,2051,1609,1479,591,103,2913,11274,3782,20.53,79.47,26.66
E02005456,North Kesteven 004,10598,1349,833,1474,1613,1207,1306,1117,1019,583,97,2182,8416,2816,20.59,79.41,26.57
E02005457,North Kesteven 005,8582,915,731,792,936,1081,1361,1098,1064,493,111,1646,6936,2766,19.18,80.82,32.23
E02005458,North Kesteven 006,6837,588,622,677,549,837,1150,917,983,439,75,1210,5627,2414,17.7,82.3,35.31
E02005459,North Kesteven 007,8426,965,787,835,825,942,1373,1207,1007,416,69,1752,6674,2699,20.79,79.21,32.03
E02005460,North Kesteven 008,6511,819,479,1047,1046,831,846,662,548,208,25,1298,5213,1443,19.94,80.06,22.16
E02005461,North Kesteven 009,6283,395,540,530,423,738,1142,1014,977,460,64,935,5348,2515,14.88,85.12,40.03
E02005462,North Kesteven 010,9761,1204,889,1311,1239,1197,1361,1065,945,450,100,2093,7668,2560,21.44,78.56,26.23
E02005463,North Kesteven 011,9773,1198,1006,1166,1342,1403,1497,940,801,357,63,2204,7569,2161,22.55,77.45,22.11
E02005464,North Kesteven 012,8558,763,702,804,729,931,1498,1275,1246,508,102,1465,7093,3131,17.12,82.88,36.59
E02006866,North Kesteven 013,8491,1057,741,1338,1276,967,1072,772,792,381,95,1798,6693,2040,21.18,78.82,24.03
E02006867,North Kesteven 014,7879,764,640,877,826,912,1149,983,1038,609,81,1404,6475,2711,17.82,82.18,34.41
E02005465,South Holland 001,8563,846,687,887,759,972,1358,1358,1095,500,101,1533,7030,3054,17.9,82.1,35.67
E02005466,South Holland 002,6685,658,555,685,531,788,1032,986,977,406,67,1213,5472,2436,18.15,81.85,36.44
E02005467,South Holland 003,7563,858,604,912,824,892,1007,928,858,574,106,1462,6101,2466,19.33,80.67,32.61
E02005468,South Holland 004,7623,765,652,697,682,942,1271,1095,1008,426,85,1417,6206,2614,18.59,81.41,34.29
E02005469,South Holland 005,8045,965,678,871,968,973,1219,1060,840,366,105,1643,6402,2371,20.42,79.58,29.47
E02005470,South Holland 006,13039,1688,962,2028,2033,1757,1601,1165,1023,629,153,2650,10389,2970,20.32,79.68,22.78
E02005471,South Holland 007,9792,1167,904,1300,1353,1133,1392,1071,884,476,112,2071,7721,2543,21.15,78.85,25.97
E02005472,South Holland 008,9869,1080,819,1015,983,1091,1369,1336,1358,673,145,1899,7970,3512,19.24,80.76,35.59
E02005473,South Holland 009,10264,1279,859,1351,1532,1360,1246,1021,981,507,128,2138,8126,2637,20.83,79.17,25.69
E02005474,South Holland 010,6793,606,504,628,570,782,1205,1061,968,397,72,1110,5683,2498,16.34,83.66,36.77
E02005475,South Holland 011,6783,793,659,745,698,857,1049,849,776,300,57,1452,5331,1982,21.41,78.59,29.22
E02005476,South Kesteven 001,7220,650,717,552,631,930,1347,1055,912,374,52,1367,5853,2393,18.93,81.07,33.14
E02005477,South Kesteven 002,9112,786,838,631,641,1127,1503,1508,1405,578,95,1624,7488,3586,17.82,82.18,39.35
E02005478,South Kesteven 003,9926,1160,973,1077,1047,1243,1360,1283,1119,492,172,2133,7793,3066,21.49,78.51,30.89
E02005479,South Kesteven 004,9252,1018,854,1106,1091,1191,1383,1137,940,425,107,1872,7380,2609,20.23,79.77,28.2
E02005480,South Kesteven 005,7636,1288,953,1042,1070,978,882,677,534,188,24,2241,5395,1423,29.35,70.65,18.64
E02005481,South Kesteven 006,12655,1689,1100,2053,1968,1623,1683,1079,892,434,134,2789,9866,2539,22.04,77.96,20.06
E02005482,South Kesteven 007,9677,966,880,876,962,1287,1624,1537,1090,393,62,1846,7831,3082,19.08,80.92,31.85
E02005483,South Kesteven 008,7932,747,745,774,701,963,1413,1124,965,403,97,1492,6440,2589,18.81,81.19,32.64
E02005484,South Kesteven 009,7211,783,621,620,752,880,1269,989,892,363,42,1404,5807,2286,19.47,80.53,31.7
E02005485,South Kesteven 010,7509,877,739,834,865,968,1033,913,800,383,97,1616,5893,2193,21.52,78.48,29.2
E02005486,South Kesteven 011,9791,1197,976,1155,1186,1267,1269,1032,959,569,181,2173,7618,2741,22.19,77.81,28.0
E02005487,South Kesteven 012,9751,888,960,768,775,1283,1748,1467,1239,525,98,1848,7903,3329,18.95,81.05,34.14
E02005488,South Kesteven 013,6916,793,634,660,695,846,964,1066,810,366,82,1427,5489,2324,20.63,79.37,33.6
E02005489,South Kesteven 014,7187,785,683,737,786,974,1051,1057,776,280,58,1468,5719,2171,20.43,79.57,30.21
E02005490,South Kesteven 015,9412,1144,819,1102,1246,1247,1282,1051,940,479,102,1963,7449,2572,20.86,79.14,27.33
E02005491,South Kesteven 016,11237,1123,987,1181,1349,1443,1670,1372,1309,648,155,2110,9127,3484,18.78,81.22,31.0
E02005492,West Lindsey 001,9748,885,864,918,847,1113,1651,1627,1242,486,115,1749,7999,3470,17.94,82.06,35.6
E02005493,West Lindsey 002,10144,1010,912,1136,968,1288,1644,1340,1179,549,118,1922,8222,3186,18.95,81.05,31.41
E02005494,West Lindsey 003,10158,994,855,1237,932,1130,1573,1422,1316,574,125,1849,8309,3437,18.2,81.8,33.84
E02005495,West Lindsey 004,10675,1387,921,1736,1373,1186,1590,1175,863,378,66,2308,8367,2482,21.62,78.38,23.25
E02005496,West Lindsey 005,6519,590,554,665,707,746,1164,1022,790,256,25,1144,5375,2093,17.55,82.45,32.11
E02005497,West Lindsey 006,7856,1254,868,1178,964,941,934,745,612,298,62,2122,5734,1717,27.01,72.99,21.86
E02005498,West Lindsey 007,7404,598,474,650,593,778,1256,1243,1227,499,86,1072,6332,3055,14.48,85.52,41.26
E02005499,West Lindsey 008,8445,877,912,899,847,1056,1326,1145,910,411,62,1789,6656,2528,21.18,78.82,29.93
E02005500,West Lindsey 009,7314,789,535,781,840,882,1204,1005,872,346,60,1324,5990,2283,18.1,81.9,31.21
E02005501,West Lindsey 010,7810,782,626,718,768,942,1176,1105,1077,522,94,1408,6402,2798,18.03,81.97,35.83
E02005502,West Lindsey 011,9594,959,784,944,1020,1141,1339,1412,1317,570,108,1743,7851,3407,18.17,81.83,35.51
E02005503,Breckland 001,7420,776,602,858,731,806,1056,1046,962,455,128,1378,6042,2591,18.57,81.43,34.92
E02005504,Breckland 002,9110,868,740,874,709,966,1475,1451,1294,617,116,1608,7502,3478,17.65,82.35,38.18
E02005505,Breckland 003,7600,874,683,915,769,862,1041,884,891,505,176,1557,6043,2456,20.49,79.51,32.32
E02005506,Breckland 004,6943,723,509,784,655,798,1019,1037,908,430,80,1232,5711,2455,17.74,82.26,35.36
E02005507,Breckland 005,11864,1304,1049,1601,1369,1423,1582,1345,1372,692,127,2353,9511,3536,19.83,80.17,29.8
E02005508,Breckland 006,7007,640,561,641,677,824,1157,1061,999,372,75,1201,5806,2507,17.14,82.86,35.78
E02005509,Breckland 007,8278,883,563,901,801,815,972,1175,1238,716,214,1446,6832,3343,17.47,82.53,40.38
E02005510,Breckland 008,7023,633,493,696,564,685,1053,1136,1144,484,135,1126,5897,2899,16.03,83.97,41.28
E02005511,Breckland 009,8248,824,493,1010,941,868,1103,1070,1133,649,157,1317,6931,3009,15.97,84.03,36.48
E02005512,Breckland 010,9450,1028,747,1287,1203,1192,1375,1249,978,329,62,1775,7675,2618,18.78,81.22,27.7
E02005513,Breckland 011,9953,1134,790,1318,1263,1142,1393,1092,1073,582,166,1924,8029,2913,19.33,80.67,29.27
E02005514,Breckland 012,6903,654,539,702,672,750,1138,1063,944,381,60,1193,5710,2448,17.28,82.72,35.46
E02005515,Breckland 013,6424,653,625,680,647,812,1056,830,698,346,77,1278,5146,1951,19.89,80.11,30.37
E02005516,Breckland 014,6908,751,553,661,689,784,1064,1052,912,356,86,1304,5604,2406,18.88,81.12,34.83
E02005517,Breckland 015,6533,1013,763,1041,1024,778,808,553,352,166,35,1776,4757,1106,27.19,72.81,16.93
E02005518,Breckland 016,11391,1298,989,1650,1953,1397,1499,1101,909,492,103,2287,9104,2605,20.08,79.92,22.87
E02005519,Breckland 017,8913,1322,944,1273,1355,1091,1135,809,571,354,59,2266,6647,1793,25.42,74.58,20.12
E02005520,Broadland 001,8657,859,729,854,837,1001,1225,1194,1250,586,122,1588,7069,3152,18.34,81.66,36.41
E02005521,Broadland 002,8781,766,801,943,849,1074,1439,1271,1122,419,97,1567,7214,2909,17.85,82.15,33.13
E02005522,Broadland 003,5534,547,464,545,540,753,857,757,691,313,67,1011,4523,1828,18.27,81.73,33.03
E02005523,Broadland 004,8470,1005,817,942,1041,1104,1349,1035,823,299,55,1822,6648,2212,21.51,78.49,26.12
E02005524,Broadland 005,5487,554,409,554,543,676,860,816,708,323,44,963,4524,1891,17.55,82.45,34.46
E02005525,Broadland 006,10164,1032,955,1285,1132,1436,1547,1145,1040,474,118,1987,8177,2777,19.55,80.45,27.32
E02005526,Broadland 007,5348,551,466,643,576,719,767,605,546,401,74,1017,4331,1626,19.02,80.98,30.4
E02005527,Broadland 008,8922,977,806,971,950,1162,1275,1072,1030,557,122,1783,7139,2781,19.98,80.02,31.17
E02005528,Broadland 009,8597,837,698,971,1083,1132,1126,1064,1031,542,113,1535,7062,2750,17.86,82.14,31.99
E02005529,Broadland 010,5904,543,402,591,548,606,881,786,833,561,153,945,4959,2333,16.01,83.99,39.52
E02005530,Broadland 011,5483,501,416,614,663,654,829,682,670,388,66,917,4566,1806,16.72,83.28,32.94
E02005531,Broadland 012,5447,557,427,672,632,655,824,684,620,292,84,984,4463,1680,18.06,81.94,30.84
E02005532,Broadland 013,8282,860,553,917,981,933,1137,1046,1086,675,94,1413,6869,2901,17.06,82.94,35.03
E02005533,Broadland 014,8917,869,843,791,866,1112,1354,1252,1212,520,98,1712,7205,3082,19.2,80.8,34.56
E02005534,Broadland 015,7281,615,651,732,709,943,1148,989,865,492,137,1266,6015,2483,17.39,82.61,34.1
E02005535,Broadland 016,7243,754,737,927,896,1110,1057,790,567,323,82,1491,5752,1762,20.59,79.41,24.33
E02005536,Broadland 017,6216,606,476,595,602,756,999,891,828,380,83,1082,5134,2182,17.41,82.59,35.1
E02005537,Broadland 018,6050,577,509,659,611,668,898,817,794,421,96,1086,4964,2128,17.95,82.05,35.17
E02005538,Great Yarmouth 001,9068,673,630,793,705,864,1476,1690,1508,569,160,1303,7765,3927,14.37,85.63,43.31
E02005539,Great Yarmouth 002,7534,700,570,745,695,798,1225,1247,1052,425,77,1270,6264,2801,16.86,83.14,37.18
E02005540,Great Yarmouth 003,8995,735,659,867,793,887,1317,1369,1502,730,136,1394,7601,3737,15.5,84.5,41.55
E02005541,Great Yarmouth 004,5924,592,608,761,633,679,807,712,691,355,86,1200,4724,1844,20.26,79.74,31.13
E02005542,Great Yarmouth 005,7554,1016,608,1343,1051,859,1025,810,575,220,47,1624,5930,1652,21.5,78.5,21.87
E02005543,Great Yarmouth 006,9707,1448,1022,1633,1464,1209,1243,837,563,210,78,2470,7237,1688,25.45,74.55,17.39
E02005544,Great Yarmouth 007,7497,1130,808,1231,1094,815,983,694,480,225,37,1938,5559,1436,25.85,74.15,19.15
E02005545,Great Yarmouth 008,6351,598,520,617,678,732,868,886,987,387,78,1118,5233,2338,17.6,82.4,36.81
E02005546,Great Yarmouth 009,7892,1088,660,1264,912,800,1028,908,794,349,89,1748,6144,2140,22.15,77.85,27.12
E02005547,Great Yarmouth 010,8812,960,839,1190,965,1041,1175,1051,981,493,117,1799,7013,2642,20.42,79.58,29.98
E02005548,Great Yarmouth 011,7498,983,790,1022,904,761,947,789,720,436,146,1773,5725,2091,23.65,76.35,27.89
E02005549,Great Yarmouth 012,5270,452,406,485,462,577,853,885,789,294,67,858,4412,2035,16.28,83.72,38.61
E02005550,Great Yarmouth 013,7234,792,560,809,824,811,1088,913,907,438,92,1352,5882,2350,18.69,81.31,32.49
E02005551,King's Lynn and West Norfolk 001,5246,310,296,392,334,409,704,970,1074,589,168,606,4640,2801,11.55,88.45,53.39
E02005552,King's Lynn and West Norfolk 002,6790,558,490,443,485,722,1064,1225,1178,516,109,1048,5742,3028,15.43,84.57,44.59
E02005553,King's Lynn and West Norfolk 003,8632,608,537,573,534,771,1280,1527,1834,787,181,1145,7487,4329,13.26,86.74,50.15
E02005554,King's Lynn and West Norfolk 004,6905,591,483,528,535,651,978,1125,1287,603,124,1074,5831,3139,15.55,84.45,45.46
E02005555,King's Lynn and West Norfolk 005,6847,647,630,570,666,816,967,1047,915,473,116,1277,5570,2551,18.65,81.35,37.26
E02005556,King's Lynn and West Norfolk 006,7408,908,631,851,911,907,1068,916,751,388,77,1539,5869,2132,20.77,79.23,28.78
E02005557,King's Lynn and West Norfolk 007,6655,1041,723,1067,1080,784,819,539,394,165,43,1764,4891,1141,26.51,73.49,17.15
E02005558,King's Lynn and West Norfolk 008,7087,759,607,744,665,780,1063,1015,941,460,53,1366,5721,2469,19.27,80.73,34.84
E02005559,King's Lynn and West Norfolk 009,7266,881,711,914,1040,914,1018,801,573,330,84,1592,5674,1788,21.91,78.09,24.61
E02005560,King's Lynn and West Norfolk 010,9204,1361,1022,1348,1556,1232,1058,737,588,268,34,2383,6821,1627,25.89,74.11,17.68
E02005561,King's Lynn and West Norfolk 011,11213,1473,977,1875,1866,1353,1360,1019,817,388,85,2450,8763,2309,21.85,78.15,20.59
E02005562,King's Lynn and West Norfolk 012,7150,723,525,629,632,794,1236,1093,1038,412,68,1248,5902,2611,17.45,82.55,36.52
E02005563,King's Lynn and West Norfolk 013,7551,788,684,836,668,861,1230,1086,927,389,82,1472,6079,2484,19.49,80.51,32.9
E02005564,King's Lynn and West Norfolk 014,9930,1326,754,1483,1246,934,1268,1232,1097,488,102,2080,7850,2919,20.95,79.05,29.4
E02005565,King's Lynn and West Norfolk 015,6996,763,598,776,721,891,1082,915,843,349,58,1361,5635,2165,19.45,80.55,30.95
E02005566,King's Lynn and West Norfolk 016,9847,1087,810,953,973,1069,1699,1428,1176,570,82,1897,7950,3256,19.26,80.74,33.07
E02005567,King's Lynn and West Norfolk 017,11005,1262,833,1150,1269,1191,1300,1297,1504,970,229,2095,8910,4000,19.04,80.96,36.35
E02005568,King's Lynn and West Norfolk 018,7423,791,609,625,660,828,1214,1150,1008,481,57,1400,6023,2696,18.86,81.14,36.32
E02005569,King's Lynn and West Norfolk 019,8228,1001,796,997,814,1028,1268,1080,851,339,54,1797,6431,2324,21.84,78.16,28.25
E02005570,North Norfolk 001,7365,546,525,595,529,694,937,1230,1314,783,212,1071,6294,3539,14.54,85.46,48.05
E02005571,North Norfolk 002,5990,400,424,497,469,559,866,1089,1006,574,106,824,5166,2775,13.76,86.24,46.33
E02005572,North Norfolk 003,7738,590,494,705,757,764,1055,1264,1233,634,242,1084,6654,3373,14.01,85.99,43.59
E02005573,North Norfolk 004,5874,378,581,598,333,466,674,965,1096,636,147,959,4915,2844,16.33,83.67,48.42
E02005574,North Norfolk 005,7117,504,450,601,558,650,1266,1282,1183,510,113,954,6163,3088,13.4,86.6,43.39
E02005575,North Norfolk 006,7169,572,637,588,522,715,1192,1306,1076,469,92,1209,5960,2943,16.86,83.14,41.05
E02005576,North Norfolk 007,6730,532,442,565,447,631,1016,1209,1200,545,143,974,5756,3097,14.47,85.53,46.02
E02005577,North Norfolk 008,6084,540,485,620,569,686,936,990,841,348,69,1025,5059,2248,16.85,83.15,36.95
E02005578,North Norfolk 009,5843,595,468,592,645,667,973,833,718,314,38,1063,4780,1903,18.19,81.81,32.57
E02005579,North Norfolk 010,12901,1257,1021,1575,1309,1330,1760,1672,1693,1032,252,2278,10623,4649,17.66,82.34,36.04
E02005580,North Norfolk 011,7937,814,546,875,877,837,1047,1100,1077,612,152,1360,6577,2941,17.13,82.87,37.05
E02005581,North Norfolk 012,8362,725,517,896,957,967,1398,1393,1058,379,72,1242,7120,2902,14.85,85.15,34.7
E02005582,North Norfolk 013,6991,735,450,710,669,725,1049,1139,945,472,97,1185,5806,2653,16.95,83.05,37.95
E02005583,North Norfolk 014,8736,568,551,723,634,846,1261,1624,1568,789,172,1119,7617,4153,12.81,87.19,47.54
E02005584,Norwich 001,10955,1484,917,1986,1756,1353,1331,960,724,351,93,2401,8554,2128,21.92,78.08,19.42
E02005585,Norwich 002,11017,1588,1139,2137,1845,1264,1245,808,651,285,55,2727,8290,1799,24.75,75.25,16.33
E02005586,Norwich 003,9889,1229,654,2130,2066,1349,1073,705,480,167,36,1883,8006,1388,19.04,80.96,14.04
E02005587,Norwich 004,9985,1337,997,1487,1314,1199,1243,895,800,585,128,2334,7651,2408,23.38,76.62,24.12
E02005588,Norwich 005,12054,1444,1122,3482,1548,1294,1173,969,669,276,77,2566,9488,1991,21.29,78.71,16.52
E02005589,Norwich 006,11841,1540,1157,3123,1613,1257,1249,828,649,355,70,2697,9144,1902,22.78,77.22,16.06
E02005590,Norwich 007,11086,974,414,3055,1879,1167,1169,1012,837,432,147,1388,9698,2428,12.52,87.48,21.9
E02005592,Norwich 009,9394,861,655,3001,1292,1005,1017,797,525,180,61,1516,7878,1563,16.14,83.86,16.64
E02005593,Norwich 010,12414,789,716,7305,858,633,730,551,430,314,88,1505,10909,1383,12.12,87.88,11.14
E02005594,Norwich 011,11105,1010,663,2715,1697,1206,1251,1129,884,421,129,1673,9432,2563,15.07,84.93,23.08
E02005595,Norwich 012,8952,841,774,1250,751,956,1195,1087,1169,711,218,1615,7337,3185,18.04,81.96,35.58
E02005596,Norwich 013,9370,1266,895,1503,1299,1081,1107,853,770,455,141,2161,7209,2219,23.06,76.94,23.68
E02006907,Norwich 014,6796,489,235,1926,1482,791,682,488,414,208,81,724,6072,1191,10.65,89.35,17.53
E02006908,Norwich 015,5715,631,332,1182,993,727,685,572,375,182,36,963,4752,1165,16.85,83.15,20.38
E02005597,South Norfolk 001,16660,2274,1416,2394,2727,2113,1993,1530,1374,695,144,3690,12970,3743,22.15,77.85,22.47
E02005598,South Norfolk 002,9977,1364,920,980,1330,1484,1265,1048,963,499,124,2284,7693,2634,22.89,77.11,26.4
E02005599,South Norfolk 003,6569,779,584,733,758,858,807,775,781,400,94,1363,5206,2050,20.75,79.25,31.21
E02005600,South Norfolk 004,6635,541,1121,781,476,785,956,829,758,316,72,1662,4973,1975,25.05,74.95,29.77
E02005601,South Norfolk 005,5673,438,433,581,557,706,915,715,826,416,86,871,4802,2043,15.35,84.65,36.01
E02005602,South Norfolk 006,12285,1316,1080,1160,1329,1563,1879,1591,1427,790,150,2396,9889,3958,19.5,80.5,32.22
E02005603,South Norfolk 007,11652,1663,1285,1406,1525,1671,1589,1095,931,408,79,2948,8704,2513,25.3,74.7,21.57
E02005604,South Norfolk 008,8600,814,825,857,758,1077,1340,1202,1053,552,122,1639,6961,2929,19.06,80.94,34.06
E02005605,South Norfolk 009,10777,1238,935,1063,1179,1464,1592,1437,1236,499,134,2173,8604,3306,20.16,79.84,30.68
E02005606,South Norfolk 010,5848,509,540,602,501,760,982,896,700,326,32,1049,4799,1954,17.94,82.06,33.41
E02005607,South Norfolk 011,11561,1218,1039,1254,1212,1488,1806,1545,1325,566,108,2257,9304,3544,19.52,80.48,30.65
E02005608,South Norfolk 012,7756,705,595,763,684,914,1238,1176,1072,499,110,1300,6456,2857,16.76,83.24,36.84
E02005609,South Norfolk 013,7526,849,617,772,792,873,977,976,1035,538,97,1466,6060,2646,19.48,80.52,35.16
E02005610,South Norfolk 014,8162,693,701,772,672,1006,1333,1304,1119,460,102,1394,6768,2985,17.08,82.92,36.57
E02005611,South Norfolk 015,11199,1199,834,1354,1393,1401,1526,1270,1270,744,208,2033,9166,3492,18.15,81.85,31.18
E02005612,Corby 001,7318,867,669,896,999,856,1162,918,631,248,72,1536,5782,1869,20.99,79.01,25.54
E02005613,Corby 002,9423,1336,917,1293,1356,1156,1381,978,641,304,61,2253,7170,1984,23.91,76.09,21.05
E02005614,Corby 003,11154,1809,1007,1372,1920,1492,1536,1031,637,295,55,2816,8338,2018,25.25,74.75,18.09
E02005615,Corby 004,9110,1199,779,1142,1244,1023,1332,1060,837,436,58,1978,7132,2391,21.71,78.29,26.25
E02005616,Corby 005,5699,733,551,837,863,737,874,510,386,193,15,1284,4415,1104,22.53,77.47,19.37
E02005617,Corby 006,10882,1742,1125,1636,1797,1240,1377,986,654,282,43,2867,8015,1965,26.35,73.65,18.06
E02006862,Corby 008,6506,847,604,849,857,767,962,887,533,174,26,1451,5055,1620,22.3,77.7,24.9
E02006863,Corby 009,12126,2066,1568,1675,2340,2014,1305,662,354,106,36,3634,8492,1158,29.97,70.03,9.55
E02005619,Daventry 001,6153,608,535,639,495,816,1153,886,658,297,66,1143,5010,1907,18.58,81.42,30.99
E02005620,Daventry 002,8957,964,1044,1071,924,1149,1466,1138,823,293,85,2008,6949,2339,22.42,77.58,26.11
E02005621,Daventry 003,8822,752,719,1029,1029,1109,1440,1237,1033,414,60,1471,7351,2744,16.67,83.33,31.1
E02005622,Daventry 004,9477,991,953,1006,842,1301,1638,1300,1011,374,61,1944,7533,2746,20.51,79.49,28.98
E02005623,Daventry 005,9835,1185,952,1089,1014,1226,1535,1227,1031,455,121,2137,7698,2834,21.73,78.27,28.82
E02005624,Daventry 006,11006,1486,1097,1582,1619,1554,1632,981,757,263,35,2583,8423,2036,23.47,76.53,18.5
E02005625,Daventry 007,9513,1100,854,1359,1226,1155,1254,999,952,491,123,1954,7559,2565,20.54,79.46,26.96
E02005626,Daventry 008,6831,1034,680,978,1030,901,922,708,438,128,12,1714,5117,1286,25.09,74.91,18.83
E02005627,Daventry 009,7484,794,669,708,777,1022,1129,1059,869,386,71,1463,6021,2385,19.55,80.45,31.87
E02005628,Daventry 010,7872,853,661,840,741,1020,1405,1081,876,326,69,1514,6358,2352,19.23,80.77,29.88
E02005629,East Northamptonshire 001,6425,705,528,560,568,800,1151,935,805,302,71,1233,5192,2113,19.19,80.81,32.89
E02005630,East Northamptonshire 002,10634,968,1616,1008,820,1277,1716,1368,1161,575,125,2584,8050,3229,24.3,75.7,30.36
E02005631,East Northamptonshire 003,10606,1073,1094,1200,1116,1527,1792,1281,1016,403,104,2167,8439,2804,20.43,79.57,26.44
E02005632,East Northamptonshire 004,6632,665,621,648,591,887,1047,974,777,324,98,1286,5346,2173,19.39,80.61,32.77
E02005633,East Northamptonshire 005,9165,1011,760,1126,1102,1140,1388,1157,965,406,110,1771,7394,2638,19.32,80.68,28.78
E02005634,East Northamptonshire 006,9338,1176,901,1278,1208,1251,1342,1009,763,325,85,2077,7261,2182,22.24,77.76,23.37
E02005635,East Northamptonshire 007,9609,1162,938,1085,1183,1455,1387,1024,894,395,86,2100,7509,2399,21.85,78.15,24.97
E02005636,East Northamptonshire 008,12234,1567,1250,1565,1566,1604,1653,1337,1106,463,123,2817,9417,3029,23.03,76.97,24.76
E02005637,East Northamptonshire 009,9596,1243,806,1469,1454,1240,1273,930,679,388,114,2049,7547,2111,21.35,78.65,22.0
E02005638,East Northamptonshire 010,10288,1081,982,1201,1011,1429,1650,1272,1148,436,78,2063,8225,2934,20.05,79.95,28.52
E02005639,Kettering 001,5135,463,408,417,385,603,972,829,714,272,72,871,4264,1887,16.96,83.04,36.75
E02005640,Kettering 002,11520,1481,1118,1371,1431,1587,1606,1301,1111,393,121,2599,8921,2926,22.56,77.44,25.4
E02005641,Kettering 003,8213,1041,738,984,1061,1018,1078,1116,835,278,64,1779,6434,2293,21.66,78.34,27.92
E02005642,Kettering 004,8215,902,855,957,956,1173,1283,892,779,356,62,1757,6458,2089,21.39,78.61,25.43
E02005643,Kettering 005,8478,1386,970,1220,1265,1061,1108,735,490,213,30,2356,6122,1468,27.79,72.21,17.32
E02005644,Kettering 006,9138,1285,859,1688,1746,1234,1048,723,378,139,38,2144,6994,1278,23.46,76.54,13.99
E02005645,Kettering 007,12286,1575,1068,1760,1794,1727,1492,1080,952,626,212,2643,9643,2870,21.51,78.49,23.36
E02005646,Kettering 008,6473,678,653,610,681,882,924,806,871,314,54,1331,5142,2045,20.56,79.44,31.59
E02005647,Kettering 009,7701,962,756,965,981,1049,1140,732,669,361,86,1718,5983,1848,22.31,77.69,24.0
E02005648,Kettering 010,8458,1117,884,920,922,1160,1229,898,905,373,50,2001,6457,2226,23.66,76.34,26.32
E02005649,Kettering 011,16159,2381,1706,1809,2041,2395,2307,1584,1321,504,111,4087,12072,3520,25.29,74.71,21.78
E02005650,Northampton 001,6549,718,530,1556,678,660,733,749,648,217,60,1248,5301,1674,19.06,80.94,25.56
E02005651,Northampton 002,5957,594,430,601,571,672,922,908,795,381,83,1024,4933,2167,17.19,82.81,36.38
E02005652,Northampton 003,6041,732,476,623,673,651,817,782,832,386,69,1208,4833,2069,20.0,80.0,34.25
E02005653,Northampton 004,8527,1606,1002,1209,1258,1147,992,728,450,117,18,2608,5919,1313,30.59,69.41,15.4
E02005654,Northampton 005,8280,1496,993,1131,1276,1063,970,780,420,140,11,2489,5791,1351,30.06,69.94,16.32
E02005655,Northampton 006,6049,763,502,560,643,725,851,799,730,402,74,1265,4784,2005,20.91,79.09,33.15
E02005656,Northampton 007,6020,957,808,765,856,843,702,618,348,111,12,1765,4255,1089,29.32,70.68,18.09
E02005657,Northampton 008,5990,657,486,772,755,713,817,793,645,304,48,1143,4847,1790,19.08,80.92,29.88
E02005658,Northampton 009,6479,1078,692,1175,1001,865,702,479,315,147,25,1770,4709,966,27.32,72.68,14.91
E02005659,Northampton 010,5635,756,567,480,764,720,707,654,557,345,85,1323,4312,1641,23.48,76.52,29.12
E02005660,Northampton 011,6190,926,731,731,713,771,829,737,580,149,23,1657,4533,1489,26.77,73.23,24.05
E02005661,Northampton 012,6794,1166,855,955,899,952,919,528,322,165,33,2021,4773,1048,29.75,70.25,15.43
E02005662,Northampton 013,6548,751,582,929,880,907,1015,580,534,302,68,1333,5215,1484,20.36,79.64,22.66
E02005663,Northampton 014,5283,640,415,588,671,698,788,684,542,222,35,1055,4228,1483,19.97,80.03,28.07
E02005664,Northampton 015,5924,686,433,1045,973,804,803,477,392,226,85,1119,4805,1180,18.89,81.11,19.92
E02005665,Northampton 016,7743,987,778,882,1121,1079,1123,937,578,221,37,1765,5978,1773,22.79,77.21,22.9
E02005666,Northampton 017,8437,1531,1080,1193,1316,1180,968,577,366,182,44,2611,5826,1169,30.95,69.05,13.86
E02005667,Northampton 018,6692,1044,606,695,844,803,906,723,672,327,72,1650,5042,1794,24.66,75.34,26.81
E02005668,Northampton 019,6147,768,527,557,708,718,842,743,717,429,138,1295,4852,2027,21.07,78.93,32.98
E02005669,Northampton 020,5747,610,539,541,501,748,932,772,674,323,107,1149,4598,1876,19.99,80.01,32.64
E02005670,Northampton 021,9884,1429,894,2317,1991,1301,999,538,256,133,26,2323,7561,953,23.5,76.5,9.64
E02005671,Northampton 022,7587,932,632,1489,1380,1130,846,585,314,210,69,1564,6023,1178,20.61,79.39,15.53
E02005672,Northampton 023,8507,1146,624,2340,1808,1147,772,391,186,77,16,1770,6737,670,20.81,79.19,7.88
E02005673,Northampton 024,7221,1022,529,1081,1257,959,841,670,490,284,88,1551,5670,1532,21.48,78.52,21.22
E02005674,Northampton 025,9070,922,525,2330,1711,1151,945,703,410,281,92,1447,7623,1486,15.95,84.05,16.38
E02005675,Northampton 026,5999,1135,690,747,926,798,736,500,308,133,26,1825,4174,967,30.42,69.58,16.12
E02005676,Northampton 027,5995,875,659,788,877,850,822,511,412,177,24,1534,4461,1124,25.59,74.41,18.75
E02005677,Northampton 028,9062,1281,700,1782,1514,1203,1040,742,509,240,51,1981,7081,1542,21.86,78.14,17.02
E02005678,Northampton 029,13450,2485,1504,1580,2228,1926,1508,1029,756,333,101,3989,9461,2219,29.66,70.34,16.5
E02005679,Northampton 030,8467,1190,775,1095,1260,1177,1290,886,498,252,44,1965,6502,1680,23.21,76.79,19.84
E02005680,Northampton 031,8336,1153,1264,934,854,1463,1361,595,443,208,61,2417,5919,1307,28.99,71.01,15.68
E02005681,South Northamptonshire 001,8515,918,859,876,757,1071,1310,1142,1106,398,78,1777,6738,2724,20.87,79.13,31.99
E02005682,South Northamptonshire 002,6977,744,707,626,649,966,1127,959,819,326,54,1451,5526,2158,20.8,79.2,30.93
E02005683,South Northamptonshire 003,14775,1974,1606,1685,1862,2283,2095,1435,1225,496,114,3580,11195,3270,24.23,75.77,22.13
E02005684,South Northamptonshire 004,8923,950,840,886,933,1198,1435,1245,983,369,84,1790,7133,2681,20.06,79.94,30.05
E02005685,South Northamptonshire 005,8958,1067,845,1083,1181,1209,1297,1046,792,344,94,1912,7046,2276,21.34,78.66,25.41
E02005686,South Northamptonshire 006,7964,749,815,754,728,1059,1417,1002,947,397,96,1564,6400,2442,19.64,80.36,30.66
E02005687,South Northamptonshire 007,6583,685,682,628,619,948,1193,840,650,282,56,1367,5216,1828,20.77,79.23,27.77
E02005688,South Northamptonshire 008,9655,1235,949,961,1240,1416,1470,1107,883,351,43,2184,7471,2384,22.62,77.38,24.69
E02005689,South Northamptonshire 009,9658,1323,914,1351,1284,1339,1516,856,666,328,81,2237,7421,1931,23.16,76.84,19.99
E02005690,South Northamptonshire 010,5657,614,452,784,743,746,925,601,502,218,72,1066,4591,1393,18.84,81.16,24.62
E02005691,South Northamptonshire 011,6825,694,584,810,673,871,1142,838,841,325,47,1278,5547,2051,18.73,81.27,30.05
E02005692,Wellingborough 001,6656,630,624,691,582,853,1121,915,869,304,67,1254,5402,2155,18.84,81.16,32.38
E02005693,Wellingborough 002,8772,1359,1062,1101,1170,1113,1125,823,651,321,47,2421,6351,1842,27.6,72.4,21.0
E02005694,Wellingborough 003,7358,786,697,725,775,1053,1134,1105,796,250,37,1483,5875,2188,20.15,79.85,29.74
E02005695,Wellingborough 004,9080,1336,706,1559,1665,1313,994,730,463,245,69,2042,7038,1507,22.49,77.51,16.6
E02005696,Wellingborough 005,6250,1051,770,811,877,735,793,484,492,197,40,1821,4429,1213,29.14,70.86,19.41
E02005697,Wellingborough 006,7117,855,537,1093,1024,895,936,729,572,360,116,1392,5725,1777,19.56,80.44,24.97
E02005698,Wellingborough 007,5919,810,616,632,735,715,853,686,577,248,47,1426,4493,1558,24.09,75.91,26.32
E02005699,Wellingborough 008,8326,1305,1104,1050,1145,1088,1125,751,513,208,37,2409,5917,1509,28.93,71.07,18.12
E02005700,Wellingborough 009,9255,1006,865,821,928,1149,1427,1343,1165,463,88,1871,7384,3059,20.22,79.78,33.05
E02005701,Wellingborough 010,10974,1279,1030,1043,1093,1477,1693,1469,1313,485,92,2309,8665,3359,21.04,78.96,30.61
E02005742,Craven 001,7439,616,547,743,651,807,1232,1218,1059,453,113,1163,6276,2843,15.63,84.37,38.22
E02005743,Craven 002,5061,322,354,423,296,528,917,887,794,432,108,676,4385,2221,13.36,86.64,43.88
E02005744,Craven 003,7970,501,725,807,584,823,1355,1300,1180,573,122,1226,6744,3175,15.38,84.62,39.84
E02005745,Craven 004,5301,469,500,457,386,623,893,803,761,322,87,969,4332,1973,18.28,81.72,37.22
E02005746,Craven 005,6761,804,505,655,794,813,980,976,756,384,94,1309,5452,2210,19.36,80.64,32.69
E02005747,Craven 006,6919,773,619,1010,959,893,895,796,579,298,97,1392,5527,1770,20.12,79.88,25.58
E02005748,Craven 007,7602,752,681,750,741,946,1329,1135,802,367,99,1433,6169,2403,18.85,81.15,31.61
E02005749,Craven 008,10089,1058,887,1049,946,1276,1534,1324,1217,638,160,1945,8144,3339,19.28,80.72,33.1
E02005750,Hambleton 001,7719,632,683,699,675,852,1339,1100,1079,557,103,1315,6404,2839,17.04,82.96,36.78
E02005751,Hambleton 002,8664,584,717,668,561,901,1565,1402,1538,648,80,1301,7363,3668,15.02,84.98,42.34
E02005752,Hambleton 003,6649,611,489,620,580,834,1114,1113,907,330,51,1100,5549,2401,16.54,83.46,36.11
E02005753,Hambleton 004,13486,1548,1164,1655,1644,1586,1956,1606,1380,761,186,2712,10774,3933,20.11,79.89,29.16
E02005754,Hambleton 005,7574,617,598,613,583,843,1269,1282,1111,558,100,1215,6359,3051,16.04,83.96,40.28
E02005755,Hambleton 006,6828,623,540,725,691,784,1227,908,785,439,106,1163,5665,2238,17.03,82.97,32.78
E02005756,Hambleton 007,6913,776,586,1131,805,744,977,914,697,255,28,1362,5551,1894,19.7,80.3,27.4
E02005757,Hambleton 008,8690,829,644,949,948,1077,1401,1183,989,537,133,1473,7217,2842,16.95,83.05,32.7
E02005758,Hambleton 009,9086,1079,781,999,1094,1012,1377,1183,992,473,96,1860,7226,2744,20.47,79.53,30.2
E02005759,Hambleton 010,9232,836,811,875,800,1041,1534,1347,1213,650,125,1647,7585,3335,17.84,82.16,36.12
E02005760,Hambleton 011,6753,696,661,757,728,910,1237,820,628,275,41,1357,5396,1764,20.09,79.91,26.12
E02005761,Harrogate 001,5494,542,528,396,463,726,909,865,716,291,58,1070,4424,1930,19.48,80.52,35.13
E02005762,Harrogate 002,6151,616,631,886,648,731,843,650,646,389,111,1247,4904,1796,20.27,79.73,29.2
E02005763,Harrogate 003,6419,665,651,644,642,832,993,812,804,299,77,1316,5103,1992,20.5,79.5,31.03
E02005764,Harrogate 004,10253,1077,981,954,1128,1307,1527,1271,1213,637,158,2058,8195,3279,20.07,79.93,31.98
E02005765,Harrogate 005,6610,622,543,579,564,812,1164,963,838,419,106,1165,5445,2326,17.62,82.38,35.19
E02005766,Harrogate 006,6057,508,544,477,479,731,1130,993,775,347,73,1052,5005,2188,17.37,82.63,36.12
E02005767,Harrogate 007,7078,681,758,482,550,924,1295,991,873,419,105,1439,5639,2388,20.33,79.67,33.74
E02005768,Harrogate 008,6960,806,1255,609,722,878,957,790,596,280,67,2061,4899,1733,29.61,70.39,24.9
E02005769,Harrogate 009,6937,717,615,718,756,813,1102,894,775,439,108,1332,5605,2216,19.2,80.8,31.94
E02005770,Harrogate 010,9029,1038,705,814,1195,1136,1444,1115,976,533,73,1743,7286,2697,19.3,80.7,29.87
E02005771,Harrogate 011,7489,1029,654,806,1120,1024,1117,849,586,256,48,1683,5806,1739,22.47,77.53,23.22
E02005772,Harrogate 012,5839,545,499,382,475,710,972,953,835,391,77,1044,4795,2256,17.88,82.12,38.64
E02005773,Harrogate 013,8980,1109,771,1146,1348,1253,1343,916,647,335,112,1880,7100,2010,20.94,79.06,22.38
E02005774,Harrogate 014,9292,1110,797,1051,1165,1260,1420,1030,787,512,160,1907,7385,2489,20.52,79.48,26.79
E02005775,Harrogate 015,9775,811,726,1411,1508,1418,1486,1032,777,471,135,1537,8238,2415,15.72,84.28,24.71
E02005776,Harrogate 016,9724,910,1577,1359,742,1088,1560,1128,909,342,109,2487,7237,2488,25.58,74.42,25.59
E02005777,Harrogate 017,8421,1001,813,589,875,1193,1304,1073,890,548,135,1814,6607,2646,21.54,78.46,31.42
E02005778,Harrogate 018,5959,558,548,469,437,775,1173,860,752,344,43,1106,4853,1999,18.56,81.44,33.55
E02005779,Harrogate 019,7727,650,694,815,800,1051,1215,897,818,568,219,1344,6383,2502,17.39,82.61,32.38
E02005780,Harrogate 020,10740,1088,1323,781,867,1575,1690,1276,1162,743,235,2411,8329,3416,22.45,77.55,31.81
E02005781,Harrogate 021,5897,632,563,403,449,768,935,853,781,398,115,1195,4702,2147,20.26,79.74,36.41
E02005782,Richmondshire 001,7628,503,565,479,708,975,1458,1353,1036,490,61,1068,6560,2940,14.0,86.0,38.54
E02005783,Richmondshire 002,8378,684,806,570,925,1001,1410,1296,1029,543,114,1490,6888,2982,17.78,82.22,35.59
E02005784,Richmondshire 003,6188,571,467,968,799,741,931,717,623,314,57,1038,5150,1711,16.77,83.23,27.65
E02005785,Richmondshire 004,16956,2807,1474,4746,3031,1788,1413,835,553,233,76,4281,12675,1697,25.25,74.75,10.01
E02005786,Richmondshire 005,5967,348,380,408,599,666,1119,1087,932,354,74,728,5239,2447,12.2,87.8,41.01
E02005787,Richmondshire 006,8613,625,663,641,960,968,1464,1437,1219,541,95,1288,7325,3292,14.95,85.05,38.22
E02005788,Ryedale 001,6560,516,545,693,486,691,1073,1121,940,423,72,1061,5499,2556,16.17,83.83,38.96
E02005789,Ryedale 002,10716,840,849,1058,831,1131,1596,1788,1619,798,206,1689,9027,4411,15.76,84.24,41.16
E02005790,Ryedale 003,6894,583,684,592,651,705,1169,1072,843,502,93,1267,5627,2510,18.38,81.62,36.41
E02005791,Ryedale 004,6972,735,575,763,692,805,1246,1033,802,263,58,1310,5662,2156,18.79,81.21,30.92
E02005794,Ryedale 007,9753,866,707,922,859,1211,1747,1544,1258,546,93,1573,8180,3441,16.13,83.87,35.28
E02006870,Ryedale 008,14485,1670,1234,1967,1779,1736,2059,1673,1378,799,190,2904,11581,4040,20.05,79.95,27.89
E02005795,Scarborough 001,6955,559,515,745,609,767,1117,1118,892,533,100,1074,5881,2643,15.44,84.56,38.0
E02005796,Scarborough 002,6585,520,503,662,466,663,1163,1219,910,389,90,1023,5562,2608,15.54,84.46,39.61
E02005797,Scarborough 003,6188,655,484,770,650,629,1030,960,723,251,36,1139,5049,1970,18.41,81.59,31.84
E02005798,Scarborough 004,8298,602,624,699,618,817,1419,1464,1373,580,102,1226,7072,3519,14.77,85.23,42.41
E02005799,Scarborough 005,9193,935,782,804,812,897,1321,1342,1403,750,147,1717,7476,3642,18.68,81.32,39.62
E02005800,Scarborough 006,7780,754,618,1194,973,940,1210,1043,691,304,53,1372,6408,2091,17.63,82.37,26.88
E02005801,Scarborough 007,5528,773,600,668,586,597,788,609,562,274,71,1373,4155,1516,24.84,75.16,27.42
E02005802,Scarborough 008,7965,1028,831,1308,1044,1016,1062,815,560,250,51,1859,6106,1676,23.34,76.66,21.04
E02005803,Scarborough 009,9190,917,821,1088,863,1054,1341,1295,999,595,217,1738,7452,3106,18.91,81.09,33.8
E02005804,Scarborough 010,8081,454,416,1185,873,907,1271,1276,948,567,184,870,7211,2975,10.77,89.23,36.81
E02005805,Scarborough 011,7398,714,489,734,661,756,1116,1131,1185,533,79,1203,6195,2928,16.26,83.74,39.58
E02005806,Scarborough 012,7610,1172,843,965,961,831,1048,775,672,296,47,2015,5595,1790,26.48,73.52,23.52
E02005807,Scarborough 013,6386,644,522,535,535,744,965,1032,927,417,65,1166,5220,2441,18.26,81.74,38.22
E02005808,Scarborough 014,11600,996,782,1009,903,1084,1712,2033,2061,896,124,1778,9822,5114,15.33,84.67,44.09
E02005809,Selby 001,7559,822,674,802,786,950,1305,943,830,362,85,1496,6063,2220,19.79,80.21,29.37
E02005810,Selby 002,9478,1151,1005,924,893,1466,1606,1157,852,378,46,2156,7322,2433,22.75,77.25,25.67
E02005811,Selby 003,9631,988,954,967,1102,1286,1513,1327,991,412,91,1942,7689,2821,20.16,79.84,29.29
E02005812,Selby 004,10700,1433,919,1364,1593,1418,1565,1126,833,378,71,2352,8348,2408,21.98,78.02,22.5
E02005813,Selby 005,13455,1951,1170,2307,2357,1626,1648,1097,733,417,149,3121,10334,2396,23.2,76.8,17.81
E02005814,Selby 006,6609,677,526,736,769,736,969,859,823,440,74,1203,5406,2196,18.2,81.8,33.23
E02005815,Selby 007,8471,866,744,891,884,1015,1357,1245,997,428,44,1610,6861,2714,19.01,80.99,32.04
E02005816,Selby 008,8707,859,784,1064,948,1156,1495,1142,891,305,63,1643,7064,2401,18.87,81.13,27.58
E02005817,Selby 009,7355,788,639,774,875,943,1182,1007,788,312,47,1427,5928,2154,19.4,80.6,29.29
E02005818,Selby 010,8655,896,823,843,1022,1129,1444,1170,885,367,76,1719,6936,2498,19.86,80.14,28.86
E02005819,Ashfield 001,6497,746,555,804,722,733,999,878,718,304,38,1301,5196,1938,20.02,79.98,29.83
E02005820,Ashfield 002,5523,473,449,670,602,659,899,706,765,266,34,922,4601,1771,16.69,83.31,32.07
E02005821,Ashfield 003,7007,987,623,1057,974,853,928,745,605,202,33,1610,5397,1585,22.98,77.02,22.62
E02005822,Ashfield 004,10688,1532,1032,1829,1633,1350,1343,1004,582,300,83,2564,8124,1969,23.99,76.01,18.42
E02005823,Ashfield 005,7957,1066,800,1212,1022,889,1104,732,614,378,140,1866,6091,1864,23.45,76.55,23.43
E02005824,Ashfield 006,10047,1065,914,1306,1221,1411,1605,1150,942,388,45,1979,8068,2525,19.7,80.3,25.13
E02005825,Ashfield 007,8046,1035,741,1057,971,996,1126,906,785,381,48,1776,6270,2120,22.07,77.93,26.35
E02005826,Ashfield 008,6376,957,627,923,936,744,811,648,440,237,53,1584,4792,1378,24.84,75.16,21.61
E02005827,Ashfield 009,9446,1127,863,1245,1200,1284,1512,1042,724,374,75,1990,7456,2215,21.07,78.93,23.45
E02005828,Ashfield 010,7963,879,631,964,993,943,1241,1018,931,303,60,1510,6453,2312,18.96,81.04,29.03
E02005829,Ashfield 011,6730,671,613,821,725,868,1020,850,780,320,62,1284,5446,2012,19.08,80.92,29.9
E02005830,Ashfield 012,5974,505,465,706,569,734,1025,843,786,300,41,970,5004,1970,16.24,83.76,32.98
E02005831,Ashfield 013,10400,1315,876,1454,1493,1453,1475,1029,836,401,68,2191,8209,2334,21.07,78.93,22.44
E02005832,Ashfield 014,9375,1122,889,1431,1424,1271,1269,873,691,337,68,2011,7364,1969,21.45,78.55,21.0
E02005833,Ashfield 015,7728,786,672,993,858,926,1215,1018,872,331,57,1458,6270,2278,18.87,81.13,29.48
E02005834,Ashfield 016,8161,1077,844,1176,1189,971,1061,778,691,321,53,1921,6240,1843,23.54,76.46,22.58
E02005835,Bassetlaw 001,10785,1359,970,1322,1243,1284,1626,1273,1083,553,72,2329,8456,2981,21.59,78.41,27.64
E02005836,Bassetlaw 002,9227,911,773,864,779,1141,1559,1375,1215,515,95,1684,7543,3200,18.25,81.75,34.68
E02005837,Bassetlaw 003,7946,697,539,1030,923,993,1300,1165,906,335,58,1236,6710,2464,15.55,84.45,31.01
E02005838,Bassetlaw 004,8257,921,688,984,869,887,1211,1209,1013,401,74,1609,6648,2697,19.49,80.51,32.66
E02005839,Bassetlaw 005,6368,628,495,742,646,753,938,865,760,458,83,1123,5245,2166,17.64,82.36,34.01
E02005840,Bassetlaw 006,9295,1135,995,1292,1109,1347,1501,951,650,260,55,2130,7165,1916,22.92,77.08,20.61
E02005842,Bassetlaw 008,8723,1023,728,1072,911,1072,1327,1043,935,495,117,1751,6972,2590,20.07,79.93,29.69
E02005843,Bassetlaw 009,6812,893,624,992,789,925,1091,699,493,227,79,1517,5295,1498,22.27,77.73,21.99
E02005844,Bassetlaw 010,8570,1100,772,1186,1058,1093,1238,948,776,335,64,1872,6698,2123,21.84,78.16,24.77
E02005846,Bassetlaw 012,7273,1128,663,1291,1121,873,918,630,384,214,51,1791,5482,1279,24.63,75.37,17.59
E02005847,Bassetlaw 013,7172,786,569,988,885,932,1022,849,744,321,76,1355,5817,1990,18.89,81.11,27.75
E02005848,Bassetlaw 014,6420,605,642,721,558,779,1056,886,789,337,47,1247,5173,2059,19.42,80.58,32.07
E02005849,Bassetlaw 015,9394,827,947,967,903,1156,1557,1348,1226,378,85,1774,7620,3037,18.88,81.12,32.33
E02006903,Bassetlaw 016,11217,1225,857,1284,1174,1297,1674,1523,1363,674,146,2082,9135,3706,18.56,81.44,33.04
E02005850,Broxtowe 001,7059,704,556,835,732,856,1060,1042,855,339,80,1260,5799,2316,17.85,82.15,32.81
E02005851,Broxtowe 002,6281,764,597,854,818,701,869,779,564,268,67,1361,4920,1678,21.67,78.33,26.72
E02005852,Broxtowe 003,8399,749,669,962,872,1060,1257,1095,1176,490,69,1418,6981,2830,16.88,83.12,33.69
E02005853,Broxtowe 004,9236,911,827,1047,1059,1227,1489,1230,987,395,64,1738,7498,2676,18.82,81.18,28.97
E02005856,Broxtowe 007,7334,763,601,698,741,928,1038,1032,922,488,123,1364,5970,2565,18.6,81.4,34.97
E02005857,Broxtowe 008,6471,881,629,894,862,848,818,597,610,305,27,1510,4961,1539,23.33,76.67,23.78
E02005858,Broxtowe 009,8255,884,666,1870,1159,1089,980,729,560,267,51,1550,6705,1607,18.78,81.22,19.47
E02005859,Broxtowe 010,9295,1049,887,1269,1257,1184,1403,983,828,355,80,1936,7359,2246,20.83,79.17,24.16
E02005860,Broxtowe 011,9325,791,472,2779,1552,941,870,755,656,395,114,1263,8062,1920,13.54,86.46,20.59
E02005861,Broxtowe 012,5636,625,404,961,977,648,777,563,453,192,36,1029,4607,1244,18.26,81.74,22.07
E02005862,Broxtowe 013,8223,1056,650,1069,1268,1006,1070,794,837,399,74,1706,6517,2104,20.75,79.25,25.59
E02005863,Broxtowe 014,7596,821,641,812,928,955,1075,925,818,488,133,1462,6134,2364,19.25,80.75,31.12
E02005864,Broxtowe 015,8267,891,817,961,925,1288,1299,956,693,355,82,1708,6559,2086,20.66,79.34,25.23
E02006906,Broxtowe 016,12656,1285,1035,1597,1445,1659,1994,1567,1322,572,180,2320,10336,3641,18.33,81.67,28.77
E02005865,Gedling 001,8293,774,718,762,750,1083,1301,1106,1164,541,94,1492,6801,2905,17.99,82.01,35.03
E02005866,Gedling 002,9416,1012,789,1023,1110,1172,1386,1276,1107,482,59,1801,7615,2924,19.13,80.87,31.05
E02005868,Gedling 004,7159,841,677,902,831,923,1053,809,751,325,47,1518,5641,1932,21.2,78.8,26.99
E02005869,Gedling 005,6089,780,725,797,850,795,800,599,422,251,70,1505,4584,1342,24.72,75.28,22.04
E02005870,Gedling 006,6868,845,608,1070,1051,846,971,633,464,315,65,1453,5415,1477,21.16,78.84,21.51
E02005871,Gedling 007,7147,692,574,823,834,895,1048,999,865,380,37,1266,5881,2281,17.71,82.29,31.92
E02005872,Gedling 008,6220,613,579,521,564,853,943,831,821,423,72,1192,5028,2147,19.16,80.84,34.52
E02005873,Gedling 009,10050,985,935,1092,984,1371,1579,1311,1115,579,99,1920,8130,3104,19.1,80.9,30.89
E02005874,Gedling 010,8715,942,709,1019,1152,1214,1330,1071,793,420,65,1651,7064,2349,18.94,81.06,26.95
E02005875,Gedling 011,8034,994,724,1096,1152,997,1154,808,692,350,67,1718,6316,1917,21.38,78.62,23.86
E02005876,Gedling 012,8962,938,836,1122,1069,1189,1338,1013,858,480,119,1774,7188,2470,19.79,80.21,27.56
E02005877,Gedling 013,7107,865,589,1093,1019,930,989,752,515,298,57,1454,5653,1622,20.46,79.54,22.82
E02005878,Gedling 014,10155,1078,926,1393,1276,1313,1510,1288,845,466,60,2004,8151,2659,19.73,80.27,26.18
E02005879,Gedling 015,7630,984,616,1399,1251,1060,1050,614,458,171,27,1600,6030,1270,20.97,79.03,16.64
E02006835,Gedling 016,6051,637,534,862,749,797,969,752,499,229,23,1171,4880,1503,19.35,80.65,24.84
E02005880,Mansfield 001,6388,861,648,774,755,700,943,730,611,334,32,1509,4879,1707,23.62,76.38,26.72
E02005881,Mansfield 002,6265,788,545,864,729,693,914,820,532,289,91,1333,4932,1732,21.28,78.72,27.65
E02005882,Mansfield 003,7558,763,622,791,760,925,1181,1101,998,358,59,1385,6173,2516,18.32,81.68,33.29
E02005883,Mansfield 004,8517,1219,780,1150,1238,955,1240,922,657,277,79,1999,6518,1935,23.47,76.53,22.72
E02005884,Mansfield 005,5926,638,436,801,701,686,957,824,588,246,49,1074,4852,1707,18.12,81.88,28.81
E02005885,Mansfield 006,8297,928,718,999,933,1008,1229,1117,856,421,88,1646,6651,2482,19.84,80.16,29.91
E02005886,Mansfield 007,11245,1439,1009,1457,1338,1456,1622,1373,1010,474,67,2448,8797,2924,21.77,78.23,26.0
E02005887,Mansfield 008,10584,1324,808,2065,1936,1222,1266,866,605,403,89,2132,8452,1963,20.14,79.86,18.55
E02005888,Mansfield 009,8513,1148,780,1353,1382,1066,1173,824,512,230,45,1928,6585,1611,22.65,77.35,18.92
E02005889,Mansfield 010,10507,1310,901,1379,1392,1265,1539,1266,924,430,101,2211,8296,2721,21.04,78.96,25.9
E02005890,Mansfield 011,6705,698,524,739,790,831,1147,882,773,272,49,1222,5483,1976,18.23,81.77,29.47
E02005891,Mansfield 012,6498,819,637,982,894,803,956,692,462,200,53,1456,5042,1407,22.41,77.59,21.65
E02005892,Mansfield 013,12310,1415,1077,1364,1584,1699,1810,1410,1205,613,133,2492,9818,3361,20.24,79.76,27.3
E02005893,Newark and Sherwood 001,11116,1472,952,1574,1309,1336,1644,1324,982,453,70,2424,8692,2829,21.81,78.19,25.45
E02005894,Newark and Sherwood 002,10868,1407,1016,1344,1367,1347,1603,1229,986,449,120,2423,8445,2784,22.29,77.71,25.62
E02005895,Newark and Sherwood 003,7980,609,705,735,556,1028,1394,1308,1125,449,71,1314,6666,2953,16.47,83.53,37.01
E02005896,Newark and Sherwood 004,7553,655,611,677,634,879,1200,1137,1184,482,94,1266,6287,2897,16.76,83.24,38.36
E02005897,Newark and Sherwood 005,9404,1018,900,968,858,1174,1536,1266,1103,503,78,1918,7486,2950,20.4,79.6,31.37
E02005898,Newark and Sherwood 006,11266,1329,1053,1550,1368,1432,1818,1295,912,418,91,2382,8884,2716,21.14,78.86,24.11
E02005899,Newark and Sherwood 007,12465,1598,1017,2175,2109,1575,1486,1248,831,345,81,2615,9850,2505,20.98,79.02,20.1
E02005900,Newark and Sherwood 008,7387,531,750,1036,476,811,1049,979,1105,538,112,1281,6106,2734,17.34,82.66,37.01
E02005901,Newark and Sherwood 009,9813,1280,925,1391,1391,1220,1303,1054,816,319,114,2205,7608,2303,22.47,77.53,23.47
E02005902,Newark and Sherwood 010,8342,1047,735,1091,988,957,1179,1060,811,395,79,1782,6560,2345,21.36,78.64,28.11
E02005903,Newark and Sherwood 011,10096,1084,867,1275,1085,1150,1543,1285,1208,521,78,1951,8145,3092,19.32,80.68,30.63
E02005904,Newark and Sherwood 012,9331,1104,852,931,992,1215,1486,1169,988,465,129,1956,7375,2751,20.96,79.04,29.48
E02005905,Newark and Sherwood 013,6800,527,511,761,726,862,1200,928,812,409,64,1038,5762,2213,15.26,84.74,32.54
E02005906,Rushcliffe 001,7439,650,611,724,716,1021,1312,1069,816,421,99,1261,6178,2405,16.95,83.05,32.33
E02005907,Rushcliffe 002,10197,1223,1104,1152,1262,1458,1324,1095,1017,477,85,2327,7870,2674,22.82,77.18,26.22
E02005908,Rushcliffe 003,9418,980,837,876,1018,1183,1346,1189,1165,657,167,1817,7601,3178,19.29,80.71,33.74
E02005909,Rushcliffe 004,8532,1073,949,1208,1128,1409,1133,845,473,256,58,2022,6510,1632,23.7,76.3,19.13
E02005910,Rushcliffe 005,9651,964,860,2788,1353,1287,955,673,394,267,110,1824,7827,1444,18.9,81.1,14.96
E02005911,Rushcliffe 006,8730,1028,956,1039,1060,1330,1381,925,640,299,72,1984,6746,1936,22.73,77.27,22.18
E02005912,Rushcliffe 007,9487,1031,1035,1112,1149,1297,1374,1064,791,501,133,2066,7421,2489,21.78,78.22,26.24
E02005913,Rushcliffe 008,7910,959,858,839,881,1092,1183,861,698,412,127,1817,6093,2098,22.97,77.03,26.52
E02005914,Rushcliffe 009,8113,1045,709,1156,1153,1019,1154,824,675,306,72,1754,6359,1877,21.62,78.38,23.14
E02005915,Rushcliffe 010,5730,538,508,475,554,709,1001,877,753,248,67,1046,4684,1945,18.25,81.75,33.94
E02005916,Rushcliffe 011,7856,962,713,836,1141,1117,1068,844,716,365,94,1675,6181,2019,21.32,78.68,25.7
E02005917,Rushcliffe 012,5795,532,484,438,436,690,973,764,901,468,109,1016,4779,2242,17.53,82.47,38.69
E02005918,Rushcliffe 013,5168,486,429,532,528,620,744,678,725,372,54,915,4253,1829,17.71,82.29,35.39
E02005919,Rushcliffe 014,6889,813,628,1026,771,883,1050,712,665,294,47,1441,5448,1718,20.92,79.08,24.94
E02005920,Rushcliffe 015,8269,895,716,909,788,1044,1267,1067,1062,420,101,1611,6658,2650,19.48,80.52,32.05
E02005921,Cherwell 001,5752,584,423,458,540,716,1061,903,667,332,68,1007,4745,1970,17.51,82.49,34.25
E02005922,Cherwell 002,8241,1160,818,1105,1356,1228,1185,702,496,171,20,1978,6263,1389,24.0,76.0,16.85
E02005923,Cherwell 003,5881,866,662,746,912,795,746,481,384,256,33,1528,4353,1154,25.98,74.02,19.62
E02005924,Cherwell 004,11863,1621,941,2151,2270,1612,1361,880,539,373,115,2562,9301,1907,21.6,78.4,16.08
E02005925,Cherwell 005,8452,1383,1075,1075,1163,1130,1063,719,589,225,30,2458,5994,1563,29.08,70.92,18.49
E02005926,Cherwell 006,8400,796,835,895,948,983,1200,1017,1030,565,131,1631,6769,2743,19.42,80.58,32.65
E02005927,Cherwell 007,5080,595,409,557,661,693,730,593,560,234,48,1004,4076,1435,19.76,80.24,28.25
E02005928,Cherwell 008,9727,1330,1061,985,1099,1277,1325,1007,1035,472,136,2391,7336,2650,24.58,75.42,27.24
E02005929,Cherwell 009,6968,720,736,566,582,878,1256,960,862,342,66,1456,5512,2230,20.9,79.1,32.0
E02005930,Cherwell 010,8477,1075,813,763,915,1173,1340,1045,895,378,80,1888,6589,2398,22.27,77.73,28.29
E02005931,Cherwell 011,10158,1427,965,1303,1513,1380,1466,996,676,338,94,2392,7766,2104,23.55,76.45,20.71
E02005932,Cherwell 012,6554,824,711,928,1043,1126,970,542,317,86,7,1535,5019,952,23.42,76.58,14.53
E02005933,Cherwell 013,7356,896,695,880,1128,1050,1076,792,548,250,41,1591,5765,1631,21.63,78.37,22.17
E02005934,Cherwell 014,8810,1057,834,1025,1200,1101,1312,1037,793,373,78,1891,6919,2281,21.46,78.54,25.89
E02005935,Cherwell 015,7901,984,724,1132,1395,1272,1030,600,410,280,74,1708,6193,1364,21.62,78.38,17.26
E02005936,Cherwell 016,11847,1663,1139,1345,1725,1580,1725,1222,949,409,90,2802,9045,2670,23.65,76.35,22.54
E02005937,Cherwell 017,6818,759,498,719,866,801,955,850,749,507,114,1257,5561,2220,18.44,81.56,32.56
E02005938,Cherwell 018,5548,689,498,654,802,689,749,685,406,323,53,1187,4361,1467,21.4,78.6,26.44
E02005939,Cherwell 019,6670,741,472,753,1041,795,992,814,580,392,90,1213,5457,1876,18.19,81.81,28.13
E02005940,Oxford 001,5605,707,566,605,518,689,844,683,576,342,75,1273,4332,1676,22.71,77.29,29.9
E02005941,Oxford 002,7015,847,1119,1169,696,751,784,673,557,306,113,1966,5049,1649,28.03,71.97,23.51
E02005942,Oxford 003,6580,625,690,1775,600,721,732,581,543,224,89,1315,5265,1437,19.98,80.02,21.84
E02005943,Oxford 004,6142,810,611,962,696,795,782,560,517,333,76,1421,4721,1486,23.14,76.86,24.19
E02005944,Oxford 005,6931,1219,738,1148,895,834,852,570,431,192,52,1957,4974,1245,28.24,71.76,17.96
E02005945,Oxford 006,14973,1108,1534,7053,1272,1101,990,773,617,376,149,2642,12331,1915,17.65,82.35,12.79
E02005946,Oxford 007,7451,1103,646,1088,938,1035,932,790,585,275,59,1749,5702,1709,23.47,76.53,22.94
E02005947,Oxford 008,18189,439,1056,13002,1418,690,597,477,316,144,50,1495,16694,987,8.22,91.78,5.43
E02005948,Oxford 009,6995,666,339,2543,1039,682,662,510,395,123,36,1005,5990,1064,14.37,85.63,15.21
E02005949,Oxford 010,7146,830,528,2644,869,693,567,473,299,197,46,1358,5788,1015,19.0,81.0,14.2
E02005950,Oxford 011,10603,665,420,5483,1229,805,705,641,471,137,47,1085,9518,1296,10.23,89.77,12.22
E02005951,Oxford 012,5524,613,411,1327,789,694,601,482,345,209,53,1024,4500,1089,18.54,81.46,19.71
E02005952,Oxford 013,13431,1773,1025,3783,2031,1540,1360,942,580,338,59,2798,10633,1919,20.83,79.17,14.29
E02005953,Oxford 014,4990,637,346,1301,699,591,564,456,254,126,16,983,4007,852,19.7,80.3,17.07
E02005954,Oxford 015,9161,1211,741,1479,1289,1186,1188,858,627,390,192,1952,7209,2067,21.31,78.69,22.56
E02005955,Oxford 016,9783,1643,1000,1634,1359,1269,1208,796,513,294,67,2643,7140,1670,27.02,72.98,17.07
E02005956,Oxford 017,5722,947,611,845,648,690,879,513,338,216,35,1558,4164,1102,27.23,72.77,19.26
E02005957,Oxford 018,6216,1183,696,1013,828,817,829,429,239,148,34,1879,4337,850,30.23,69.77,13.67
E02005958,South Oxfordshire 001,5328,608,456,616,683,723,823,700,459,216,44,1064,4264,1419,19.97,80.03,26.63
E02005959,South Oxfordshire 002,5667,518,491,670,568,669,1004,779,644,273,51,1009,4658,1747,17.8,82.2,30.83
E02005960,South Oxfordshire 003,7227,968,747,729,842,1028,947,687,751,430,98,1715,5512,1966,23.73,76.27,27.2
E02005961,South Oxfordshire 004,6672,733,542,694,772,837,1063,850,729,376,76,1275,5397,2031,19.11,80.89,30.44
E02005962,South Oxfordshire 005,9078,1071,824,882,974,1234,1393,1215,1001,408,76,1895,7183,2700,20.87,79.13,29.74
E02005963,South Oxfordshire 006,8078,866,744,858,868,1068,1274,1083,844,393,80,1610,6468,2400,19.93,80.07,29.71
E02005964,South Oxfordshire 007,7061,750,609,681,669,867,1239,929,833,414,70,1359,5702,2246,19.25,80.75,31.81
E02005965,South Oxfordshire 008,5456,603,515,463,426,822,909,696,666,296,60,1118,4338,1718,20.49,79.51,31.49
E02005966,South Oxfordshire 009,7853,1046,764,1172,1424,1313,1222,543,264,87,18,1810,6043,912,23.05,76.95,11.61
E02005967,South Oxfordshire 010,8685,1501,785,1191,1637,1122,957,600,542,284,66,2286,6399,1492,26.32,73.68,17.18
E02005968,South Oxfordshire 011,7937,1059,588,1387,1245,967,944,669,688,324,66,1647,6290,1747,20.75,79.25,22.01
E02005969,South Oxfordshire 012,9432,1137,903,968,1176,1341,1289,1013,920,553,132,2040,7392,2618,21.63,78.37,27.76
E02005970,South Oxfordshire 013,5391,702,453,861,924,743,773,528,261,127,19,1155,4236,935,21.42,78.58,17.34
E02005971,South Oxfordshire 014,6176,746,577,756,809,831,914,622,525,324,72,1323,4853,1543,21.42,78.58,24.98
E02005972,South Oxfordshire 015,9920,1409,996,1010,1232,1375,1352,1019,949,473,105,2405,7515,2546,24.24,75.76,25.67
E02005973,South Oxfordshire 016,5644,560,465,565,630,729,791,606,730,459,109,1025,4619,1904,18.16,81.84,33.73
E02005974,South Oxfordshire 017,6219,691,627,633,644,937,948,622,661,365,91,1318,4901,1739,21.19,78.81,27.96
E02005975,South Oxfordshire 018,8144,831,1040,667,567,1126,1319,1029,1006,443,116,1871,6273,2594,22.97,77.03,31.85
E02005976,South Oxfordshire 019,6203,550,823,553,334,843,1090,785,768,362,95,1373,4830,2010,22.13,77.87,32.4
E02005977,South Oxfordshire 020,5886,623,546,456,457,842,956,733,685,461,127,1169,4717,2006,19.86,80.14,34.08
E02005978,Vale of White Horse 001,7637,812,664,826,841,983,1128,964,768,476,175,1476,6161,2383,19.33,80.67,31.2
E02005979,Vale of White Horse 002,10123,1079,956,1363,1283,1399,1415,1053,880,564,131,2035,8088,2628,20.1,79.9,25.96
E02005980,Vale of White Horse 003,12027,1318,1731,1647,1417,1365,1505,1249,1140,546,109,3049,8978,3044,25.35,74.65,25.31
E02005981,Vale of White Horse 004,8901,1031,730,1033,1146,1281,1363,1185,810,267,55,1761,7140,2317,19.78,80.22,26.03
E02005982,Vale of White Horse 005,5995,750,547,695,745,901,809,650,582,274,42,1297,4698,1548,21.63,78.37,25.82
E02005983,Vale of White Horse 006,11644,1349,1033,1742,2032,1528,1400,993,861,542,164,2382,9262,2560,20.46,79.54,21.99
E02005984,Vale of White Horse 007,8422,953,812,876,841,1196,1382,1082,851,359,70,1765,6657,2362,20.96,79.04,28.05
E02005985,Vale of White Horse 008,8011,931,684,1013,1097,1061,1084,864,832,375,70,1615,6396,2141,20.16,79.84,26.73
E02005986,Vale of White Horse 009,9909,1262,884,1140,1354,1360,1426,1045,892,446,100,2146,7763,2483,21.66,78.34,25.06
E02005987,Vale of White Horse 010,9504,1286,845,1129,1276,1272,1341,1035,824,426,70,2131,7373,2355,22.42,77.58,24.78
E02005988,Vale of White Horse 011,7863,1075,689,960,1099,955,1089,872,743,324,57,1764,6099,1996,22.43,77.57,25.38
E02005991,Vale of White Horse 014,9905,1023,844,1267,1221,1255,1449,1102,1003,576,165,1867,8038,2846,18.85,81.15,28.73
E02005992,Vale of White Horse 015,12823,1852,1176,1490,1796,1660,1673,1317,1123,608,128,3028,9795,3176,23.61,76.39,24.77
E02006886,Vale of White Horse 016,13243,1760,1194,1319,1633,1958,1999,1410,1250,562,158,2954,10289,3380,22.31,77.69,25.52
E02005993,West Oxfordshire 001,6918,778,578,760,892,908,948,822,805,361,66,1356,5562,2054,19.6,80.4,29.69
E02005994,West Oxfordshire 002,6509,712,679,669,646,822,1019,820,663,357,122,1391,5118,1962,21.37,78.63,30.14
E02005995,West Oxfordshire 003,6021,568,585,438,483,813,1015,907,760,352,100,1153,4868,2119,19.15,80.85,35.19
E02005996,West Oxfordshire 004,8493,970,843,696,838,1225,1270,1069,931,534,117,1813,6680,2651,21.35,78.65,31.21
E02005997,West Oxfordshire 005,5573,591,461,492,506,671,851,930,677,323,71,1052,4521,2001,18.88,81.12,35.91
E02005998,West Oxfordshire 006,6291,685,579,542,631,849,914,814,811,369,97,1264,5027,2091,20.09,79.91,33.24
E02005999,West Oxfordshire 007,6295,629,584,545,600,745,1120,901,740,366,65,1213,5082,2072,19.27,80.73,32.92
E02006000,West Oxfordshire 008,11978,1424,1246,1334,1644,1713,1769,1185,1028,477,158,2670,9308,2848,22.29,77.71,23.78
E02006001,West Oxfordshire 009,6226,906,567,774,954,769,890,561,427,297,81,1473,4753,1366,23.66,76.34,21.94
E02006002,West Oxfordshire 010,10773,1178,817,1545,1548,1311,1392,1104,1038,658,182,1995,8778,2982,18.52,81.48,27.68
E02006003,West Oxfordshire 011,5489,569,533,558,542,709,887,663,659,309,60,1102,4387,1691,20.08,79.92,30.81
E02006004,West Oxfordshire 012,6101,541,606,528,509,772,1084,899,754,297,111,1147,4954,2061,18.8,81.2,33.78
E02006005,West Oxfordshire 013,9821,1751,867,1576,2039,1287,1035,599,431,199,37,2618,7203,1266,26.66,73.34,12.89
E02006006,West Oxfordshire 014,7117,650,478,1690,1049,897,883,654,500,272,44,1128,5989,1470,15.85,84.15,20.65
E02006007,West Oxfordshire 015,7038,747,682,623,768,899,1111,948,781,386,93,1429,5609,2208,20.3,79.7,31.37
E02006047,Mendip 001,8672,909,794,799,737,1136,1502,1265,1043,409,78,1703,6969,2795,19.64,80.36,32.23
E02006048,Mendip 002,7118,732,811,736,630,872,1149,1045,761,309,73,1543,5575,2188,21.68,78.32,30.74
E02006049,Mendip 003,7409,762,623,811,788,852,1070,1062,951,400,90,1385,6024,2503,18.69,81.31,33.78
E02006050,Mendip 004,8921,1070,924,1107,1164,1266,1266,983,653,365,123,1994,6927,2124,22.35,77.65,23.81
E02006051,Mendip 005,8141,753,856,722,704,938,1239,1181,1087,556,105,1609,6532,2929,19.76,80.24,35.98
E02006052,Mendip 006,7813,731,682,866,684,984,1295,1070,917,434,150,1413,6400,2571,18.09,81.91,32.91
E02006053,Mendip 007,10494,1573,971,1237,1492,1359,1451,1151,802,362,96,2544,7950,2411,24.24,75.76,22.98
E02006054,Mendip 008,8409,782,644,861,715,975,1282,1181,1067,704,198,1426,6983,3150,16.96,83.04,37.46
E02006055,Mendip 009,9256,1233,784,1383,1365,1061,1325,968,737,335,65,2017,7239,2105,21.79,78.21,22.74
E02006056,Mendip 010,7723,813,670,765,742,953,1323,1058,935,377,87,1483,6240,2457,19.2,80.8,31.81
E02006057,Mendip 011,7785,767,689,779,743,975,1340,1152,857,359,124,1456,6329,2492,18.7,81.3,32.01
E02006058,Mendip 012,8777,874,1269,1075,858,978,1192,1076,932,439,84,2143,6634,2531,24.42,75.58,28.84
E02006059,Mendip 013,6793,597,602,594,471,784,1273,1131,917,336,88,1199,5594,2472,17.65,82.35,36.39
E02006060,Mendip 014,8276,921,793,1131,1010,1073,1164,825,801,434,124,1714,6562,2184,20.71,79.29,26.39
E02006061,Sedgemoor 001,9232,901,879,937,769,1154,1542,1261,1103,526,160,1780,7452,3050,19.28,80.72,33.04
E02006062,Sedgemoor 002,11159,1005,867,1046,966,1237,1754,1762,1608,736,178,1872,9287,4284,16.78,83.22,38.39
E02006063,Sedgemoor 003,6900,540,723,601,460,766,1276,1107,973,376,78,1263,5637,2534,18.3,81.7,36.72
E02006064,Sedgemoor 004,7656,579,511,716,630,776,1141,1177,1221,686,219,1090,6566,3303,14.24,85.76,43.14
E02006065,Sedgemoor 005,8861,1119,801,1077,906,1038,1294,1105,1037,395,89,1920,6941,2626,21.67,78.33,29.64
E02006066,Sedgemoor 006,8306,806,702,814,831,911,1264,1329,1119,440,90,1508,6798,2978,18.16,81.84,35.85
E02006067,Sedgemoor 007,6909,634,594,626,536,748,1158,1145,940,424,104,1228,5681,2613,17.77,82.23,37.82
E02006068,Sedgemoor 008,7956,1225,828,1289,1042,918,1052,733,561,245,63,2053,5903,1602,25.8,74.2,20.14
E02006069,Sedgemoor 009,10361,1242,890,1771,1690,1372,1315,968,674,349,90,2132,8229,2081,20.58,79.42,20.08
E02006070,Sedgemoor 010,8291,1133,673,1257,1158,940,1163,906,670,316,75,1806,6485,1967,21.78,78.22,23.72
E02006071,Sedgemoor 011,9610,1149,956,1116,1198,1207,1371,1076,894,527,116,2105,7505,2613,21.9,78.1,27.19
E02006072,Sedgemoor 012,9438,731,814,885,663,1033,1760,1572,1297,565,118,1545,7893,3552,16.37,83.63,37.64
E02006073,Sedgemoor 013,7478,1083,761,1089,961,905,1014,732,584,262,87,1844,5634,1665,24.66,75.34,22.27
E02006074,Sedgemoor 014,11021,1515,1029,1373,1468,1304,1621,1187,966,438,120,2544,8477,2711,23.08,76.92,24.6
E02006075,South Somerset 001,5616,521,910,624,442,638,894,692,587,255,53,1431,4185,1587,25.48,74.52,28.26
E02006076,South Somerset 002,8698,661,812,746,666,954,1470,1409,1207,611,162,1473,7225,3389,16.93,83.07,38.96
E02006077,South Somerset 003,5639,619,440,540,470,581,825,838,829,405,92,1059,4580,2164,18.78,81.22,38.38
E02006078,South Somerset 004,6106,575,530,488,508,692,951,998,861,381,122,1105,5001,2362,18.1,81.9,38.68
E02006079,South Somerset 005,7877,988,652,833,906,827,1165,1108,889,415,94,1640,6237,2506,20.82,79.18,31.81
E02006080,South Somerset 006,7251,758,620,1468,951,691,919,771,694,321,58,1378,5873,1844,19.0,81.0,25.43
E02006081,South Somerset 007,5365,477,508,417,459,588,883,903,776,305,49,985,4380,2033,18.36,81.64,37.89
E02006082,South Somerset 008,6635,731,562,664,656,736,984,1041,900,304,57,1293,5342,2302,19.49,80.51,34.69
E02006083,South Somerset 009,5605,515,435,542,551,657,845,875,781,325,79,950,4655,2060,16.95,83.05,36.75
E02006084,South Somerset 010,7450,713,607,554,609,843,1123,1304,1079,494,124,1320,6130,3001,17.72,82.28,40.28
E02006085,South Somerset 011,7319,980,611,919,1022,825,934,906,767,298,57,1591,5728,2028,21.74,78.26,27.71
E02006086,South Somerset 012,7309,924,755,932,867,981,1003,720,683,361,83,1679,5630,1847,22.97,77.03,25.27
E02006087,South Somerset 013,6219,882,587,956,873,823,748,577,447,254,72,1469,4750,1350,23.62,76.38,21.71
E02006088,South Somerset 014,7934,1105,855,1156,1045,1011,999,775,595,331,62,1960,5974,1763,24.7,75.3,22.22
E02006089,South Somerset 015,7027,811,520,1224,1147,967,877,695,436,260,90,1331,5696,1481,18.94,81.06,21.08
E02006090,South Somerset 016,6954,824,615,961,976,869,912,734,630,321,112,1439,5515,1797,20.69,79.31,25.84
E02006091,South Somerset 017,9727,955,852,817,841,1084,1539,1588,1374,536,141,1807,7920,3639,18.58,81.42,37.41
E02006092,South Somerset 018,6351,596,545,714,749,760,961,889,755,304,78,1141,5210,2026,17.97,82.03,31.9
E02006093,South Somerset 019,8809,983,660,903,919,919,1272,1159,1191,609,194,1643,7166,3153,18.65,81.35,35.79
E02006094,South Somerset 020,5284,492,398,502,444,619,865,773,739,387,65,890,4394,1964,16.84,83.16,37.17
E02006095,South Somerset 021,8025,836,648,800,764,914,1171,1149,1092,544,107,1484,6541,2892,18.49,81.51,36.04
E02006096,South Somerset 022,7001,832,630,812,777,842,1086,805,804,344,69,1462,5539,2022,20.88,79.12,28.88
E02006097,South Somerset 023,6872,804,607,856,830,771,936,779,727,456,106,1411,5461,2068,20.53,79.47,30.09
E02006098,South Somerset 024,7272,589,556,556,526,743,1220,1328,1165,471,118,1145,6127,3082,15.75,84.25,42.38
E02006118,Cannock Chase 001,7481,649,608,814,807,943,1150,1037,1010,410,53,1257,6224,2510,16.8,83.2,33.55
E02006119,Cannock Chase 002,8307,978,737,1174,1162,1019,1227,878,661,343,128,1715,6592,2010,20.65,79.35,24.2
E02006120,Cannock Chase 003,9447,1136,887,1306,1310,1119,1350,1012,829,422,76,2023,7424,2339,21.41,78.59,24.76
E02006121,Cannock Chase 004,5867,661,524,821,751,791,936,680,506,164,33,1185,4682,1383,20.2,79.8,23.57
E02006122,Cannock Chase 005,7809,887,605,1324,1128,1021,1085,853,617,257,32,1492,6317,1759,19.11,80.89,22.53
E02006123,Cannock Chase 006,6473,697,566,936,818,897,1070,783,453,193,60,1263,5210,1489,19.51,80.49,23.0
E02006124,Cannock Chase 007,7579,1006,743,1029,1057,932,1072,824,576,270,70,1749,5830,1740,23.08,76.92,22.96
E02006125,Cannock Chase 008,7439,831,715,1128,999,903,1006,807,750,248,52,1546,5893,1857,20.78,79.22,24.96
E02006126,Cannock Chase 009,8244,831,773,1057,1035,1171,1266,945,762,334,70,1604,6640,2111,19.46,80.54,25.61
E02006127,Cannock Chase 010,7559,892,780,1122,1120,1153,1227,742,326,147,50,1672,5887,1265,22.12,77.88,16.74
E02006128,Cannock Chase 011,8578,741,581,1040,941,1025,1334,1123,1124,553,116,1322,7256,2916,15.41,84.59,33.99
E02006129,Cannock Chase 012,8497,1116,730,1383,1287,1045,1078,768,650,356,84,1846,6651,1858,21.73,78.27,21.87
E02006130,Cannock Chase 013,7482,774,689,892,943,955,1193,868,792,318,58,1463,6019,2036,19.55,80.45,27.21
E02006131,East Staffordshire 001,7688,726,659,845,689,937,1344,1108,920,383,77,1385,6303,2488,18.02,81.98,32.36
E02006132,East Staffordshire 002,6552,847,614,865,830,748,951,783,588,261,65,1461,5091,1697,22.3,77.7,25.9
E02006133,East Staffordshire 003,6915,693,647,1027,703,910,1134,764,628,346,63,1340,5575,1801,19.38,80.62,26.04
E02006134,East Staffordshire 004,9606,991,859,871,886,1321,1553,1271,1204,565,85,1850,7756,3125,19.26,80.74,32.53
E02006135,East Staffordshire 005,7545,725,695,783,736,883,1310,1038,871,439,65,1420,6125,2413,18.82,81.18,31.98
E02006136,East Staffordshire 006,8723,663,705,1010,836,1107,1492,1175,1154,448,133,1368,7355,2910,15.68,84.32,33.36
E02006137,East Staffordshire 007,9152,1262,940,1278,1279,1095,1187,884,705,433,89,2202,6950,2111,24.06,75.94,23.07
E02006138,East Staffordshire 008,7540,1337,841,1273,1275,926,842,547,324,142,33,2178,5362,1046,28.89,71.11,13.87
E02006139,East Staffordshire 009,8358,1366,811,1486,1490,1029,836,683,413,185,59,2177,6181,1340,26.05,73.95,16.03
E02006140,East Staffordshire 010,8591,1183,818,1076,1033,1049,1215,975,796,367,79,2001,6590,2217,23.29,76.71,25.81
E02006141,East Staffordshire 011,12184,1821,1184,2278,2550,1542,1206,806,478,276,43,3005,9179,1603,24.66,75.34,13.16
E02006142,East Staffordshire 012,5093,497,409,563,498,614,928,704,591,252,37,906,4187,1584,17.79,82.21,31.1
E02006143,East Staffordshire 013,7838,1017,720,1030,958,1092,1192,831,668,273,57,1737,6101,1829,22.16,77.84,23.34
E02006144,East Staffordshire 014,7972,1045,750,1073,970,932,1153,935,668,350,96,1795,6177,2049,22.52,77.48,25.7
E02006145,East Staffordshire 015,5997,646,606,454,478,865,969,833,737,345,64,1252,4745,1979,20.88,79.12,33.0
E02006146,Lichfield 001,8619,1005,700,1117,1065,1035,1268,1060,937,340,92,1705,6914,2429,19.78,80.22,28.18
E02006147,Lichfield 002,8190,860,840,919,790,1119,1318,1009,899,384,52,1700,6490,2344,20.76,79.24,28.62
E02006148,Lichfield 003,6960,574,640,685,551,894,1197,1001,1039,333,46,1214,5746,2419,17.44,82.56,34.76
E02006149,Lichfield 004,11298,1329,1152,1442,1465,1519,1435,1134,1003,665,154,2481,8817,2956,21.96,78.04,26.16
E02006150,Lichfield 005,11422,1013,862,1138,1256,1390,1655,1704,1566,683,155,1875,9547,4108,16.42,83.58,35.97
E02006151,Lichfield 006,9305,995,836,1242,1087,1230,1357,1101,1024,355,78,1831,7474,2558,19.68,80.32,27.49
E02006152,Lichfield 007,10298,1215,882,1190,1287,1500,1442,1024,1146,523,89,2097,8201,2782,20.36,79.64,27.01
E02006153,Lichfield 008,7788,823,749,803,878,1061,1241,953,859,352,69,1572,6216,2233,20.18,79.82,28.67
E02006154,Lichfield 009,9769,833,742,1036,896,1129,1480,1257,1711,594,91,1575,8194,3653,16.12,83.88,37.39
E02006155,Lichfield 010,5824,812,585,820,809,721,797,555,505,187,33,1397,4427,1280,23.99,76.01,21.98
E02006156,Lichfield 011,7874,683,643,742,625,981,1273,1058,1148,555,166,1326,6548,2927,16.84,83.16,37.17
E02006157,Lichfield 012,7409,770,585,1483,775,859,1009,845,705,309,69,1355,6054,1928,18.29,81.71,26.02
E02006158,Newcastle-under-Lyme 001,8048,674,630,1027,864,1054,1379,1101,982,293,44,1304,6744,2420,16.2,83.8,30.07
E02006159,Newcastle-under-Lyme 002,5767,636,530,864,709,649,744,725,576,281,53,1166,4601,1635,20.22,79.78,28.35
E02006160,Newcastle-under-Lyme 003,8713,946,728,1292,1160,961,1144,1081,950,371,80,1674,7039,2482,19.21,80.79,28.49
E02006161,Newcastle-under-Lyme 004,6929,605,594,908,738,881,1211,886,752,309,45,1199,5730,1992,17.3,82.7,28.75
E02006162,Newcastle-under-Lyme 005,8549,836,676,1104,1002,1117,1325,1113,919,376,81,1512,7037,2489,17.69,82.31,29.11
E02006163,Newcastle-under-Lyme 006,8300,972,874,1172,1125,1072,1096,840,682,388,79,1846,6454,1989,22.24,77.76,23.96
E02006164,Newcastle-under-Lyme 007,7970,1095,730,1313,1184,925,987,815,492,347,82,1825,6145,1736,22.9,77.1,21.78
E02006165,Newcastle-under-Lyme 008,7983,874,593,1290,1212,1106,1068,744,679,357,60,1467,6516,1840,18.38,81.62,23.05
E02006166,Newcastle-under-Lyme 009,7138,669,575,1010,868,915,1107,843,730,347,74,1244,5894,1994,17.43,82.57,27.93
E02006167,Newcastle-under-Lyme 010,10249,1320,906,2126,1459,1221,1178,892,692,384,71,2226,8023,2039,21.72,78.28,19.89
E02006168,Newcastle-under-Lyme 011,9296,646,630,2733,1163,990,1037,843,645,456,153,1276,8020,2097,13.73,86.27,22.56
E02006169,Newcastle-under-Lyme 012,9595,634,626,4816,767,681,692,622,492,221,44,1260,8335,1379,13.13,86.87,14.37
E02006170,Newcastle-under-Lyme 013,5342,498,451,639,511,651,826,731,655,316,64,949,4393,1766,17.76,82.24,33.06
E02006171,Newcastle-under-Lyme 014,9164,982,846,1268,1060,1132,1258,1022,935,541,120,1828,7336,2618,19.95,80.05,28.57
E02006172,Newcastle-under-Lyme 015,9414,846,780,1026,910,1148,1479,1300,1157,655,113,1626,7788,3225,17.27,82.73,34.26
E02006173,Newcastle-under-Lyme 016,6984,486,593,757,548,817,1181,1122,975,415,90,1079,5905,2602,15.45,84.55,37.26
E02006174,South Staffordshire 001,10467,947,927,1184,958,1371,1579,1441,1412,570,78,1874,8593,3501,17.9,82.1,33.45
E02006175,South Staffordshire 002,7284,870,661,1146,903,915,1189,732,603,221,44,1531,5753,1600,21.02,78.98,21.97
E02006176,South Staffordshire 003,7675,654,644,865,653,953,1227,1091,1031,477,80,1298,6377,2679,16.91,83.09,34.91
E02006177,South Staffordshire 004,9886,1021,833,1246,1030,1174,1477,1317,1217,500,71,1854,8032,3105,18.75,81.25,31.41
E02006178,South Staffordshire 005,7827,732,608,1086,882,897,1292,957,978,349,46,1340,6487,2330,17.12,82.88,29.77
E02006179,South Staffordshire 006,9358,536,542,1877,1388,1244,1439,1027,906,354,45,1078,8280,2332,11.52,88.48,24.92
E02006180,South Staffordshire 007,6952,770,613,850,753,788,1114,850,668,437,109,1383,5569,2064,19.89,80.11,29.69
E02006181,South Staffordshire 008,5722,624,489,706,608,696,792,710,634,387,76,1113,4609,1807,19.45,80.55,31.58
E02006182,South Staffordshire 009,7053,703,637,717,659,823,1108,867,945,486,108,1340,5713,2406,19.0,81.0,34.11
E02006183,South Staffordshire 010,7525,730,583,961,791,810,1254,1170,791,370,65,1313,6212,2396,17.45,82.55,31.84
E02006184,South Staffordshire 011,5281,637,443,700,708,635,712,789,463,141,53,1080,4201,1446,20.45,79.55,27.38
E02006185,South Staffordshire 012,7341,750,637,900,733,837,1141,913,839,491,100,1387,5954,2343,18.89,81.11,31.92
E02006186,South Staffordshire 013,12841,1089,1021,1398,1226,1486,2205,1747,1546,937,186,2110,10731,4416,16.43,83.57,34.39
E02006187,South Staffordshire 014,7224,549,549,662,547,839,1261,1076,1139,491,111,1098,6126,2817,15.2,84.8,39.0
E02006188,Stafford 001,6053,573,525,602,530,749,914,828,809,417,106,1098,4955,2160,18.14,81.86,35.68
E02006189,Stafford 002,7418,634,603,736,648,832,1241,1147,959,496,122,1237,6181,2724,16.68,83.32,36.72
E02006190,Stafford 003,10836,1199,1023,1444,1264,1376,1587,1158,1002,622,161,2222,8614,2943,20.51,79.49,27.16
E02006191,Stafford 004,8080,773,670,878,774,1015,1320,1196,1024,353,77,1443,6637,2650,17.86,82.14,32.8
E02006192,Stafford 005,8934,864,710,915,958,1160,1540,1230,1052,452,53,1574,7360,2787,17.62,82.38,31.2
E02006193,Stafford 006,6940,737,508,809,851,921,997,830,849,387,51,1245,5695,2117,17.94,82.06,30.5
E02006194,Stafford 007,8439,1042,847,1265,1089,1019,1143,803,681,441,109,1889,6550,2034,22.38,77.62,24.1
E02006195,Stafford 008,8742,806,711,795,782,1091,1408,1367,1240,461,81,1517,7225,3149,17.35,82.65,36.02
E02006196,Stafford 009,7674,851,660,1419,1442,1062,899,668,444,190,39,1511,6163,1341,19.69,80.31,17.47
E02006197,Stafford 010,9624,1220,672,1941,1860,1229,1096,662,552,304,88,1892,7732,1606,19.66,80.34,16.69
E02006198,Stafford 011,9294,940,772,1683,1219,1117,1285,1003,810,392,73,1712,7582,2278,18.42,81.58,24.51
E02006199,Stafford 012,8091,676,634,917,772,1042,1415,1050,983,459,143,1310,6781,2635,16.19,83.81,32.57
E02006200,Stafford 013,7931,1014,817,1237,1035,990,1061,807,619,282,69,1831,6100,1777,23.09,76.91,22.41
E02006201,Stafford 014,12121,1249,1256,1104,1132,1585,1795,1481,1619,776,124,2505,9616,4000,20.67,79.33,33.0
E02006202,Stafford 015,9170,783,697,905,860,1128,1600,1408,1242,482,65,1480,7690,3197,16.14,83.86,34.86
E02006203,Stafford 016,7933,973,736,1152,1061,1029,1093,861,706,262,60,1709,6224,1889,21.54,78.46,23.81
E02006204,Staffordshire Moorlands 001,7621,831,728,945,799,977,1134,990,788,357,72,1559,6062,2207,20.46,79.54,28.96
E02006205,Staffordshire Moorlands 002,7496,621,515,707,610,976,1259,1207,1128,399,74,1136,6360,2808,15.15,84.85,37.46
E02006206,Staffordshire Moorlands 003,8473,1051,969,1213,1049,1134,1294,844,501,337,81,2020,6453,1763,23.84,76.16,20.81
E02006207,Staffordshire Moorlands 004,6236,501,461,588,553,667,988,969,1030,418,61,962,5274,2478,15.43,84.57,39.74
E02006208,Staffordshire Moorlands 005,8270,893,698,1189,1108,1116,1227,910,710,319,100,1591,6679,2039,19.24,80.76,24.66
E02006209,Staffordshire Moorlands 006,10995,979,1043,1118,1093,1415,1713,1505,1363,639,127,2022,8973,3634,18.39,81.61,33.05
E02006210,Staffordshire Moorlands 007,5496,461,411,516,474,653,1004,921,719,288,49,872,4624,1977,15.87,84.13,35.97
E02006211,Staffordshire Moorlands 008,6488,549,529,703,533,761,1047,886,906,480,94,1078,5410,2366,16.62,83.38,36.47
E02006212,Staffordshire Moorlands 009,7853,682,719,791,746,923,1171,1130,1057,553,81,1401,6452,2821,17.84,82.16,35.92
E02006213,Staffordshire Moorlands 010,6564,557,618,767,660,811,1143,874,773,317,44,1175,5389,2008,17.9,82.1,30.59
E02006214,Staffordshire Moorlands 011,6287,606,516,901,659,725,901,815,800,313,51,1122,5165,1979,17.85,82.15,31.48
E02006215,Staffordshire Moorlands 012,7947,698,624,846,754,984,1367,1099,1063,446,66,1322,6625,2674,16.64,83.36,33.65
E02006216,Staffordshire Moorlands 013,8709,820,790,968,928,1124,1338,1145,1130,390,76,1610,7099,2741,18.49,81.51,31.47
E02006217,Tamworth 001,9186,955,857,1037,935,1112,1247,1150,1210,559,124,1812,7374,3043,19.73,80.27,33.13
E02006218,Tamworth 002,8286,916,610,1221,1160,1023,1071,840,820,504,121,1526,6760,2285,18.42,81.58,27.58
E02006219,Tamworth 003,7629,838,801,1027,969,1040,1108,939,677,197,33,1639,5990,1846,21.48,78.52,24.2
E02006220,Tamworth 004,7420,830,647,949,868,884,1084,858,890,351,59,1477,5943,2158,19.91,80.09,29.08
E02006221,Tamworth 005,6034,638,539,883,840,906,986,626,463,138,15,1177,4857,1242,19.51,80.49,20.58
E02006222,Tamworth 006,6918,880,712,1002,919,873,873,785,621,221,32,1592,5326,1659,23.01,76.99,23.98
E02006223,Tamworth 007,6999,1170,876,1070,1063,871,729,607,451,135,27,2046,4953,1220,29.23,70.77,17.43
E02006224,Tamworth 008,7474,920,682,1101,999,969,1195,941,479,173,15,1602,5872,1608,21.43,78.57,21.51
E02006225,Tamworth 009,7172,782,648,808,860,942,1028,989,753,309,53,1430,5742,2104,19.94,80.06,29.34
E02006226,Tamworth 010,9578,1277,939,1402,1492,1284,1242,1024,617,253,48,2216,7362,1942,23.14,76.86,20.28
E02006227,Babergh 001,6270,454,495,524,467,633,1110,1111,942,429,105,949,5321,2587,15.14,84.86,41.26
E02006228,Babergh 002,6121,639,524,716,577,760,911,901,743,284,66,1163,4958,1994,19.0,81.0,32.58
E02006229,Babergh 003,5937,498,470,567,544,711,862,892,907,391,95,968,4969,2285,16.3,83.7,38.49
E02006230,Babergh 004,11148,1261,1091,1151,1139,1323,1530,1419,1306,746,182,2352,8796,3653,21.1,78.9,32.77
E02006231,Babergh 005,8619,889,748,1050,1008,1160,1326,1108,854,375,101,1637,6982,2438,18.99,81.01,28.29
E02006232,Babergh 006,6107,599,548,572,569,753,966,905,787,337,71,1147,4960,2100,18.78,81.22,34.39
E02006233,Babergh 007,11790,1208,986,1565,1312,1421,1689,1316,1334,743,216,2194,9596,3609,18.61,81.39,30.61
E02006234,Babergh 008,9751,1167,986,1363,1198,1275,1394,923,1003,364,78,2153,7598,2368,22.08,77.92,24.28
E02006235,Babergh 009,8200,730,768,643,683,1039,1368,1221,1097,522,129,1498,6702,2969,18.27,81.73,36.21
E02006236,Babergh 010,10362,964,1017,910,820,1287,1632,1456,1487,686,103,1981,8381,3732,19.12,80.88,36.02
E02006237,Babergh 011,7731,721,845,737,648,863,1281,1080,931,480,145,1566,6165,2636,20.26,79.74,34.1
E02006245,Ipswich 001,7778,1064,764,978,962,852,1026,866,749,429,88,1828,5950,2132,23.5,76.5,27.41
E02006246,Ipswich 002,7040,795,577,774,833,828,1003,963,741,428,98,1372,5668,2230,19.49,80.51,31.68
E02006247,Ipswich 003,8915,1382,800,1455,1427,1096,1097,793,582,234,49,2182,6733,1658,24.48,75.52,18.6
E02006248,Ipswich 004,8109,1041,935,852,1019,1171,1083,836,708,384,80,1976,6133,2008,24.37,75.63,24.76
E02006249,Ipswich 005,8185,918,778,995,895,1155,1158,997,715,456,118,1696,6489,2286,20.72,79.28,27.93
E02006250,Ipswich 006,10945,1495,1010,2207,2015,1482,1212,834,443,187,60,2505,8440,1524,22.89,77.11,13.92
E02006251,Ipswich 007,10928,1294,953,2370,2045,1528,1284,787,413,200,54,2247,8681,1454,20.56,79.44,13.31
E02006252,Ipswich 008,9269,1252,927,1356,1476,1237,1098,843,585,376,119,2179,7090,1923,23.51,76.49,20.75
E02006253,Ipswich 009,6895,673,588,680,689,803,990,958,835,519,160,1261,5634,2472,18.29,81.71,35.85
E02006254,Ipswich 010,9499,1252,900,1543,1641,1193,1168,848,534,294,126,2152,7347,1802,22.66,77.34,18.97
E02006255,Ipswich 011,8208,1019,583,1607,1400,1076,1052,714,467,237,53,1602,6606,1471,19.52,80.48,17.92
E02006256,Ipswich 012,9754,1484,861,1699,1662,1183,1116,856,548,257,88,2345,7409,1749,24.04,75.96,17.93
E02006257,Ipswich 013,6460,821,535,732,838,656,903,796,646,448,85,1356,5104,1975,20.99,79.01,30.57
E02006258,Ipswich 014,9082,1272,995,1306,1352,1204,1156,915,545,270,67,2267,6815,1797,24.96,75.04,19.79
E02006259,Ipswich 015,7100,1086,565,987,945,782,834,842,694,289,76,1651,5449,1901,23.25,76.75,26.77
E02006260,Ipswich 016,8746,1352,884,1141,1279,1053,1058,946,622,352,59,2236,6510,1979,25.57,74.43,22.63
E02006261,Mid Suffolk 001,8070,680,743,719,669,933,1294,1249,1210,473,100,1423,6647,3032,17.63,82.37,37.57
E02006262,Mid Suffolk 002,9118,756,822,860,762,1094,1568,1423,1238,492,103,1578,7540,3256,17.31,82.69,35.71
E02006263,Mid Suffolk 003,7712,634,702,695,630,868,1302,1192,1152,471,66,1336,6376,2881,17.32,82.68,37.36
E02006264,Mid Suffolk 004,8672,869,839,943,926,1070,1402,1139,947,456,81,1708,6964,2623,19.7,80.3,30.25
E02006265,Mid Suffolk 005,7283,695,607,691,756,844,1187,1074,934,408,87,1302,5981,2503,17.88,82.12,34.37
E02006266,Mid Suffolk 006,9653,859,865,915,978,1095,1528,1448,1303,559,103,1724,7929,3413,17.86,82.14,35.36
E02006267,Mid Suffolk 007,8615,742,931,764,749,1091,1511,1359,945,457,66,1673,6942,2827,19.42,80.58,32.81
E02006268,Mid Suffolk 008,6407,756,582,807,732,724,834,799,710,365,98,1338,5069,1972,20.88,79.12,30.78
E02006269,Mid Suffolk 009,7508,746,645,844,832,966,1207,961,773,378,156,1391,6117,2268,18.53,81.47,30.21
E02006270,Mid Suffolk 010,13467,1712,1364,2009,2135,1888,1783,1199,850,402,125,3076,10391,2576,22.84,77.16,19.13
E02006271,Mid Suffolk 011,9748,1006,709,1714,1447,1041,1192,1105,1008,426,100,1715,8033,2639,17.59,82.41,27.07
E02006272,Mid Suffolk 012,7642,673,672,752,725,1018,1183,1049,991,477,102,1345,6297,2619,17.6,82.4,34.27
E02006317,Elmbridge 001,5846,838,538,494,673,887,814,706,565,267,64,1376,4470,1602,23.54,76.46,27.4
E02006318,Elmbridge 002,6465,813,524,693,664,949,1086,750,616,270,100,1337,5128,1736,20.68,79.32,26.85
E02006319,Elmbridge 003,6785,1001,649,631,904,1053,971,706,514,273,83,1650,5135,1576,24.32,75.68,23.23
E02006320,Elmbridge 004,6729,1141,546,794,1040,1036,913,599,430,210,20,1687,5042,1259,25.07,74.93,18.71
E02006321,Elmbridge 005,6459,1005,737,456,705,1118,945,597,493,271,132,1742,4717,1493,26.97,73.03,23.12
E02006322,Elmbridge 006,6555,970,720,592,800,1092,1036,637,428,241,39,1690,4865,1345,25.78,74.22,20.52
E02006323,Elmbridge 007,7344,1095,577,721,1013,1156,990,699,600,410,83,1672,5672,1792,22.77,77.23,24.4
E02006324,Elmbridge 008,7747,1223,840,821,1023,1284,1116,643,449,252,96,2063,5684,1440,26.63,73.37,18.59
E02006325,Elmbridge 009,9504,1417,1216,833,886,1613,1494,840,700,400,105,2633,6871,2045,27.7,72.3,21.52
E02006326,Elmbridge 010,6904,1106,606,674,959,1076,934,630,553,289,77,1712,5192,1549,24.8,75.2,22.44
E02006327,Elmbridge 011,6650,948,713,483,679,1109,998,648,631,350,91,1661,4989,1720,24.98,75.02,25.86
E02006328,Elmbridge 012,9344,1318,873,822,1242,1599,1336,925,695,397,137,2191,7153,2154,23.45,76.55,23.05
E02006329,Elmbridge 013,7491,884,932,748,654,1147,1184,780,670,350,142,1816,5675,1942,24.24,75.76,25.92
E02006330,Elmbridge 014,9724,1414,957,891,1110,1514,1314,936,916,498,174,2371,7353,2524,24.38,75.62,25.96
E02006331,Elmbridge 015,7051,929,793,524,589,1109,1191,816,656,365,79,1722,5329,1916,24.42,75.58,27.17
E02006332,Elmbridge 016,6426,807,686,587,656,1043,1022,674,501,317,133,1493,4933,1625,23.23,76.77,25.29
E02006333,Elmbridge 017,10609,1399,1366,1138,914,1601,1603,1060,863,528,137,2765,7844,2588,26.06,73.94,24.39
E02006334,Elmbridge 018,9162,1129,1267,754,611,1549,1488,1063,713,445,143,2396,6766,2364,26.15,73.85,25.8
E02006335,Epsom and Ewell 001,8011,870,665,894,910,1068,1274,1025,815,397,93,1535,6476,2330,19.16,80.84,29.09
E02006336,Epsom and Ewell 002,7115,1098,739,858,1024,1030,1014,624,432,259,37,1837,5278,1352,25.82,74.18,19.0
E02006337,Epsom and Ewell 003,8954,1109,856,969,969,1254,1365,1021,879,461,71,1965,6989,2432,21.95,78.05,27.16
E02006338,Epsom and Ewell 004,7023,947,662,707,854,1021,1057,758,667,295,55,1609,5414,1775,22.91,77.09,25.27
E02006339,Epsom and Ewell 005,10936,1813,1206,1199,1632,1909,1445,869,611,208,44,3019,7917,1732,27.61,72.39,15.84
E02006341,Epsom and Ewell 007,10079,1332,1031,1493,1227,1518,1325,889,758,416,90,2363,7716,2153,23.44,76.56,21.36
E02006342,Epsom and Ewell 008,8563,1034,687,1612,1275,1222,863,660,634,438,138,1721,6842,1870,20.1,79.9,21.84
E02006343,Epsom and Ewell 009,8807,1158,1167,888,832,1329,1274,926,773,380,80,2325,6482,2159,26.4,73.6,24.51
E02006837,Epsom and Ewell 010,11139,1243,1198,1262,1029,1591,1707,1193,1142,619,155,2441,8698,3109,21.91,78.09,27.91
E02006344,Guildford 001,8704,920,833,923,790,1189,1350,1103,1019,476,101,1753,6951,2699,20.14,79.86,31.01
E02006345,Guildford 002,7232,885,631,1495,1003,836,827,659,570,274,52,1516,5716,1555,20.96,79.04,21.5
E02006346,Guildford 003,10273,1032,1279,1145,697,1341,1715,1229,1109,578,148,2311,7962,3064,22.5,77.5,29.83
E02006347,Guildford 004,7535,933,623,1051,1038,1129,962,801,639,298,61,1556,5979,1799,20.65,79.35,23.88
E02006348,Guildford 005,8826,1032,721,1382,1075,1081,1175,981,811,461,107,1753,7073,2360,19.86,80.14,26.74
E02006349,Guildford 006,8843,1059,682,2249,1339,1099,966,641,471,266,71,1741,7102,1449,19.69,80.31,16.39
E02006350,Guildford 007,6592,809,659,1312,1037,848,773,550,368,201,35,1468,5124,1154,22.27,77.73,17.51
E02006351,Guildford 008,8744,1194,1006,1245,1022,1282,1242,811,594,276,72,2200,6544,1753,25.16,74.84,20.05
E02006352,Guildford 009,7070,747,456,2334,889,733,734,536,427,190,24,1203,5867,1177,17.02,82.98,16.65
E02006353,Guildford 010,6369,781,556,914,867,867,874,608,569,293,40,1337,5032,1510,20.99,79.01,23.71
E02006354,Guildford 011,9781,1131,1248,1167,913,1433,1440,994,806,538,111,2379,7402,2449,24.32,75.68,25.04
E02006355,Guildford 012,10424,738,682,5347,1116,764,737,503,299,195,43,1420,9004,1040,13.62,86.38,9.98
E02006356,Guildford 013,12372,1117,817,3736,2289,1568,1229,797,452,282,85,1934,10438,1616,15.63,84.37,13.06
E02006357,Guildford 014,6339,719,507,747,776,846,1004,831,634,230,45,1226,5113,1740,19.34,80.66,27.45
E02006358,Guildford 015,9528,707,576,4612,903,870,687,508,400,211,54,1283,8245,1173,13.47,86.53,12.31
E02006359,Guildford 016,6395,652,675,1020,745,858,869,696,554,241,85,1327,5068,1576,20.75,79.25,24.64
E02006360,Guildford 017,8266,913,836,892,789,1117,1279,917,793,503,227,1749,6517,2440,21.16,78.84,29.52
E02006361,Guildford 018,5705,556,577,649,419,719,989,768,664,298,66,1133,4572,1796,19.86,80.14,31.48
E02006362,Mole Valley 001,6691,746,751,593,497,1030,1055,776,730,423,90,1497,5194,2019,22.37,77.63,30.17
E02006363,Mole Valley 002,6221,717,711,514,547,915,943,749,629,377,119,1428,4793,1874,22.95,77.05,30.12
E02006364,Mole Valley 003,7627,1052,690,1184,1175,1069,1011,657,474,250,65,1742,5885,1446,22.84,77.16,18.96
E02006365,Mole Valley 004,6232,612,524,656,596,830,977,759,731,434,113,1136,5096,2037,18.23,81.77,32.69
E02006366,Mole Valley 005,7986,857,805,856,673,952,1285,1063,890,505,100,1662,6324,2558,20.81,79.19,32.03
E02006367,Mole Valley 006,5837,521,585,562,442,692,949,725,782,475,104,1106,4731,2086,18.95,81.05,35.74
E02006368,Mole Valley 007,5537,571,515,461,401,702,852,769,707,438,121,1086,4451,2035,19.61,80.39,36.75
E02006369,Mole Valley 008,6219,480,469,508,436,742,1127,974,893,496,94,949,5270,2457,15.26,84.74,39.51
E02006370,Mole Valley 009,6273,603,652,703,688,932,992,753,578,294,78,1255,5018,1703,20.01,79.99,27.15
E02006371,Mole Valley 010,7329,797,627,835,793,1084,1096,845,663,444,145,1424,5905,2097,19.43,80.57,28.61
E02006372,Mole Valley 011,6508,778,655,799,757,861,989,720,553,331,65,1433,5075,1669,22.02,77.98,25.65
E02006373,Mole Valley 012,7662,796,785,780,669,1091,1300,995,790,378,78,1581,6081,2241,20.63,79.37,29.25
E02006374,Mole Valley 013,7123,639,660,739,695,948,1261,1004,816,303,58,1299,5824,2181,18.24,81.76,30.62
E02006375,Reigate and Banstead 001,6720,811,639,642,714,989,1082,785,678,321,59,1450,5270,1843,21.58,78.42,27.43
E02006376,Reigate and Banstead 002,9164,846,709,1194,1135,1156,1293,966,946,634,285,1555,7609,2831,16.97,83.03,30.89
E02006377,Reigate and Banstead 003,6112,619,603,628,528,799,982,803,688,348,114,1222,4890,1953,19.99,80.01,31.95
E02006378,Reigate and Banstead 004,9022,1032,954,1023,1004,1320,1516,960,723,396,94,1986,7036,2173,22.01,77.99,24.09
E02006379,Reigate and Banstead 005,6631,1152,645,834,984,974,822,578,413,180,49,1797,4834,1220,27.1,72.9,18.4
E02006380,Reigate and Banstead 006,7077,678,676,669,610,827,1140,1000,837,504,136,1354,5723,2477,19.13,80.87,35.0
E02006381,Reigate and Banstead 007,7204,755,598,739,681,905,1233,952,820,418,103,1353,5851,2293,18.78,81.22,31.83
E02006382,Reigate and Banstead 008,6646,960,742,786,950,1031,904,585,429,199,60,1702,4944,1273,25.61,74.39,19.15
E02006383,Reigate and Banstead 009,10341,1245,1317,1046,1196,1575,1403,922,834,575,228,2562,7779,2559,24.78,75.22,24.75
E02006384,Reigate and Banstead 010,11147,1475,1128,1438,1777,1684,1436,968,735,423,83,2603,8544,2209,23.35,76.65,19.82
E02006385,Reigate and Banstead 011,11738,1818,971,1687,2417,1977,1316,745,482,266,59,2789,8949,1552,23.76,76.24,13.22
E02006386,Reigate and Banstead 012,8449,1285,1013,809,979,1423,1185,753,603,304,95,2298,6151,1755,27.2,72.8,20.77
E02006387,Reigate and Banstead 013,6623,1015,743,655,733,1008,987,587,574,259,62,1758,4865,1482,26.54,73.46,22.38
E02006388,Reigate and Banstead 014,9111,1267,847,1112,1374,1454,1266,844,642,250,55,2114,6997,1791,23.2,76.8,19.66
E02006389,Reigate and Banstead 015,6993,960,687,655,836,1006,1047,788,628,322,64,1647,5346,1802,23.55,76.45,25.77
E02006390,Reigate and Banstead 016,8800,1270,860,1015,1183,1235,1157,940,704,353,83,2130,6670,2080,24.2,75.8,23.64
E02006391,Reigate and Banstead 017,7792,1281,677,845,1181,1215,1025,816,500,199,53,1958,5834,1568,25.13,74.87,20.12
E02006392,Reigate and Banstead 018,9178,1159,664,1201,1441,1299,1226,953,728,382,125,1823,7355,2188,19.86,80.14,23.84
E02006393,Runnymede 001,6813,617,434,2220,964,717,719,467,371,244,60,1051,5762,1142,15.43,84.57,16.76
E02006394,Runnymede 002,13191,856,827,6683,976,1057,996,755,610,364,67,1683,11508,1796,12.76,87.24,13.62
E02006395,Runnymede 003,9733,1197,840,1508,1561,1372,1345,923,566,342,79,2037,7696,1910,20.93,79.07,19.62
E02006396,Runnymede 004,6139,558,497,850,671,738,938,780,708,330,69,1055,5084,1887,17.19,82.81,30.74
E02006397,Runnymede 005,6728,776,731,837,687,986,1012,695,536,372,96,1507,5221,1699,22.4,77.6,25.25
E02006398,Runnymede 006,8453,1177,662,1288,1317,1134,1127,749,591,330,78,1839,6614,1748,21.76,78.24,20.68
E02006399,Runnymede 007,11931,1571,1020,1767,1763,1536,1571,1148,926,520,109,2591,9340,2703,21.72,78.28,22.66
E02006400,Runnymede 008,5915,604,465,847,680,759,891,696,581,294,98,1069,4846,1669,18.07,81.93,28.22
E02006401,Runnymede 009,10584,1440,935,1549,1444,1391,1421,946,842,487,129,2375,8209,2404,22.44,77.56,22.71
E02006402,Runnymede 010,9937,1159,861,1282,1132,1421,1512,997,968,491,114,2020,7917,2570,20.33,79.67,25.86
E02006403,Spelthorne 001,6467,866,554,823,1040,972,904,656,433,179,40,1420,5047,1308,21.96,78.04,20.23
E02006404,Spelthorne 002,7776,1201,856,1044,1314,1149,923,555,426,241,67,2057,5719,1289,26.45,73.55,16.58
E02006405,Spelthorne 003,10904,1325,916,1301,1613,1658,1535,1106,917,440,93,2241,8663,2556,20.55,79.45,23.44
E02006406,Spelthorne 004,8761,1187,646,1270,1602,1320,1184,739,466,282,65,1833,6928,1552,20.92,79.08,17.71
E02006407,Spelthorne 005,8802,1087,780,1077,1067,1135,1389,923,800,459,85,1867,6935,2267,21.21,78.79,25.76
E02006408,Spelthorne 006,8551,1177,740,1148,1209,1168,1186,777,657,426,63,1917,6634,1923,22.42,77.58,22.49
E02006409,Spelthorne 007,6824,879,715,828,884,937,1000,722,536,262,61,1594,5230,1581,23.36,76.64,23.17
E02006410,Spelthorne 008,8386,1175,892,1139,1148,1241,1092,806,536,300,57,2067,6319,1699,24.65,75.35,20.26
E02006411,Spelthorne 009,7100,754,625,679,861,1055,1100,808,724,411,83,1379,5721,2026,19.42,80.58,28.54
E02006412,Spelthorne 010,7431,920,736,716,898,1031,1062,826,772,381,89,1656,5775,2068,22.29,77.71,27.83
E02006413,Spelthorne 011,6086,704,561,682,615,827,882,733,625,370,87,1265,4821,1815,20.79,79.21,29.82
E02006414,Spelthorne 012,6197,719,552,635,705,801,1026,761,593,331,74,1271,4926,1759,20.51,79.49,28.38
E02006415,Spelthorne 013,6559,657,542,616,579,863,1045,792,862,499,104,1199,5360,2257,18.28,81.72,34.41
E02006416,Surrey Heath 001,8379,955,783,720,723,1183,1456,1146,878,466,69,1738,6641,2559,20.74,79.26,30.54
E02006417,Surrey Heath 002,6065,840,506,660,799,917,840,630,542,255,76,1346,4719,1503,22.19,77.81,24.78
E02006418,Surrey Heath 003,6720,630,592,687,637,964,1149,828,722,393,118,1222,5498,2061,18.18,81.82,30.67
E02006419,Surrey Heath 004,8140,1073,822,1159,1187,1152,1181,709,478,332,47,1895,6245,1566,23.28,76.72,19.24
E02006420,Surrey Heath 005,7775,745,797,967,681,1096,1237,836,794,497,125,1542,6233,2252,19.83,80.17,28.96
E02006421,Surrey Heath 006,9029,1020,1142,1018,1015,1288,1434,926,727,377,82,2162,6867,2112,23.95,76.05,23.39
E02006422,Surrey Heath 007,6131,751,723,620,664,956,884,661,595,249,28,1474,4657,1533,24.04,75.96,25.0
E02006423,Surrey Heath 008,11196,1261,1014,1562,1674,1625,1500,1041,847,545,127,2275,8921,2560,20.32,79.68,22.87
E02006424,Surrey Heath 009,6348,707,710,614,587,907,953,759,682,370,59,1417,4931,1870,22.32,77.68,29.46
E02006425,Surrey Heath 010,6561,761,722,782,752,1039,960,636,558,281,70,1483,5078,1545,22.6,77.4,23.55
E02006426,Surrey Heath 011,5545,672,544,648,648,813,851,650,510,188,21,1216,4329,1369,21.93,78.07,24.69
E02006427,Surrey Heath 012,7416,944,623,918,1046,1043,993,658,644,424,123,1567,5849,1849,21.13,78.87,24.93
E02006429,Tandridge 002,7879,971,597,988,1225,1126,1109,822,674,300,67,1568,6311,1863,19.9,80.1,23.65
E02006430,Tandridge 003,9758,1369,1044,1148,1383,1489,1353,865,700,329,78,2413,7345,1972,24.73,75.27,20.21
E02006431,Tandridge 004,11470,1500,1256,1396,1625,1542,1554,1130,883,433,151,2756,8714,2597,24.03,75.97,22.64
E02006432,Tandridge 005,5850,701,503,639,600,768,951,629,616,326,117,1204,4646,1688,20.58,79.42,28.85
E02006433,Tandridge 006,9515,1122,935,835,916,1339,1456,1094,988,643,187,2057,7458,2912,21.62,78.38,30.6
E02006434,Tandridge 007,6521,876,741,684,808,874,911,692,552,304,79,1617,4904,1627,24.8,75.2,24.95
E02006435,Tandridge 008,6238,737,558,675,654,847,1070,790,602,238,67,1295,4943,1697,20.76,79.24,27.2
E02006436,Tandridge 009,6098,771,615,653,764,791,900,646,589,280,89,1386,4712,1604,22.73,77.27,26.3
E02006437,Tandridge 010,8756,859,811,984,867,1100,1406,1051,1029,466,183,1670,7086,2729,19.07,80.93,31.17
E02006438,Tandridge 011,8186,794,752,832,770,1078,1418,1115,950,391,86,1546,6640,2542,18.89,81.11,31.05
E02006790,Tandridge 012,7858,905,709,816,844,958,1201,973,843,492,117,1614,6244,2425,20.54,79.46,30.86
E02006439,Waverley 001,5935,659,582,585,611,887,939,677,627,324,44,1241,4694,1672,20.91,79.09,28.17
E02006440,Waverley 002,6988,858,693,772,738,1003,1045,790,719,322,48,1551,5437,1879,22.2,77.8,26.89
E02006441,Waverley 003,8452,884,626,1873,954,1011,1024,719,696,474,191,1510,6942,2080,17.87,82.13,24.61
E02006442,Waverley 004,6279,793,770,493,423,1001,924,725,639,420,91,1563,4716,1875,24.89,75.11,29.86
E02006443,Waverley 005,7338,1002,549,750,1037,992,982,825,673,405,123,1551,5787,2026,21.14,78.86,27.61
E02006444,Waverley 006,7121,1016,886,648,774,1122,978,696,602,326,73,1902,5219,1697,26.71,73.29,23.83
E02006445,Waverley 007,8111,1142,1051,839,1234,1237,913,700,614,290,91,2193,5918,1695,27.04,72.96,20.9
E02006446,Waverley 008,6914,820,787,622,551,991,1102,836,713,395,97,1607,5307,2041,23.24,76.76,29.52
E02006447,Waverley 009,6393,746,833,591,551,959,960,706,634,338,75,1579,4814,1753,24.7,75.3,27.42
E02006448,Waverley 010,7380,1064,743,653,960,1130,1023,779,629,322,77,1807,5573,1807,24.49,75.51,24.49
E02006449,Waverley 011,6985,803,660,675,616,962,1084,791,737,524,133,1463,5522,2185,20.94,79.06,31.28
E02006450,Waverley 012,7263,869,881,711,662,1054,1147,847,675,337,80,1750,5513,1939,24.09,75.91,26.7
E02006451,Waverley 013,11403,1141,1429,1273,993,1366,1508,1371,1474,702,146,2570,8833,3693,22.54,77.46,32.39
E02006453,Waverley 015,8116,821,783,902,685,993,1202,981,1043,551,155,1604,6512,2730,19.76,80.24,33.64
E02006454,Waverley 016,6706,811,716,580,610,967,1022,740,647,450,163,1527,5179,2000,22.77,77.23,29.82
E02006455,Waverley 017,6182,794,595,680,687,993,899,633,471,287,143,1389,4793,1534,22.47,77.53,24.81
E02006839,Waverley 018,8762,819,911,815,693,1230,1484,1065,963,604,178,1730,7032,2810,19.74,80.26,32.07
E02006456,Woking 001,7595,1111,719,695,1018,1176,1056,742,638,346,94,1830,5765,1820,24.09,75.91,23.96
E02006457,Woking 002,9004,1049,887,754,744,1401,1376,1038,1001,550,204,1936,7068,2793,21.5,78.5,31.02
E02006458,Woking 003,8999,1131,910,822,850,1382,1376,1038,840,518,132,2041,6958,2528,22.68,77.32,28.09
E02006459,Woking 004,10435,1590,1196,1678,1728,1632,1180,806,373,202,50,2786,7649,1431,26.7,73.3,13.71
E02006460,Woking 005,8993,1311,863,1004,1364,1248,1200,1040,626,264,73,2174,6819,2003,24.17,75.83,22.27
E02006461,Woking 006,6818,776,689,690,727,1068,944,749,603,428,144,1465,5353,1924,21.49,78.51,28.22
E02006462,Woking 007,8011,1077,848,903,981,1294,1222,778,585,290,33,1925,6086,1686,24.03,75.97,21.05
E02006463,Woking 008,10850,1624,730,1464,2324,1747,1161,769,576,349,106,2354,8496,1800,21.7,78.3,16.59
E02006464,Woking 009,6589,814,629,651,791,973,959,764,602,347,59,1443,5146,1772,21.9,78.1,26.89
E02006465,Woking 010,5945,710,597,564,678,893,897,714,535,271,86,1307,4638,1606,21.98,78.02,27.01
E02006466,Woking 011,10668,1758,1298,1188,1574,1733,1295,821,591,313,97,3056,7612,1822,28.65,71.35,17.08
E02006467,Woking 012,6886,906,764,590,757,1092,1072,791,592,277,45,1670,5216,1705,24.25,75.75,24.76
E02006468,North Warwickshire 001,11011,1179,1028,1340,1174,1467,1653,1314,1248,520,88,2207,8804,3170,20.04,79.96,28.79
E02006469,North Warwickshire 002,9200,1127,932,1175,1249,1125,1351,1053,763,329,96,2059,7141,2241,22.38,77.62,24.36
E02006470,North Warwickshire 003,12021,1439,1032,1646,1409,1478,1711,1435,1169,582,120,2471,9550,3306,20.56,79.44,27.5
E02006471,North Warwickshire 004,6947,602,543,793,706,839,1167,1049,900,307,41,1145,5802,2297,16.48,83.52,33.06
E02006472,North Warwickshire 005,9549,1076,812,1224,1156,1239,1487,1144,955,352,104,1888,7661,2555,19.77,80.23,26.76
E02006473,North Warwickshire 006,10160,1024,812,1347,1198,1259,1562,1208,1049,580,121,1836,8324,2958,18.07,81.93,29.11
E02006474,North Warwickshire 007,6376,699,507,676,634,810,1116,843,701,311,79,1206,5170,1934,18.91,81.09,30.33
E02006475,Nuneaton and Bedworth 001,8483,1117,790,923,983,1070,1195,996,873,462,74,1907,6576,2405,22.48,77.52,28.35
E02006476,Nuneaton and Bedworth 002,8809,1467,949,1322,1397,999,1041,807,544,236,47,2416,6393,1634,27.43,72.57,18.55
E02006477,Nuneaton and Bedworth 003,7547,822,686,856,814,923,1217,1009,794,373,53,1508,6039,2229,19.98,80.02,29.53
E02006478,Nuneaton and Bedworth 004,7802,991,780,1124,1030,1079,1234,857,547,149,11,1771,6031,1564,22.7,77.3,20.05
E02006479,Nuneaton and Bedworth 005,9244,1119,713,1694,1576,1238,1168,825,610,243,58,1832,7412,1736,19.82,80.18,18.78
E02006480,Nuneaton and Bedworth 006,7466,1000,707,1034,972,919,1059,887,634,227,27,1707,5759,1775,22.86,77.14,23.77
E02006481,Nuneaton and Bedworth 007,7006,998,696,1023,981,851,860,711,630,228,28,1694,5312,1597,24.18,75.82,22.79
E02006482,Nuneaton and Bedworth 008,7122,878,645,1067,993,939,994,746,609,220,31,1523,5599,1606,21.38,78.62,22.55
E02006483,Nuneaton and Bedworth 009,8172,1131,825,1219,1128,993,1120,745,604,327,80,1956,6216,1756,23.94,76.06,21.49
E02006484,Nuneaton and Bedworth 010,7587,997,630,1113,1022,935,1108,730,639,347,66,1627,5960,1782,21.44,78.56,23.49
E02006485,Nuneaton and Bedworth 011,6367,488,485,639,595,724,1126,1044,852,358,56,973,5394,2310,15.28,84.72,36.28
E02006486,Nuneaton and Bedworth 012,6958,808,561,931,783,843,1091,874,698,302,67,1369,5589,1941,19.68,80.32,27.9
E02006487,Nuneaton and Bedworth 013,6876,808,575,955,815,804,894,807,797,348,73,1383,5493,2025,20.11,79.89,29.45
E02006488,Nuneaton and Bedworth 014,6096,563,416,538,521,625,900,884,1035,554,60,979,5117,2533,16.06,83.94,41.55
E02006489,Nuneaton and Bedworth 015,8063,1134,813,1099,1190,1102,1091,796,613,204,21,1947,6116,1634,24.15,75.85,20.27
E02006490,Nuneaton and Bedworth 016,7720,972,796,893,1044,1036,1054,875,611,368,71,1768,5952,1925,22.9,77.1,24.94
E02006806,Nuneaton and Bedworth 018,8565,1133,840,1156,1152,1037,1175,934,688,376,74,1973,6592,2072,23.04,76.96,24.19
E02006492,Rugby 001,13368,1779,1123,1708,1843,1811,1987,1383,1087,487,160,2902,10466,3117,21.71,78.29,23.32
E02006493,Rugby 002,10428,1549,1009,1429,1777,1462,1466,955,560,183,38,2558,7870,1736,24.53,75.47,16.65
E02006494,Rugby 003,7578,1004,654,1188,1185,973,979,710,519,281,85,1658,5920,1595,21.88,78.12,21.05
E02006495,Rugby 004,7587,806,685,807,784,983,1096,940,1002,418,66,1491,6096,2426,19.65,80.35,31.98
E02006496,Rugby 005,7080,901,629,1258,1325,1018,931,513,360,122,23,1530,5550,1018,21.61,78.39,14.38
E02006497,Rugby 006,8379,1118,777,1372,1605,1149,1053,629,427,212,37,1895,6484,1305,22.62,77.38,15.57
E02006498,Rugby 007,13373,2033,1683,1511,1882,2010,1816,1126,917,334,61,3716,9657,2438,27.79,72.21,18.23
E02006499,Rugby 008,5882,706,585,640,723,879,866,565,566,286,66,1291,4591,1483,21.95,78.05,25.21
E02006500,Rugby 009,5970,533,951,732,640,641,758,637,625,350,103,1484,4486,1715,24.86,75.14,28.73
E02006501,Rugby 010,10036,1261,1037,1066,1135,1387,1330,1072,1081,517,150,2298,7738,2820,22.9,77.1,28.1
E02006502,Rugby 011,10730,1102,929,989,1142,1308,1425,1270,1457,852,256,2031,8699,3835,18.93,81.07,35.74
E02006503,Rugby 012,8524,896,818,764,655,1040,1414,1081,1135,585,136,1714,6810,2937,20.11,79.89,34.46
E02006504,Stratford-on-Avon 001,5825,531,481,603,395,656,1041,897,810,343,68,1012,4813,2118,17.37,82.63,36.36
E02006505,Stratford-on-Avon 002,6780,551,563,592,534,773,1052,923,1114,559,119,1114,5666,2715,16.43,83.57,40.04
E02006506,Stratford-on-Avon 003,5942,704,564,703,608,700,840,705,668,368,82,1268,4674,1823,21.34,78.66,30.68
E02006507,Stratford-on-Avon 004,9801,1046,965,1270,1055,1273,1494,1119,990,497,92,2011,7790,2698,20.52,79.48,27.53
E02006508,Stratford-on-Avon 005,10365,1106,916,1093,1026,1431,1666,1297,1241,486,103,2022,8343,3127,19.51,80.49,30.17
E02006509,Stratford-on-Avon 006,6101,572,470,717,623,616,928,800,786,487,102,1042,5059,2175,17.08,82.92,35.65
E02006510,Stratford-on-Avon 007,6933,643,596,628,637,826,1075,1003,995,454,76,1239,5694,2528,17.87,82.13,36.46
E02006511,Stratford-on-Avon 008,9992,1106,927,1104,1016,1212,1456,1304,1162,535,170,2033,7959,3171,20.35,79.65,31.74
E02006512,Stratford-on-Avon 009,12317,1251,945,1779,1833,1610,1649,1371,1119,613,147,2196,10121,3250,17.83,82.17,26.39
E02006513,Stratford-on-Avon 010,8301,883,801,856,859,1137,1254,916,940,518,137,1684,6617,2511,20.29,79.71,30.25
E02006514,Stratford-on-Avon 011,9366,747,700,1103,1014,1140,1342,1219,1178,704,219,1447,7919,3320,15.45,84.55,35.45
E02006515,Stratford-on-Avon 012,10555,1133,948,1073,1113,1319,1680,1387,1234,569,99,2081,8474,3289,19.72,80.28,31.16
E02006516,Stratford-on-Avon 013,9318,983,744,1146,994,1126,1497,1249,1047,429,103,1727,7591,2828,18.53,81.47,30.35
E02006517,Stratford-on-Avon 014,8938,1089,887,933,964,1148,1353,1091,962,404,107,1976,6962,2564,22.11,77.89,28.69
E02006518,Stratford-on-Avon 015,9564,849,754,891,815,1130,1548,1413,1309,678,177,1603,7961,3577,16.76,83.24,37.4
E02006519,Warwick 001,7449,661,630,931,671,937,1058,913,973,520,155,1291,6158,2561,17.33,82.67,34.38
E02006520,Warwick 002,8026,739,796,1019,685,1077,1290,970,893,442,115,1535,6491,2420,19.13,80.87,30.15
E02006521,Warwick 003,7140,707,670,780,536,891,1114,840,938,547,117,1377,5763,2442,19.29,80.71,34.2
E02006522,Warwick 004,5240,445,457,568,401,653,940,804,688,241,43,902,4338,1776,17.21,82.79,33.89
E02006523,Warwick 005,12927,1138,1070,3704,1143,1220,1537,1241,1097,596,181,2208,10719,3115,17.08,82.92,24.1
E02006524,Warwick 006,5479,724,522,886,657,617,756,549,449,243,76,1246,4233,1317,22.74,77.26,24.04
E02006525,Warwick 007,13678,1233,1016,3228,1739,1669,1612,1146,1150,673,212,2249,11429,3181,16.44,83.56,23.26
E02006526,Warwick 008,8408,958,620,1222,1064,1058,1143,1063,822,373,85,1578,6830,2343,18.77,81.23,27.87
E02006527,Warwick 009,9651,894,730,2152,1162,1321,1154,941,768,392,137,1624,8027,2238,16.83,83.17,23.19
E02006528,Warwick 010,11079,1135,671,3319,1557,1337,1172,883,628,314,63,1806,9273,1888,16.3,83.7,17.04
E02006529,Warwick 011,12585,1717,1114,2063,1792,1765,1606,1094,849,470,115,2831,9754,2528,22.5,77.5,20.09
E02006530,Warwick 012,11630,1421,1191,1716,1306,1700,1616,1118,994,473,95,2612,9018,2680,22.46,77.54,23.04
E02006531,Warwick 013,10937,1090,789,3853,1642,1069,1011,783,409,242,49,1879,9058,1483,17.18,82.82,13.56
E02006532,Warwick 014,9710,1305,963,1169,1027,1437,1418,1070,882,381,58,2268,7442,2391,23.36,76.64,24.62
E02006533,Warwick 015,9814,1300,846,1577,1267,1375,1304,899,757,383,106,2146,7668,2145,21.87,78.13,21.86
E02006534,Adur 001,8873,1086,840,933,1029,1252,1324,977,856,464,112,1926,6947,2409,21.71,78.29,27.15
E02006535,Adur 002,7309,943,638,606,739,1108,996,878,893,418,90,1581,5728,2279,21.63,78.37,31.18
E02006536,Adur 003,7408,829,814,731,845,980,1079,906,749,412,63,1643,5765,2130,22.18,77.82,28.75
E02006537,Adur 004,10681,1455,1013,1335,1320,1510,1501,1023,880,523,121,2468,8213,2547,23.11,76.89,23.85
E02006538,Adur 005,9173,1082,701,969,1023,1387,1316,1115,972,499,109,1783,7390,2695,19.44,80.56,29.38
E02006539,Adur 006,7248,799,623,772,830,925,1036,882,918,382,81,1422,5826,2263,19.62,80.38,31.22
E02006540,Adur 007,5756,642,437,587,647,696,799,756,767,364,61,1079,4677,1948,18.75,81.25,33.84
E02006541,Adur 008,7853,772,536,891,1003,908,1072,958,1006,562,145,1308,6545,2671,16.66,83.34,34.01
E02006542,Arun 001,5649,440,467,440,471,635,914,939,871,390,82,907,4742,2282,16.06,83.94,40.4
E02006543,Arun 002,5537,501,438,532,507,604,943,810,771,356,75,939,4598,2012,16.96,83.04,36.34
E02006544,Arun 003,10756,1125,1026,1045,1013,1272,1670,1490,1355,598,162,2151,8605,3605,20.0,80.0,33.52
E02006545,Arun 004,10644,1832,1019,1424,1522,1234,1406,1047,789,310,61,2851,7793,2207,26.79,73.21,20.73
E02006546,Arun 005,10431,1122,989,1045,925,1347,1449,1271,1403,706,174,2111,8320,3554,20.24,79.76,34.07
E02006547,Arun 006,6548,759,564,724,801,797,938,908,689,288,80,1323,5225,1965,20.2,79.8,30.01
E02006548,Arun 007,9509,1099,832,1091,1062,1175,1331,1134,1069,581,135,1931,7578,2919,20.31,79.69,30.7
E02006549,Arun 008,5966,269,349,400,266,525,871,1062,1354,712,158,618,5348,3286,10.36,89.64,55.08
E02006550,Arun 009,9251,803,759,896,761,947,1329,1379,1439,789,149,1562,7689,3756,16.88,83.12,40.6
E02006551,Arun 010,8062,390,338,450,385,627,969,1464,1979,1128,332,728,7334,4903,9.03,90.97,60.82
E02006552,Arun 011,7300,758,536,987,961,959,1076,860,703,347,113,1294,6006,2023,17.73,82.27,27.71
E02006553,Arun 012,8975,1095,727,1079,1254,1061,1226,1087,918,459,69,1822,7153,2533,20.3,79.7,28.22
E02006554,Arun 013,6630,542,518,556,489,673,915,1108,1139,574,116,1060,5570,2937,15.99,84.01,44.3
E02006555,Arun 014,7921,896,673,1211,1102,948,1168,845,619,343,116,1569,6352,1923,19.81,80.19,24.28
E02006556,Arun 015,9996,1139,891,889,837,1071,1403,1311,1538,737,180,2030,7966,3766,20.31,79.69,37.68
E02006557,Arun 016,8081,1073,761,1194,1124,1015,1182,728,585,300,119,1834,6247,1732,22.7,77.3,21.43
E02006558,Arun 017,11853,1101,628,2310,1725,1411,1588,1200,1075,633,182,1729,10124,3090,14.59,85.41,26.07
E02006559,Arun 018,8317,512,478,551,478,766,1054,1473,1804,957,244,990,7327,4478,11.9,88.1,53.84
E02006560,Arun 019,9332,845,626,750,764,967,1304,1480,1610,852,134,1471,7861,4076,15.76,84.24,43.68
E02006561,Chichester 001,6814,820,843,552,553,1016,1073,851,747,305,54,1663,5151,1957,24.41,75.59,28.72
E02006562,Chichester 002,6043,636,615,457,415,743,1094,928,781,327,47,1251,4792,2083,20.7,79.3,34.47
E02006563,Chichester 003,5810,519,556,498,382,718,1042,896,729,369,101,1075,4735,2095,18.5,81.5,36.06
E02006564,Chichester 004,7918,855,648,714,727,866,1180,1139,1060,575,154,1503,6415,2928,18.98,81.02,36.98
E02006565,Chichester 005,7991,695,724,712,618,869,1298,1200,1147,556,172,1419,6572,3075,17.76,82.24,38.48
E02006566,Chichester 006,7939,793,626,802,589,864,1138,1241,1102,646,138,1419,6520,3127,17.87,82.13,39.39
E02006567,Chichester 007,7313,789,674,609,629,875,1220,1028,922,471,96,1463,5850,2517,20.01,79.99,34.42
E02006568,Chichester 008,11904,1284,885,2515,1573,1253,1400,1164,1025,612,193,2169,9735,2994,18.22,81.78,25.15
E02006569,Chichester 009,8586,943,698,961,854,911,1126,1219,1164,547,163,1641,6945,3093,19.11,80.89,36.02
E02006570,Chichester 010,9267,740,517,2083,1094,1006,1083,992,942,656,154,1257,8010,2744,13.56,86.44,29.61
E02006571,Chichester 011,8892,977,743,1233,807,1043,1344,1079,1000,529,137,1720,7172,2745,19.34,80.66,30.87
E02006572,Chichester 012,10684,1301,995,1488,1402,1283,1495,1231,978,426,85,2296,8388,2720,21.49,78.51,25.46
E02006573,Chichester 013,11207,1005,820,914,859,1172,1657,1705,1837,970,268,1825,9382,4780,16.28,83.72,42.65
E02006574,Chichester 014,10761,851,770,948,730,983,1643,1803,1854,947,232,1621,9140,4836,15.06,84.94,44.94
E02006575,Crawley 001,8665,1310,957,1172,1535,1255,1012,740,418,216,50,2267,6398,1424,26.16,73.84,16.43
E02006576,Crawley 002,8933,1315,813,1066,1321,1331,1144,937,639,303,64,2128,6805,1943,23.82,76.18,21.75
E02006577,Crawley 003,8502,1233,782,1126,1385,1161,981,764,543,382,145,2015,6487,1834,23.7,76.3,21.57
E02006578,Crawley 004,11365,1684,908,1727,2416,1529,1228,830,556,373,114,2592,8773,1873,22.81,77.19,16.48
E02006579,Crawley 005,8082,1109,794,1050,1265,1194,1052,732,518,296,72,1903,6179,1618,23.55,76.45,20.02
E02006580,Crawley 006,8231,1149,728,1089,1250,1023,1121,816,550,403,102,1877,6354,1871,22.8,77.2,22.73
E02006581,Crawley 007,9237,1375,754,1339,1644,1221,1133,794,563,323,91,2129,7108,1771,23.05,76.95,19.17
E02006582,Crawley 008,7749,1000,900,964,1007,1366,1199,709,424,142,38,1900,5849,1313,24.52,75.48,16.94
E02006583,Crawley 009,9203,1180,873,1242,1325,1289,1254,920,665,362,93,2053,7150,2040,22.31,77.69,22.17
E02006584,Crawley 010,7687,1187,821,1004,1323,1108,1066,699,349,95,35,2008,5679,1178,26.12,73.88,15.32
E02006585,Crawley 011,7708,1048,907,927,1053,1080,1008,737,482,405,61,1955,5753,1685,25.36,74.64,21.86
E02006586,Crawley 012,8067,1259,921,1380,1328,1198,959,689,266,56,11,2180,5887,1022,27.02,72.98,12.67
E02006587,Crawley 013,8980,1305,905,1322,1589,1272,1112,858,459,139,19,2210,6770,1475,24.61,75.39,16.43
E02006588,Horsham 001,9119,1087,785,1275,1265,1267,1358,961,771,306,44,1872,7247,2082,20.53,79.47,22.83
E02006589,Horsham 002,11360,1244,1079,1238,1221,1585,1881,1428,1079,499,106,2323,9037,3112,20.45,79.55,27.39
E02006590,Horsham 003,9104,1046,893,1132,1064,1244,1390,990,822,432,91,1939,7165,2335,21.3,78.7,25.65
E02006591,Horsham 004,8415,969,736,1051,1194,1225,1192,850,654,425,119,1705,6710,2048,20.26,79.74,24.34
E02006592,Horsham 005,6698,682,714,676,631,849,1145,894,692,325,90,1396,5302,2001,20.84,79.16,29.87
E02006593,Horsham 006,11461,1309,991,1542,1622,1620,1546,1060,836,694,241,2300,9161,2831,20.07,79.93,24.7
E02006594,Horsham 007,10428,1493,1051,1183,1536,1590,1364,1037,729,357,88,2544,7884,2211,24.4,75.6,21.2
E02006595,Horsham 008,8801,793,1352,853,768,1040,1455,1066,957,447,70,2145,6656,2540,24.37,75.63,28.86
E02006596,Horsham 009,9313,1125,986,1154,1094,1302,1603,1080,640,276,53,2111,7202,2049,22.67,77.33,22.0
E02006597,Horsham 010,10911,1352,1093,1099,1253,1573,1668,1195,1050,523,105,2445,8466,2873,22.41,77.59,26.33
E02006598,Horsham 011,5528,527,487,558,487,707,987,824,620,270,61,1014,4514,1775,18.34,81.66,32.11
E02006599,Horsham 012,6870,414,490,463,346,628,1177,1297,1301,637,117,904,5966,3352,13.16,86.84,48.79
E02006600,Horsham 013,9895,1002,729,927,951,1167,1418,1361,1430,700,210,1731,8164,3701,17.49,82.51,37.4
E02006601,Horsham 014,8838,977,742,840,841,989,1361,1189,1102,644,153,1719,7119,3088,19.45,80.55,34.94
E02006602,Horsham 015,8433,911,880,798,746,1048,1418,1143,994,424,71,1791,6642,2632,21.24,78.76,31.21
E02006603,Horsham 016,8617,727,761,769,676,1052,1371,1215,1292,620,134,1488,7129,3261,17.27,82.73,37.84
E02006604,Mid Sussex 001,13047,1567,1151,1555,1795,1921,1778,1366,1103,600,211,2718,10329,3280,20.83,79.17,25.14
E02006605,Mid Sussex 002,6519,718,747,833,657,832,970,761,643,288,70,1465,5054,1762,22.47,77.53,27.03
E02006606,Mid Sussex 003,8589,1040,856,839,1010,1211,1367,1024,848,339,55,1896,6693,2266,22.07,77.93,26.38
E02006607,Mid Sussex 004,8102,901,738,819,849,1143,1222,962,907,444,117,1639,6463,2430,20.23,79.77,29.99
E02006608,Mid Sussex 005,6351,778,558,589,650,780,907,922,799,335,33,1336,5015,2089,21.04,78.96,32.89
E02006609,Mid Sussex 006,6982,665,903,780,582,893,1158,896,741,305,59,1568,5414,2001,22.46,77.54,28.66
E02006610,Mid Sussex 007,7526,886,813,666,814,1132,1225,871,657,354,108,1699,5827,1990,22.58,77.42,26.44
E02006611,Mid Sussex 008,11341,1504,1171,942,1151,1730,1460,1254,1325,646,158,2675,8666,3383,23.59,76.41,29.83
E02006612,Mid Sussex 009,12053,1553,911,1490,2123,1961,1384,970,923,543,195,2464,9589,2631,20.44,79.56,21.83
E02006613,Mid Sussex 010,7926,1099,825,920,1207,1115,1072,767,570,284,67,1924,6002,1688,24.27,75.73,21.3
E02006614,Mid Sussex 011,11972,1591,1246,1246,1509,1814,1800,1203,997,462,104,2837,9135,2766,23.7,76.3,23.1
E02006615,Mid Sussex 012,7056,905,735,910,959,1074,1121,674,443,188,47,1640,5416,1352,23.24,76.76,19.16
E02006616,Mid Sussex 013,9050,1203,813,1037,1273,1202,1220,951,853,437,61,2016,7034,2302,22.28,77.72,25.44
E02006617,Mid Sussex 014,9322,1066,779,1215,1405,1307,1232,966,800,445,107,1845,7477,2318,19.79,80.21,24.87
E02006618,Mid Sussex 015,6299,613,599,603,600,836,994,851,670,422,111,1212,5087,2054,19.24,80.76,32.61
E02006619,Mid Sussex 016,8930,1119,1032,858,951,1390,1356,1073,724,341,86,2151,6779,2224,24.09,75.91,24.9
E02006620,Mid Sussex 017,9957,1134,934,776,938,1491,1473,1157,1108,779,167,2068,7889,3211,20.77,79.23,32.25
E02006621,Worthing 001,7648,530,560,567,491,936,1230,1232,1319,650,133,1090,6558,3334,14.25,85.75,43.59
E02006622,Worthing 002,7975,867,688,758,830,1044,1194,1004,938,515,137,1555,6420,2594,19.5,80.5,32.53
E02006623,Worthing 003,8115,1081,798,933,1002,962,1130,967,817,347,78,1879,6236,2209,23.15,76.85,27.22
E02006624,Worthing 004,7481,814,890,748,696,1182,1195,851,659,367,79,1704,5777,1956,22.78,77.22,26.15
E02006625,Worthing 005,8050,1035,826,982,1078,1285,1239,759,525,262,59,1861,6189,1605,23.12,76.88,19.94
E02006626,Worthing 006,9368,1561,1012,1112,1446,1245,1203,930,561,248,50,2573,6795,1789,27.47,72.53,19.1
E02006627,Worthing 007,9229,1036,873,1050,1135,1219,1344,982,979,506,105,1909,7320,2572,20.68,79.32,27.87
E02006628,Worthing 008,9287,1249,959,1244,1468,1424,1327,723,537,297,59,2208,7079,1616,23.78,76.22,17.4
E02006629,Worthing 009,7986,933,835,974,947,1177,1177,831,659,360,93,1768,6218,1943,22.14,77.86,24.33
E02006630,Worthing 010,8753,741,417,1121,1178,1078,1277,947,982,701,311,1158,7595,2941,13.23,86.77,33.6
E02006631,Worthing 011,10288,993,578,1711,1792,1518,1391,848,779,505,173,1571,8717,2305,15.27,84.73,22.4
E02006632,Worthing 012,8308,776,637,826,863,1055,1170,1143,1036,626,176,1413,6895,2981,17.01,82.99,35.88
E02006633,Worthing 013,8082,564,605,635,534,855,1272,1216,1456,778,167,1169,6913,3617,14.46,85.54,44.75
E02006696,Bromsgrove 001,7162,911,841,632,777,1021,986,648,788,462,96,1752,5410,1994,24.46,75.54,27.84
E02006697,Bromsgrove 002,7506,645,687,698,598,975,1337,1051,898,472,145,1332,6174,2566,17.75,82.25,34.19
E02006698,Bromsgrove 003,6523,654,550,807,700,807,1069,798,644,416,78,1204,5319,1936,18.46,81.54,29.68
E02006699,Bromsgrove 004,6065,668,512,627,641,711,862,796,793,380,75,1180,4885,2044,19.46,80.54,33.7
E02006700,Bromsgrove 005,6260,652,446,640,603,730,968,797,775,499,150,1098,5162,2221,17.54,82.46,35.48
E02006701,Bromsgrove 006,7020,939,571,644,815,967,1054,902,711,327,90,1510,5510,2030,21.51,78.49,28.92
E02006702,Bromsgrove 007,6125,820,487,874,751,794,830,669,572,270,58,1307,4818,1569,21.34,78.66,25.62
E02006703,Bromsgrove 008,7722,929,644,750,894,1034,1219,1018,793,357,84,1573,6149,2252,20.37,79.63,29.16
E02006704,Bromsgrove 009,7115,805,628,647,725,1020,1029,943,790,418,110,1433,5682,2261,20.14,79.86,31.78
E02006705,Bromsgrove 010,7299,884,611,1028,1023,936,1015,746,655,314,87,1495,5804,1802,20.48,79.52,24.69
E02006706,Bromsgrove 011,7452,590,926,1016,780,828,1013,861,738,508,192,1516,5936,2299,20.34,79.66,30.85
E02006707,Bromsgrove 012,6993,844,836,639,735,1144,1052,690,662,326,65,1680,5313,1743,24.02,75.98,24.92
E02006708,Bromsgrove 013,8470,1142,880,1320,1234,1132,1131,769,531,271,60,2022,6448,1631,23.87,76.13,19.26
E02006709,Bromsgrove 014,8169,712,635,1070,1143,1047,1291,1113,787,293,78,1347,6822,2271,16.49,83.51,27.8
E02006710,Malvern Hills 001,8199,783,657,760,647,919,1337,1238,1195,542,121,1440,6759,3096,17.56,82.44,37.76
E02006711,Malvern Hills 002,8299,700,801,737,651,1019,1424,1272,1109,506,80,1501,6798,2967,18.09,81.91,35.75
E02006712,Malvern Hills 003,7358,701,582,635,632,884,1220,1105,1013,491,95,1283,6075,2704,17.44,82.56,36.75
E02006713,Malvern Hills 004,6438,602,460,690,682,748,1018,796,796,506,140,1062,5376,2238,16.5,83.5,34.76
E02006714,Malvern Hills 005,5650,521,416,477,418,671,950,825,856,397,119,937,4713,2197,16.58,83.42,38.88
E02006715,Malvern Hills 006,8639,928,781,1040,963,1204,1362,1093,843,366,59,1709,6930,2361,19.78,80.22,27.33
E02006716,Malvern Hills 007,6397,886,665,874,710,734,881,734,565,286,62,1551,4846,1647,24.25,75.75,25.75
E02006717,Malvern Hills 008,6470,614,554,553,640,747,1014,946,901,382,119,1168,5302,2348,18.05,81.95,36.29
E02006718,Malvern Hills 009,6217,521,605,660,472,639,854,924,879,493,170,1126,5091,2466,18.11,81.89,39.67
E02006719,Malvern Hills 010,7893,494,827,1107,560,792,1086,1186,1050,627,164,1321,6572,3027,16.74,83.26,38.35
E02006720,Malvern Hills 011,7138,588,615,606,524,792,1244,1167,985,499,118,1203,5935,2769,16.85,83.15,38.79
E02006721,Redditch 001,6168,739,512,724,840,679,761,866,742,259,46,1251,4917,1913,20.28,79.72,31.01
E02006722,Redditch 002,5415,861,609,808,895,703,541,605,305,74,14,1470,3945,998,27.15,72.85,18.43
E02006723,Redditch 003,8783,1306,998,1181,1360,1203,1142,707,508,281,97,2304,6479,1593,26.23,73.77,18.14
E02006724,Redditch 004,7207,1084,678,1269,1365,983,764,519,330,154,61,1762,5445,1064,24.45,75.55,14.76
E02006725,Redditch 005,5582,686,498,779,800,782,696,768,441,110,22,1184,4398,1341,21.21,78.79,24.02
E02006726,Redditch 006,6557,829,601,984,1064,835,821,662,505,215,41,1430,5127,1423,21.81,78.19,21.7
E02006727,Redditch 007,5983,664,517,709,743,808,793,759,676,274,40,1181,4802,1749,19.74,80.26,29.23
E02006728,Redditch 008,7152,772,600,782,788,929,1085,1001,690,398,107,1372,5780,2196,19.18,80.82,30.7
E02006729,Redditch 009,7112,841,708,921,944,937,880,954,710,184,33,1549,5563,1881,21.78,78.22,26.45
E02006730,Redditch 010,6660,1102,750,1072,1118,848,637,573,400,131,29,1852,4808,1133,27.81,72.19,17.01
E02006731,Redditch 011,5609,691,447,657,714,639,848,734,612,214,53,1138,4471,1613,20.29,79.71,28.76
E02006732,Redditch 012,7004,692,649,883,825,924,1063,946,702,287,33,1341,5663,1968,19.15,80.85,28.1
E02006733,Redditch 013,6029,598,538,664,591,807,987,796,714,263,71,1136,4893,1844,18.84,81.16,30.59
E02006734,Worcester 001,8076,920,680,770,902,1100,1118,1020,896,536,134,1600,6476,2586,19.81,80.19,32.02
E02006735,Worcester 002,5496,993,543,815,811,597,703,480,333,201,20,1536,3960,1034,27.95,72.05,18.81
E02006736,Worcester 003,6281,762,578,1019,812,980,1072,560,347,136,15,1340,4941,1058,21.33,78.67,16.84
E02006737,Worcester 004,8170,893,712,1260,1151,1113,1091,881,749,261,59,1605,6565,1950,19.65,80.35,23.87
E02006738,Worcester 005,8994,1376,1060,1460,1343,1044,1078,784,561,248,40,2436,6558,1633,27.08,72.92,18.16
E02006739,Worcester 006,5691,350,379,1915,419,488,644,515,576,337,68,729,4962,1496,12.81,87.19,26.29
E02006740,Worcester 007,7783,543,463,2331,1208,864,930,685,469,219,71,1006,6777,1444,12.93,87.07,18.55
E02006741,Worcester 008,6029,771,604,938,761,865,913,549,360,219,49,1375,4654,1177,22.81,77.19,19.52
E02006742,Worcester 009,8836,997,895,2165,956,981,922,845,673,342,60,1892,6944,1920,21.41,78.59,21.73
E02006743,Worcester 010,6550,911,678,1035,880,872,854,659,472,166,23,1589,4961,1320,24.26,75.74,20.15
E02006744,Worcester 011,7420,849,612,1572,1147,1008,919,626,401,226,60,1461,5959,1313,19.69,80.31,17.7
E02006745,Worcester 012,8167,838,716,1109,934,945,1124,1008,890,483,120,1554,6613,2501,19.03,80.97,30.62
E02006746,Worcester 013,8332,915,722,1299,1117,1071,1110,922,750,364,62,1637,6695,2098,19.65,80.35,25.18
E02006747,Worcester 014,5397,581,462,781,593,783,893,581,469,224,30,1043,4354,1304,19.33,80.67,24.16
E02006748,Wychavon 001,7985,946,716,822,816,1009,1266,1066,839,415,90,1662,6323,2410,20.81,79.19,30.18
E02006749,Wychavon 002,5279,747,597,656,699,635,690,567,491,163,34,1344,3935,1255,25.46,74.54,23.77
E02006750,Wychavon 003,5442,509,405,586,628,613,701,716,704,436,144,914,4528,2000,16.8,83.2,36.75
E02006751,Wychavon 004,5991,590,591,595,567,781,902,751,745,364,105,1181,4810,1965,19.71,80.29,32.8
E02006752,Wychavon 005,7467,793,676,874,709,966,1160,995,882,359,53,1469,5998,2289,19.67,80.33,30.65
E02006753,Wychavon 006,6885,706,660,640,652,844,1124,979,862,348,70,1366,5519,2259,19.84,80.16,32.81
E02006754,Wychavon 007,5672,535,494,546,403,726,988,856,808,278,38,1029,4643,1980,18.14,81.86,34.91
E02006755,Wychavon 008,5721,477,465,428,414,645,1039,935,883,369,66,942,4779,2253,16.47,83.53,39.38
E02006756,Wychavon 009,6317,781,625,703,723,841,1025,732,539,235,113,1406,4911,1619,22.26,77.74,25.63
E02006757,Wychavon 010,7081,540,575,625,471,755,1231,1243,1033,490,118,1115,5966,2884,15.75,84.25,40.73
E02006758,Wychavon 011,6025,589,466,699,610,755,1094,822,698,245,47,1055,4970,1812,17.51,82.49,30.07
E02006759,Wychavon 012,8096,859,635,827,751,870,1119,1147,1125,583,180,1494,6602,3035,18.45,81.55,37.49
E02006760,Wychavon 013,9214,986,726,968,978,1087,1421,1296,1098,509,145,1712,7502,3048,18.58,81.42,33.08
E02006761,Wychavon 014,6695,729,478,1106,1242,872,817,647,434,266,104,1207,5488,1451,18.03,81.97,21.67
E02006762,Wychavon 015,6820,788,642,857,774,921,975,749,727,320,67,1430,5390,1863,20.97,79.03,27.32
E02006763,Wychavon 016,8708,1170,832,1092,1229,1099,1193,950,717,371,55,2002,6706,2093,22.99,77.01,24.04
E02006764,Wychavon 017,6105,763,505,876,950,839,821,648,452,194,57,1268,4837,1351,20.77,79.23,22.13
E02006765,Wychavon 018,6193,498,395,550,430,619,1000,1056,978,523,144,893,5300,2701,14.42,85.58,43.61
E02006766,Wychavon 019,7737,573,734,589,532,911,1361,1326,1143,474,94,1307,6430,3037,16.89,83.11,39.25
E02006767,Wyre Forest 001,9106,815,883,911,747,1079,1493,1234,1267,550,127,1698,7408,3178,18.65,81.35,34.9
E02006768,Wyre Forest 002,6883,807,540,792,769,848,954,797,933,360,83,1347,5536,2173,19.57,80.43,31.57
E02006769,Wyre Forest 003,7010,721,613,909,842,916,1006,820,754,357,72,1334,5676,2003,19.03,80.97,28.57
E02006770,Wyre Forest 004,8542,1340,709,1531,1341,1119,981,685,565,197,74,2049,6493,1521,23.99,76.01,17.81
E02006771,Wyre Forest 005,6834,593,529,626,586,777,1142,1091,1025,400,65,1122,5712,2581,16.42,83.58,37.77
E02006772,Wyre Forest 006,6552,660,515,746,678,861,971,777,794,447,103,1175,5377,2121,17.93,82.07,32.37
E02006773,Wyre Forest 007,8439,904,682,1015,992,982,1058,1099,1104,487,116,1586,6853,2806,18.79,81.21,33.25
E02006774,Wyre Forest 008,7579,925,640,1124,941,1021,1086,827,682,291,42,1565,6014,1842,20.65,79.35,24.3
E02006775,Wyre Forest 009,6073,930,639,884,860,688,767,576,475,202,52,1569,4504,1305,25.84,74.16,21.49
E02006776,Wyre Forest 010,6419,666,474,756,698,781,1010,944,774,251,65,1140,5279,2034,17.76,82.24,31.69
E02006777,Wyre Forest 011,7054,514,515,581,540,790,1127,1204,1105,582,96,1029,6025,2987,14.59,85.41,42.34
E02006778,Wyre Forest 012,7014,809,636,723,737,836,1050,801,866,450,106,1445,5569,2223,20.6,79.4,31.69
E02006779,Wyre Forest 013,7931,771,647,959,798,1021,1229,1018,987,436,65,1418,6513,2506,17.88,82.12,31.6
E02006780,Wyre Forest 014,5855,638,426,614,580,659,769,841,928,312,88,1064,4791,2169,18.17,81.83,37.05
E02004924,St Albans 001,7931,1190,1104,727,689,1426,1175,685,598,267,70,2294,5637,1620,28.92,71.08,20.43
E02004925,St Albans 002,7968,1209,1190,660,851,1374,1114,669,490,305,106,2399,5569,1570,30.11,69.89,19.7
E02004926,St Albans 003,8143,1161,953,755,799,1309,1207,674,690,484,111,2114,6029,1959,25.96,74.04,24.06
E02004927,St Albans 004,6536,882,767,574,607,963,959,704,641,378,61,1649,4887,1784,25.23,74.77,27.29
E02004928,St Albans 005,6752,890,773,534,591,1025,1053,806,629,385,66,1663,5089,1886,24.63,75.37,27.93
E02004929,St Albans 006,6403,785,727,546,670,939,935,660,701,341,99,1512,4891,1801,23.61,76.39,28.13
E02004930,St Albans 007,6944,815,787,780,806,1071,1067,718,534,287,79,1602,5342,1618,23.07,76.93,23.3
E02004931,St Albans 008,6748,857,887,663,738,1036,954,695,478,362,78,1744,5004,1613,25.84,74.16,23.9
E02004932,St Albans 009,7788,1263,949,799,1091,1298,996,690,450,191,61,2212,5576,1392,28.4,71.6,17.87
E02004933,St Albans 010,7001,1019,930,635,766,1159,1021,694,450,268,59,1949,5052,1471,27.84,72.16,21.01
E02004934,St Albans 011,8235,1183,748,1125,1685,1329,936,584,325,259,61,1931,6304,1229,23.45,76.55,14.92
E02004935,St Albans 012,9085,1330,479,1480,2281,1341,975,621,317,199,62,1809,7276,1199,19.91,80.09,13.2
E02004936,St Albans 013,6525,1005,825,725,898,1126,890,497,370,155,34,1830,4695,1056,28.05,71.95,16.18
E02004937,St Albans 014,7357,951,685,573,781,1123,986,786,841,469,162,1636,5721,2258,22.24,77.76,30.69
E02004938,St Albans 015,6418,802,818,727,742,1101,984,574,429,211,30,1620,4798,1244,25.24,74.76,19.38
E02004939,St Albans 016,6990,959,743,780,1034,1092,877,603,495,324,83,1702,5288,1505,24.35,75.65,21.53
E02004940,St Albans 017,7579,1175,768,859,1257,1241,906,621,414,240,98,1943,5636,1373,25.64,74.36,18.12
E02004941,St Albans 018,9728,1221,1036,1291,1352,1489,1386,980,610,308,55,2257,7471,1953,23.2,76.8,20.08
E02004942,St Albans 019,6445,736,650,704,684,894,945,722,699,333,78,1386,5059,1832,21.51,78.49,28.43
E02004943,St Albans 020,7876,897,748,844,700,1046,1205,931,916,479,110,1645,6231,2436,20.89,79.11,30.93
E02004980,Welwyn Hatfield 001,6360,567,623,659,503,809,1057,803,720,446,173,1190,5170,2142,18.71,81.29,33.68
E02004981,Welwyn Hatfield 002,7949,941,799,980,1074,1170,1091,798,634,373,89,1740,6209,1894,21.89,78.11,23.83
E02004982,Welwyn Hatfield 003,6059,820,642,669,630,858,945,602,516,317,60,1462,4597,1495,24.13,75.87,24.67
E02004983,Welwyn Hatfield 004,6151,880,561,799,869,829,780,637,462,282,52,1441,4710,1433,23.43,76.57,23.3
E02004984,Welwyn Hatfield 005,6452,759,484,856,1002,783,895,854,461,257,101,1243,5209,1673,19.27,80.73,25.93
E02004985,Welwyn Hatfield 006,7078,739,614,861,794,845,1006,768,758,530,163,1353,5725,2219,19.12,80.88,31.35
E02004986,Welwyn Hatfield 007,8215,1262,929,1406,1472,1086,971,579,307,166,37,2191,6024,1089,26.67,73.33,13.26
E02004987,Welwyn Hatfield 008,7523,1199,745,974,1205,1041,960,638,426,269,66,1944,5579,1399,25.84,74.16,18.6
E02004988,Welwyn Hatfield 009,8020,1323,838,1144,1338,1090,955,619,420,253,40,2161,5859,1332,26.95,73.05,16.61
E02004989,Welwyn Hatfield 010,14303,1345,1196,5837,1966,1350,1073,717,499,237,83,2541,11762,1536,17.77,82.23,10.74
E02004990,Welwyn Hatfield 011,7346,830,547,1367,1259,923,863,664,476,314,103,1377,5969,1557,18.74,81.26,21.2
E02004991,Welwyn Hatfield 012,9070,1198,609,2655,1744,896,861,515,305,223,64,1807,7263,1107,19.92,80.08,12.21
E02004992,Welwyn Hatfield 013,11480,1198,704,5198,1569,866,795,482,357,257,54,1902,9578,1150,16.57,83.43,10.02
E02004993,Welwyn Hatfield 014,5732,674,392,1096,705,657,755,632,509,249,63,1066,4666,1453,18.6,81.4,25.35
E02004994,Welwyn Hatfield 015,5960,621,656,795,480,724,923,737,634,321,69,1277,4683,1761,21.43,78.57,29.55
E02004995,Welwyn Hatfield 016,5345,501,483,616,420,669,854,733,635,369,65,984,4361,1802,18.41,81.59,33.71
E02004878,East Hertfordshire 001,8362,1084,817,876,863,1102,1344,957,876,339,104,1901,6461,2276,22.73,77.27,27.22
E02004879,East Hertfordshire 002,8271,939,804,790,792,1106,1451,1070,874,377,68,1743,6528,2389,21.07,78.93,28.88
E02004880,East Hertfordshire 003,9519,1075,1074,952,924,1389,1785,1102,774,371,73,2149,7370,2320,22.58,77.42,24.37
E02004881,East Hertfordshire 004,6672,751,600,953,929,1001,843,618,485,417,75,1351,5321,1595,20.25,79.75,23.91
E02004882,East Hertfordshire 005,8989,1021,1270,1232,1197,1356,1177,742,614,324,56,2291,6698,1736,25.49,74.51,19.31
E02004883,East Hertfordshire 006,6168,717,656,689,662,854,967,674,638,260,51,1373,4795,1623,22.26,77.74,26.31
E02004884,East Hertfordshire 007,10878,1331,977,1572,1819,1647,1485,983,636,360,68,2308,8570,2047,21.22,78.78,18.82
E02004885,East Hertfordshire 008,8529,1035,992,960,890,1398,1502,833,593,273,53,2027,6502,1752,23.77,76.23,20.54
E02004886,East Hertfordshire 009,6502,799,610,629,752,907,1003,788,599,351,64,1409,5093,1802,21.67,78.33,27.71
E02004887,East Hertfordshire 010,7683,835,755,740,789,1067,1238,1066,792,351,50,1590,6093,2259,20.7,79.3,29.4
E02004888,East Hertfordshire 011,9071,1035,844,925,1039,1301,1357,1117,924,439,90,1879,7192,2570,20.71,79.29,28.33
E02004889,East Hertfordshire 012,11532,1554,1051,1373,1584,1784,1565,987,846,616,172,2605,8927,2621,22.59,77.41,22.73
E02004890,East Hertfordshire 013,8560,904,689,1117,1120,1255,1348,980,703,381,63,1593,6967,2127,18.61,81.39,24.85
E02004891,East Hertfordshire 014,8089,1099,763,732,1053,1215,1135,859,746,396,91,1862,6227,2092,23.02,76.98,25.86
E02004892,East Hertfordshire 015,5693,836,550,682,782,808,881,541,345,200,68,1386,4307,1154,24.35,75.65,20.27
E02004893,East Hertfordshire 016,5983,848,670,766,878,964,981,457,312,80,27,1518,4465,876,25.37,74.63,14.64
E02004894,East Hertfordshire 017,9674,1170,769,1399,1488,1513,1284,858,672,389,132,1939,7735,2051,20.04,79.96,21.2
E02004895,East Hertfordshire 018,9573,985,1242,1134,1090,1257,1455,1092,900,318,100,2227,7346,2410,23.26,76.74,25.17
E02004944,Stevenage 001,7642,1240,850,1127,1229,1029,967,610,420,147,23,2090,5552,1200,27.35,72.65,15.7
E02004945,Stevenage 002,12288,1473,1145,1844,1843,1659,1682,1190,865,469,118,2618,9670,2642,21.31,78.69,21.5
E02004946,Stevenage 003,6340,826,611,841,900,811,961,643,446,247,54,1437,4903,1390,22.67,77.33,21.92
E02004947,Stevenage 004,6147,667,490,739,862,815,1098,725,474,249,28,1157,4990,1476,18.82,81.18,24.01
E02004948,Stevenage 005,6025,773,458,914,900,743,785,735,444,220,53,1231,4794,1452,20.43,79.57,24.1
E02004949,Stevenage 006,8797,1118,740,1291,1419,1084,1118,751,699,436,141,1858,6939,2027,21.12,78.88,23.04
E02004950,Stevenage 007,6816,1068,700,908,1022,833,944,603,448,256,34,1768,5048,1341,25.94,74.06,19.67
E02004951,Stevenage 008,7955,1199,730,1364,1368,946,955,619,419,279,76,1929,6026,1393,24.25,75.75,17.51
E02004952,Stevenage 009,6671,881,639,883,930,880,1002,711,391,282,72,1520,5151,1456,22.79,77.21,21.83
E02004953,Stevenage 010,6378,977,642,876,1021,797,911,519,380,211,44,1619,4759,1154,25.38,74.62,18.09
E02004954,Stevenage 011,6923,971,673,977,1110,804,959,643,442,279,65,1644,5279,1429,23.75,76.25,20.64
E02004955,Stevenage 012,5863,765,577,709,806,742,880,688,387,271,38,1342,4521,1384,22.89,77.11,23.61
E02006287,Suffolk Coastal 001,6179,481,461,407,430,569,981,1260,1044,433,113,942,5237,2850,15.25,84.75,46.12
E02006288,Suffolk Coastal 002,9562,816,1078,894,627,1201,1538,1426,1229,622,131,1894,7668,3408,19.81,80.19,35.64
E02006289,Suffolk Coastal 003,9527,1008,824,950,786,988,1497,1412,1327,627,108,1832,7695,3474,19.23,80.77,36.46
E02006290,Suffolk Coastal 004,8129,706,617,852,781,811,1145,1208,1211,610,188,1323,6806,3217,16.28,83.72,39.57
E02006291,Suffolk Coastal 005,7681,785,614,706,682,800,1187,1263,1046,490,108,1399,6282,2907,18.21,81.79,37.85
E02006292,Suffolk Coastal 006,6857,601,738,543,438,967,1143,1118,851,385,73,1339,5518,2427,19.53,80.47,35.39
E02006293,Suffolk Coastal 007,11451,1121,993,1580,1359,1382,1806,1492,1167,438,113,2114,9337,3210,18.46,81.54,28.03
E02006294,Suffolk Coastal 008,8228,684,791,754,663,858,1148,1084,1204,790,252,1475,6753,3330,17.93,82.07,40.47
E02006295,Suffolk Coastal 009,9796,1058,1013,1053,1013,1234,1356,1105,1147,662,155,2071,7725,3069,21.14,78.86,31.33
E02006296,Suffolk Coastal 010,13489,1592,1427,1476,1468,1984,1883,1574,1316,648,121,3019,10470,3659,22.38,77.62,27.13
E02006297,Suffolk Coastal 011,8226,695,829,851,644,1005,1452,1128,945,580,97,1524,6702,2750,18.53,81.47,33.43
E02006298,Suffolk Coastal 012,9290,1013,753,1032,989,1121,1452,1410,1050,402,68,1766,7524,2930,19.01,80.99,31.54
E02006299,Suffolk Coastal 013,8381,558,596,639,516,792,1227,1459,1557,849,188,1154,7227,4053,13.77,86.23,48.36
E02006300,Suffolk Coastal 014,7781,879,776,1040,881,956,1127,930,791,319,82,1655,6126,2122,21.27,78.73,27.27
E02006301,Suffolk Coastal 015,6451,588,494,702,655,822,929,871,761,430,199,1082,5369,2261,16.77,83.23,35.05
E02006302,Waveney 001,6742,495,466,675,556,731,1009,1138,1104,443,125,961,5781,2810,14.25,85.75,41.68
E02006303,Waveney 002,8152,999,939,1085,1009,1058,1075,819,743,357,68,1938,6214,1987,23.77,76.23,24.37
E02006304,Waveney 003,7774,796,597,794,697,749,1105,1088,1256,570,122,1393,6381,3036,17.92,82.08,39.05
E02006305,Waveney 004,10024,1442,969,1648,1448,1239,1400,843,730,255,50,2411,7613,1878,24.05,75.95,18.74
E02006306,Waveney 005,7510,896,637,869,927,746,1004,904,979,442,106,1533,5977,2431,20.41,79.59,32.37
E02006307,Waveney 006,7303,581,612,671,565,786,1015,1113,1197,608,155,1193,6110,3073,16.34,83.66,42.08
E02006308,Waveney 007,7736,892,688,1194,974,962,1130,905,604,290,97,1580,6156,1896,20.42,79.58,24.51
E02006309,Waveney 008,6899,716,633,829,654,718,923,886,852,563,125,1349,5550,2426,19.55,80.45,35.16
E02006310,Waveney 009,8522,1053,865,1090,1077,1013,1250,852,862,376,84,1918,6604,2174,22.51,77.49,25.51
E02006311,Waveney 010,8471,834,752,963,850,900,1081,1121,1167,629,174,1586,6885,3091,18.72,81.28,36.49
E02006312,Waveney 011,8830,878,795,995,768,1055,1354,1211,1179,531,64,1673,7157,2985,18.95,81.05,33.81
E02006313,Waveney 012,10033,898,812,1025,912,1091,1425,1510,1555,685,120,1710,8323,3870,17.04,82.96,38.57
E02006314,Waveney 013,7383,733,576,837,694,853,1039,1128,928,471,124,1309,6074,2651,17.73,82.27,35.91
E02006315,Waveney 014,5848,431,436,534,405,512,865,1048,956,515,146,867,4981,2665,14.83,85.17,45.57
E02006316,Waveney 015,7206,678,517,718,602,653,1022,1076,1141,655,144,1195,6011,3016,16.58,83.42,41.85
E02006238,Forest Heath 001,9785,1257,707,1188,1240,988,1285,1275,1199,530,116,1964,7821,3120,20.07,79.93,31.89
E02006239,Forest Heath 002,7719,1221,531,2235,1015,531,686,612,570,260,58,1752,5967,1500,22.7,77.3,19.43
E02006240,Forest Heath 003,10485,2143,1039,1771,1467,933,1157,958,684,280,53,3182,7303,1975,30.35,69.65,18.84
E02006241,Forest Heath 004,9054,1284,767,1302,1242,918,1130,974,854,463,120,2051,7003,2411,22.65,77.35,26.63
E02006242,Forest Heath 005,9994,1859,853,1468,1690,1065,1153,841,644,316,105,2712,7282,1906,27.14,72.86,19.07
E02006243,Forest Heath 006,8966,1250,686,1218,1529,1022,1232,915,703,316,95,1936,7030,2029,21.59,78.41,22.63
E02006273,St Edmundsbury 001,6726,699,560,610,641,728,1063,997,933,417,78,1259,5467,2425,18.72,81.28,36.05
E02006274,St Edmundsbury 002,6820,813,554,1171,899,722,966,690,636,295,74,1367,5453,1695,20.04,79.96,24.85
E02006275,St Edmundsbury 003,7142,921,804,988,948,879,1003,619,623,276,81,1725,5417,1599,24.15,75.85,22.39
E02006276,St Edmundsbury 004,6874,668,582,559,586,761,1024,1001,1012,523,158,1250,5624,2694,18.18,81.82,39.19
E02006277,St Edmundsbury 005,7994,1059,865,1025,1287,1236,1106,703,501,186,26,1924,6070,1416,24.07,75.93,17.71
E02006278,St Edmundsbury 006,8793,700,631,1434,1376,1029,1170,937,852,525,139,1331,7462,2453,15.14,84.86,27.9
E02006279,St Edmundsbury 007,8825,888,744,941,1004,1070,1263,1078,1131,572,134,1632,7193,2915,18.49,81.51,33.03
E02006280,St Edmundsbury 008,9789,974,1065,883,925,1142,1500,1286,1254,620,140,2039,7750,3300,20.83,79.17,33.71
E02006281,St Edmundsbury 009,8800,723,677,1007,925,1019,1070,1064,1218,802,295,1400,7400,3379,15.91,84.09,38.4
E02006282,St Edmundsbury 010,6368,558,553,507,482,717,1032,990,979,430,120,1111,5257,2519,17.45,82.55,39.56
E02006283,St Edmundsbury 011,7626,670,544,960,1130,1022,1150,912,867,316,55,1214,6412,2150,15.92,84.08,28.19
E02006284,St Edmundsbury 012,7933,1101,728,975,1148,943,1053,819,737,370,59,1829,6104,1985,23.06,76.94,25.02
E02006285,St Edmundsbury 013,7773,1084,903,984,1228,1079,1112,640,499,187,57,1987,5786,1383,25.56,74.44,17.79
E02006286,St Edmundsbury 014,11775,1559,1224,1681,1744,1583,1448,1068,919,431,118,2783,8992,2536,23.63,76.37,21.54
E02006826,Forest Heath 008,9804,1200,666,1494,1669,1049,1247,1031,819,515,114,1866,7938,2479,19.03,80.97,25.29
E02006099,Taunton Deane 001,6974,778,770,674,673,971,1042,969,711,298,88,1548,5426,2066,22.2,77.8,29.62
E02006100,Taunton Deane 002,7854,828,948,875,872,994,1168,937,776,383,73,1776,6078,2169,22.61,77.39,27.62
E02006101,Taunton Deane 003,5712,487,527,507,465,643,984,909,734,367,89,1014,4698,2099,17.75,82.25,36.75
E02006102,Taunton Deane 004,6872,789,657,837,894,811,974,863,604,351,92,1446,5426,1910,21.04,78.96,27.79
E02006103,Taunton Deane 005,7877,849,737,641,628,978,1188,1170,1120,472,94,1586,6291,2856,20.13,79.87,36.26
E02006104,Taunton Deane 006,9996,1437,941,1226,1479,1333,1401,1033,785,297,64,2378,7618,2179,23.79,76.21,21.8
E02006105,Taunton Deane 007,11347,1301,781,2008,1926,1471,1443,1054,785,468,110,2082,9265,2417,18.35,81.65,21.3
E02006106,Taunton Deane 008,9728,1253,806,1573,1355,1169,1230,1024,774,414,130,2059,7669,2342,21.17,78.83,24.07
E02006107,Taunton Deane 009,8492,1225,857,1053,1190,1015,1112,984,631,316,109,2082,6410,2040,24.52,75.48,24.02
E02006108,Taunton Deane 010,8912,818,664,1267,1124,1010,1130,925,982,743,249,1482,7430,2899,16.63,83.37,32.53
E02006109,Taunton Deane 011,8082,854,738,815,705,992,1134,1017,1061,631,135,1592,6490,2844,19.7,80.3,35.19
E02006110,Taunton Deane 012,9640,1287,829,1210,1228,1157,1348,1156,858,465,102,2116,7524,2581,21.95,78.05,26.77
E02006111,Taunton Deane 013,10683,937,950,984,860,1187,1645,1590,1594,714,222,1887,8796,4120,17.66,82.34,38.57
E02006112,Taunton Deane 014,7871,618,808,685,618,849,1320,1289,1010,491,183,1426,6445,2973,18.12,81.88,37.77
E02006113,West Somerset 001,7475,746,531,831,650,683,1065,1022,1071,653,223,1277,6198,2969,17.08,82.92,39.72
E02006114,West Somerset 002,6600,433,428,784,651,499,887,1143,1087,565,123,861,5739,2918,13.05,86.95,44.21
E02006115,West Somerset 003,7429,727,529,751,600,619,1104,1394,1133,490,82,1256,6173,3099,16.91,83.09,41.71
E02006116,West Somerset 004,7993,628,585,650,516,795,1309,1460,1302,594,154,1213,6780,3510,15.18,84.82,43.91
E02006117,West Somerset 005,5578,353,351,465,346,422,1021,1107,970,452,91,704,4874,2620,12.62,87.38,46.97
E02000984,Bolton 001,7510,799,675,841,830,1037,1239,913,844,289,43,1474,6036,2089,19.63,80.37,27.82
E02000985,Bolton 002,7255,622,691,776,598,890,1186,947,989,485,71,1313,5942,2492,18.1,81.9,34.35
E02000986,Bolton 003,8506,897,792,1224,1090,1039,1272,897,781,418,96,1689,6817,2192,19.86,80.14,25.77
E02000987,Bolton 004,7205,686,572,1048,926,888,1155,788,717,340,85,1258,5947,1930,17.46,82.54,26.79
E02000988,Bolton 005,8898,1211,932,1397,1309,1178,1095,832,590,289,65,2143,6755,1776,24.08,75.92,19.96
E02000989,Bolton 006,8127,782,645,773,799,943,1192,1075,1243,603,72,1427,6700,2993,17.56,82.44,36.83
E02000990,Bolton 007,7897,921,668,991,1012,1021,1212,969,764,294,45,1589,6308,2072,20.12,79.88,26.24
E02000991,Bolton 008,7650,954,691,1100,1010,938,1107,859,634,281,76,1645,6005,1850,21.5,78.5,24.18
E02000992,Bolton 009,6046,728,467,700,698,772,919,682,684,347,49,1195,4851,1762,19.77,80.23,29.14
E02000993,Bolton 010,8251,1428,937,1422,1263,972,948,677,375,193,36,2365,5886,1281,28.66,71.34,15.53
E02000994,Bolton 011,8467,1426,941,1337,1353,1067,1006,664,468,177,28,2367,6100,1337,27.96,72.04,15.79
E02000995,Bolton 012,8199,1104,913,985,928,1007,1111,923,739,392,97,2017,6182,2151,24.6,75.4,26.23
E02000996,Bolton 013,8503,1424,1026,1249,1217,985,1023,687,520,281,91,2450,6053,1579,28.81,71.19,18.57
E02000997,Bolton 014,6115,722,477,740,740,784,920,746,643,262,81,1199,4916,1732,19.61,80.39,28.32
E02000998,Bolton 015,9566,1650,1014,1754,1490,1193,1018,730,471,196,50,2664,6902,1447,27.85,72.15,15.13
E02000999,Bolton 016,8158,1093,811,1675,1105,1072,960,692,464,215,71,1904,6254,1442,23.34,76.66,17.68
E02001000,Bolton 017,9306,1181,797,1492,1364,1082,1187,959,743,422,79,1978,7328,2203,21.26,78.74,23.67
E02001001,Bolton 018,8900,1370,1002,1405,1205,1119,1159,804,483,280,73,2372,6528,1640,26.65,73.35,18.43
E02001002,Bolton 019,9703,1378,968,1249,1287,1163,1318,1091,867,335,47,2346,7357,2340,24.18,75.82,24.12
E02001003,Bolton 020,7355,777,732,828,717,887,1027,960,899,416,112,1509,5846,2387,20.52,79.48,32.45
E02001004,Bolton 021,8688,1599,1122,1338,1253,1161,908,705,402,159,41,2721,5967,1307,31.32,68.68,15.04
E02001005,Bolton 022,9014,1494,1072,1732,1387,1071,901,707,392,221,37,2566,6448,1357,28.47,71.53,15.05
E02001006,Bolton 023,8349,1591,923,1350,1315,1091,888,593,396,178,24,2514,5835,1191,30.11,69.89,14.27
E02001007,Bolton 024,9933,1025,899,1169,1023,1358,1398,1296,1311,401,53,1924,8009,3061,19.37,80.63,30.82
E02001008,Bolton 025,8813,1756,1195,1374,1334,1082,839,606,369,196,62,2951,5862,1233,33.48,66.52,13.99
E02001009,Bolton 026,7391,1185,785,950,1059,880,911,689,608,272,52,1970,5421,1621,26.65,73.35,21.93
E02001010,Bolton 027,6199,1023,663,1109,930,787,764,516,258,129,20,1686,4513,923,27.2,72.8,14.89
E02001011,Bolton 028,9695,1074,771,1238,1223,1270,1435,1265,957,405,57,1845,7850,2684,19.03,80.97,27.68
E02001012,Bolton 029,8436,1337,1099,1285,1124,1026,1022,744,570,190,39,2436,6000,1543,28.88,71.12,18.29
E02001013,Bolton 030,6147,692,527,778,672,826,915,645,723,323,46,1219,4928,1737,19.83,80.17,28.26
E02001014,Bolton 031,8029,910,719,1103,1046,1009,1195,949,743,292,63,1629,6400,2047,20.29,79.71,25.5
E02001015,Bolton 032,8323,995,652,1278,1155,937,1159,878,791,390,88,1647,6676,2147,19.79,80.21,25.8
E02001016,Bolton 033,8543,1342,1068,1278,1209,1176,1022,669,545,200,34,2410,6133,1448,28.21,71.79,16.95
E02001017,Bolton 034,10855,1305,1082,1539,1489,1408,1625,1048,935,377,47,2387,8468,2407,21.99,78.01,22.17
E02001018,Bolton 035,7518,871,705,991,945,1056,1276,889,567,200,18,1576,5942,1674,20.96,79.04,22.27
E02001019,Bury 001,8969,990,960,1149,1092,1294,1342,969,799,327,47,1950,7019,2142,21.74,78.26,23.88
E02001020,Bury 002,5810,534,559,461,478,751,836,809,900,385,97,1093,4717,2191,18.81,81.19,37.71
E02001021,Bury 003,7484,748,680,817,723,1023,1325,973,774,336,85,1428,6056,2168,19.08,80.92,28.97
E02001022,Bury 004,7893,863,731,993,923,919,1161,940,842,430,91,1594,6299,2303,20.2,79.8,29.18
E02001023,Bury 005,5711,644,584,713,658,719,776,716,678,202,21,1228,4483,1617,21.5,78.5,28.31
E02001024,Bury 006,8185,902,819,1004,1018,1105,1246,911,807,312,61,1721,6464,2091,21.03,78.97,25.55
E02001025,Bury 007,8034,1266,832,1189,1103,947,1044,782,536,278,57,2098,5936,1653,26.11,73.89,20.58
E02001026,Bury 008,10725,1743,1175,1907,1813,1350,1195,779,479,237,47,2918,7807,1542,27.21,72.79,14.38
E02001027,Bury 009,7412,1063,650,1225,1175,1009,973,568,473,214,62,1713,5699,1317,23.11,76.89,17.77
E02001028,Bury 010,7232,662,594,670,595,834,1095,1001,1166,508,107,1256,5976,2782,17.37,82.63,38.47
E02001029,Bury 011,7600,1034,845,1295,1106,987,968,677,437,204,47,1879,5721,1365,24.72,75.28,17.96
E02001030,Bury 012,5854,590,558,727,685,758,1052,703,549,183,49,1148,4706,1484,19.61,80.39,25.35
E02001031,Bury 013,6627,826,608,982,848,857,943,712,598,225,28,1434,5193,1563,21.64,78.36,23.59
E02001032,Bury 014,7703,902,706,1143,942,892,1077,854,772,355,60,1608,6095,2041,20.87,79.13,26.5
E02001033,Bury 015,6032,854,549,1025,929,713,885,500,389,158,30,1403,4629,1077,23.26,76.74,17.85
E02001034,Bury 016,8471,1166,737,1450,1303,1022,1128,771,586,255,53,1903,6568,1665,22.46,77.54,19.66
E02001035,Bury 017,6921,740,640,769,704,849,1098,804,823,420,74,1380,5541,2121,19.94,80.06,30.65
E02001036,Bury 018,7727,1077,841,1163,1152,951,1014,750,541,205,33,1918,5809,1529,24.82,75.18,19.79
E02001037,Bury 019,6993,774,581,659,803,931,993,915,799,440,98,1355,5638,2252,19.38,80.62,32.2
E02001038,Bury 020,5809,661,460,841,932,730,809,590,472,269,45,1121,4688,1376,19.3,80.7,23.69
E02001039,Bury 021,8484,1129,1029,1327,1260,1120,1104,672,533,282,28,2158,6326,1515,25.44,74.56,17.86
E02001040,Bury 022,6159,717,540,711,846,801,932,727,570,262,53,1257,4902,1612,20.41,79.59,26.17
E02001041,Bury 023,7702,889,641,1124,1332,999,1029,770,507,324,87,1530,6172,1688,19.86,80.14,21.92
E02001042,Bury 024,6412,787,534,876,872,873,922,662,565,251,70,1321,5091,1548,20.6,79.4,24.14
E02001043,Bury 025,5473,699,487,675,808,739,789,535,401,225,115,1186,4287,1276,21.67,78.33,23.31
E02001044,Bury 026,9568,2180,1509,1213,1276,1023,894,758,481,189,45,3689,5879,1473,38.56,61.44,15.4
E02001045,Manchester 001,8199,1297,881,1148,1154,973,1011,805,604,264,62,2178,6021,1735,26.56,73.44,21.16
E02001046,Manchester 002,10414,1775,1154,1610,1691,1274,1254,818,542,248,48,2929,7485,1656,28.13,71.87,15.9
E02001047,Manchester 003,9954,1517,1069,1423,1487,1273,1360,867,636,285,37,2586,7368,1825,25.98,74.02,18.33
E02001048,Manchester 004,9028,1529,934,1378,1512,1082,1037,733,514,252,57,2463,6565,1556,27.28,72.72,17.24
E02001049,Manchester 005,9687,1309,965,1400,1332,1096,1414,1006,730,344,91,2274,7413,2171,23.47,76.53,22.41
E02001050,Manchester 006,8563,1456,957,1346,1457,1202,929,620,412,152,32,2413,6150,1216,28.18,71.82,14.2
E02001051,Manchester 007,8997,1512,1075,1257,1261,1192,1158,760,463,270,49,2587,6410,1542,28.75,71.25,17.14
E02001052,Manchester 008,14201,2768,1715,2315,2554,1858,1198,904,471,326,92,4483,9718,1793,31.57,68.43,12.63
E02001053,Manchester 009,11134,2062,1381,1692,1734,1429,1351,769,484,201,31,3443,7691,1485,30.92,69.08,13.34
E02001055,Manchester 011,9191,1620,887,1393,1375,1019,1128,865,590,242,72,2507,6684,1769,27.28,72.72,19.25
E02001056,Manchester 012,8317,1501,1122,1177,1141,1033,980,677,474,187,25,2623,5694,1363,31.54,68.46,16.39
E02001057,Manchester 013,11419,1137,725,3601,2881,1037,902,596,344,159,37,1862,9557,1136,16.31,83.69,9.95
E02001059,Manchester 015,11967,2259,1182,2316,2162,1408,1199,774,457,178,32,3441,8526,1441,28.75,71.25,12.04
E02001061,Manchester 017,9966,1694,1191,1431,1513,1201,1265,858,553,226,34,2885,7081,1671,28.95,71.05,16.77
E02001062,Manchester 018,11031,1518,1060,3848,1728,1124,862,470,276,119,26,2578,8453,891,23.37,76.63,8.08
E02001063,Manchester 019,14646,1089,767,8709,2015,883,595,325,159,77,27,1856,12790,588,12.67,87.33,4.01
E02001064,Manchester 020,10326,1900,1274,1601,1730,1284,1169,720,389,220,39,3174,7152,1368,30.74,69.26,13.25
E02001065,Manchester 021,9671,1856,1018,1498,1524,1237,1138,697,452,222,29,2874,6797,1400,29.72,70.28,14.48
E02001066,Manchester 022,13097,1190,1098,6293,1789,1053,762,452,265,143,52,2288,10809,912,17.47,82.53,6.96
E02001067,Manchester 023,11124,2176,1415,1731,1888,1475,1188,625,388,202,36,3591,7533,1251,32.28,67.72,11.25
E02001068,Manchester 024,10629,2027,1558,2123,1665,1188,986,499,304,243,36,3585,7044,1082,33.73,66.27,10.18
E02001069,Manchester 025,12706,1927,1099,4628,2267,1122,721,477,288,147,30,3026,9680,942,23.82,76.18,7.41
E02001070,Manchester 026,12950,973,933,6882,1498,935,716,511,304,157,41,1906,11044,1013,14.72,85.28,7.82
E02001071,Manchester 027,14444,2836,1831,2400,2584,2077,1300,728,435,217,36,4667,9777,1416,32.31,67.69,9.8
E02001072,Manchester 028,9038,1119,795,1864,2023,1311,935,538,269,138,46,1914,7124,991,21.18,78.82,10.96
E02001073,Manchester 029,9546,955,638,2025,2021,1185,1213,773,455,237,44,1593,7953,1509,16.69,83.31,15.81
E02001074,Manchester 030,11831,1614,1361,2469,1979,1358,1304,892,452,321,81,2975,8856,1746,25.15,74.85,14.76
E02001075,Manchester 031,8771,1393,970,1568,1789,1228,917,506,269,106,25,2363,6408,906,26.94,73.06,10.33
E02001076,Manchester 032,11948,683,475,8181,931,636,441,322,157,97,25,1158,10790,601,9.69,90.31,5.03
E02001077,Manchester 033,7201,834,528,1358,1404,1002,860,644,343,179,49,1362,5839,1215,18.91,81.09,16.87
E02001078,Manchester 034,10400,1481,1111,1841,1653,1407,1045,850,609,358,45,2592,7808,1862,24.92,75.08,17.9
E02001079,Manchester 035,8880,1095,850,2616,1369,903,875,565,370,179,58,1945,6935,1172,21.9,78.1,13.2
E02001080,Manchester 036,9664,683,441,5235,1232,600,494,431,341,180,27,1124,8540,979,11.63,88.37,10.13
E02001081,Manchester 037,6332,860,452,880,1267,906,907,522,308,174,56,1312,5020,1060,20.72,79.28,16.74
E02001082,Manchester 038,6734,557,335,2529,1384,588,529,405,244,123,40,892,5842,812,13.25,86.75,12.06
E02001083,Manchester 039,8204,748,454,2727,2046,1035,531,351,211,81,20,1202,7002,663,14.65,85.35,8.08
E02001084,Manchester 040,8379,926,607,2545,1347,888,843,626,357,195,45,1533,6846,1223,18.3,81.7,14.6
E02001085,Manchester 041,8372,1447,1110,1253,1312,945,1028,658,423,165,31,2557,5815,1277,30.54,69.46,15.25
E02001086,Manchester 042,6595,778,600,1213,1258,857,784,487,344,209,65,1378,5217,1105,20.89,79.11,16.76
E02001087,Manchester 043,9457,1127,673,1686,1769,1338,1069,822,616,299,58,1800,7657,1795,19.03,80.97,18.98
E02001088,Manchester 044,9059,1474,916,1295,1595,1009,1135,790,512,259,74,2390,6669,1635,26.38,73.62,18.05
E02001089,Manchester 045,7885,1012,683,1385,1275,934,983,777,493,278,65,1695,6190,1613,21.5,78.5,20.46
E02001090,Manchester 046,6496,721,440,844,1110,797,981,738,542,268,55,1161,5335,1603,17.87,82.13,24.68
E02001091,Manchester 047,7965,1002,598,1166,1291,964,1050,878,652,282,82,1600,6365,1894,20.09,79.91,23.78
E02001092,Manchester 048,8498,1303,823,1365,1419,987,1124,732,447,237,61,2126,6372,1477,25.02,74.98,17.38
E02001093,Manchester 049,9379,1560,988,1542,1630,1050,987,748,512,270,92,2548,6831,1622,27.17,72.83,17.29
E02001094,Manchester 050,9615,1858,1091,1446,1691,1064,1046,781,450,157,31,2949,6666,1419,30.67,69.33,14.76
E02001095,Manchester 051,8272,1264,818,1224,1390,955,1099,755,532,179,56,2082,6190,1522,25.17,74.83,18.4
E02001096,Manchester 052,7537,1084,670,1046,1234,882,1016,802,510,241,52,1754,5783,1605,23.27,76.73,21.29
E02001097,Manchester 053,8082,1267,727,1220,1445,881,1078,770,457,179,58,1994,6088,1464,24.67,75.33,18.11
E02006902,Manchester 054,7355,344,317,3181,2098,607,416,262,98,26,6,661,6694,392,8.99,91.01,5.33
E02006912,Manchester 055,18057,285,173,13761,2409,594,327,242,135,106,25,458,17599,508,2.54,97.46,2.81
E02006913,Manchester 056,7404,845,621,2284,1676,748,571,368,195,81,15,1466,5938,659,19.8,80.2,8.9
E02006914,Manchester 057,10813,306,155,8466,1044,401,252,90,37,58,4,461,10352,189,4.26,95.74,1.75
E02006915,Manchester 058,9485,1565,1039,1984,1911,1269,915,472,236,87,7,2604,6881,802,27.45,72.55,8.46
E02006916,Manchester 059,6596,449,201,2900,1713,596,395,184,101,43,14,650,5946,342,9.85,90.15,5.18
E02006917,Manchester 060,7347,238,158,3803,1906,602,354,211,51,22,2,396,6951,286,5.39,94.61,3.89
E02001098,Oldham 001,5851,603,493,645,548,629,846,797,925,314,51,1096,4755,2087,18.73,81.27,35.67
E02001099,Oldham 002,5916,691,476,873,721,725,919,661,569,224,57,1167,4749,1511,19.73,80.27,25.54
E02001100,Oldham 003,5956,613,453,732,702,678,869,747,696,350,116,1066,4890,1909,17.9,82.1,32.05
E02001101,Oldham 004,5530,582,479,578,572,717,833,779,722,216,52,1061,4469,1769,19.19,80.81,31.99
E02001102,Oldham 005,6012,683,502,847,788,761,1021,639,528,201,42,1185,4827,1410,19.71,80.29,23.45
E02001103,Oldham 006,5443,464,453,556,452,763,937,789,674,297,58,917,4526,1818,16.85,83.15,33.4
E02001104,Oldham 007,7169,1038,765,1041,956,994,983,722,497,144,29,1803,5366,1392,25.15,74.85,19.42
E02001105,Oldham 008,6019,581,513,772,672,748,871,733,737,333,59,1094,4925,1862,18.18,81.82,30.94
E02001106,Oldham 009,5768,585,471,838,715,634,879,668,605,299,74,1056,4712,1646,18.31,81.69,28.54
E02001107,Oldham 010,6489,915,790,926,877,789,822,586,525,222,37,1705,4784,1370,26.28,73.72,21.11
E02001108,Oldham 011,5873,1103,671,962,918,626,690,405,323,131,44,1774,4099,903,30.21,69.79,15.38
E02001109,Oldham 012,7665,1042,672,1262,1000,905,1171,781,534,236,62,1714,5951,1613,22.36,77.64,21.04
E02001110,Oldham 013,6463,606,519,645,670,847,1082,902,806,296,90,1125,5338,2094,17.41,82.59,32.4
E02001111,Oldham 014,7635,1273,1024,1195,1138,979,835,573,358,200,60,2297,5338,1191,30.09,69.91,15.6
E02001112,Oldham 015,5716,600,461,699,681,677,902,855,583,222,36,1061,4655,1696,18.56,81.44,29.67
E02001113,Oldham 016,9493,1759,1413,1879,1517,1268,744,488,259,147,19,3172,6321,913,33.41,66.59,9.62
E02001114,Oldham 017,8796,1215,983,1299,1213,1073,1073,809,706,364,61,2198,6598,1940,24.99,75.01,22.06
E02001115,Oldham 018,5848,676,508,854,699,706,886,676,583,211,49,1184,4664,1519,20.25,79.75,25.97
E02001116,Oldham 019,7754,1607,1074,1234,1277,907,678,511,265,155,46,2681,5073,977,34.58,65.42,12.6
E02001117,Oldham 020,6131,643,549,629,642,830,978,768,709,336,47,1192,4939,1860,19.44,80.56,30.34
E02001118,Oldham 021,6030,581,538,683,659,775,986,769,663,309,67,1119,4911,1808,18.56,81.44,29.98
E02001119,Oldham 022,12073,2249,1888,2333,1942,1441,880,717,341,208,74,4137,7936,1340,34.27,65.73,11.1
E02001121,Oldham 024,8919,1814,1402,1656,1411,1079,718,442,255,115,27,3216,5703,839,36.06,63.94,9.41
E02001123,Oldham 026,6941,1141,819,1076,1006,858,815,571,456,173,26,1960,4981,1226,28.24,71.76,17.66
E02001124,Oldham 027,6557,1003,758,1048,951,799,777,567,409,210,35,1761,4796,1221,26.86,73.14,18.62
E02001125,Oldham 028,8139,982,762,1295,1192,926,1156,847,605,320,54,1744,6395,1826,21.43,78.57,22.44
E02001126,Oldham 029,9110,1689,1121,1451,1430,1078,1014,694,408,191,34,2810,6300,1327,30.85,69.15,14.57
E02001127,Oldham 030,7715,1228,986,1196,1092,907,966,692,445,174,29,2214,5501,1340,28.7,71.3,17.37
E02001128,Oldham 031,7699,962,694,1233,1004,930,1056,829,628,314,49,1656,6043,1820,21.51,78.49,23.64
E02001129,Oldham 032,6231,723,550,1101,951,731,815,590,468,262,40,1273,4958,1360,20.43,79.57,21.83
E02001130,Oldham 033,5401,458,467,725,551,642,1002,701,554,257,44,925,4476,1556,17.13,82.87,28.81
E02001131,Oldham 034,5252,623,454,679,601,574,863,545,555,314,44,1077,4175,1458,20.51,79.49,27.76
E02006860,Oldham 035,15516,2868,2284,2835,2449,2059,1245,977,447,288,64,5152,10364,1776,33.2,66.8,11.45
E02001132,Rochdale 001,6488,746,591,860,816,869,957,721,610,251,67,1337,5151,1649,20.61,79.39,25.42
E02001133,Rochdale 002,6503,855,578,753,817,826,971,791,669,214,29,1433,5070,1703,22.04,77.96,26.19
E02001134,Rochdale 003,6340,732,466,756,726,776,1022,819,720,262,61,1198,5142,1862,18.9,81.1,29.37
E02001135,Rochdale 004,8203,1350,1105,1269,1180,1017,898,605,522,212,45,2455,5748,1384,29.93,70.07,16.87
E02001136,Rochdale 005,9277,1123,809,1373,1200,1169,1256,1115,791,357,84,1932,7345,2347,20.83,79.17,25.3
E02001137,Rochdale 006,6125,667,503,813,654,822,992,846,575,211,42,1170,4955,1674,19.1,80.9,27.33
E02001138,Rochdale 007,8557,847,740,993,842,1022,1386,1131,1001,488,107,1587,6970,2727,18.55,81.45,31.87
E02001139,Rochdale 008,9959,1762,1400,1902,1595,1188,824,718,367,168,35,3162,6797,1288,31.75,68.25,12.93
E02001140,Rochdale 009,8310,1288,1004,1274,1251,984,976,713,476,263,81,2292,6018,1533,27.58,72.42,18.45
E02001141,Rochdale 010,12671,1991,1481,2224,1955,1733,1490,963,520,247,67,3472,9199,1797,27.4,72.6,14.18
E02001142,Rochdale 011,5798,595,539,663,566,670,827,778,694,403,63,1134,4664,1938,19.56,80.44,33.43
E02001143,Rochdale 012,11816,1999,1536,2001,1719,1552,1307,842,569,244,47,3535,8281,1702,29.92,70.08,14.4
E02001144,Rochdale 013,6488,749,557,1017,868,746,967,745,585,203,51,1306,5182,1584,20.13,79.87,24.41
E02001145,Rochdale 014,7143,823,655,901,864,963,1045,837,755,255,45,1478,5665,1892,20.69,79.31,26.49
E02001146,Rochdale 015,9988,1709,1343,1808,1508,1297,951,705,356,260,51,3052,6936,1372,30.56,69.44,13.74
E02001147,Rochdale 016,10047,1620,1115,1571,1427,1234,1289,904,583,274,30,2735,7312,1791,27.22,72.78,17.83
E02001148,Rochdale 017,10632,1428,966,1515,1379,1276,1403,1166,993,403,103,2394,8238,2665,22.52,77.48,25.07
E02001149,Rochdale 018,10520,1497,940,1662,1587,1191,1327,1117,772,364,63,2437,8083,2316,23.17,76.83,22.02
E02001150,Rochdale 019,9049,1332,848,1388,1197,1011,1282,972,693,264,62,2180,6869,1991,24.09,75.91,22.0
E02001151,Rochdale 020,10161,1351,875,1451,1300,1288,1446,1089,898,384,79,2226,7935,2450,21.91,78.09,24.11
E02001152,Rochdale 021,9485,1216,841,1485,1375,1174,1292,1044,691,311,56,2057,7428,2102,21.69,78.31,22.16
E02001153,Rochdale 022,11522,1903,1221,1677,1788,1332,1364,1147,684,322,84,3124,8398,2237,27.11,72.89,19.42
E02001154,Rochdale 023,10255,1233,973,1694,1498,1229,1491,1121,656,303,57,2206,8049,2137,21.51,78.49,20.84
E02001155,Rochdale 024,7429,828,601,982,1104,971,1092,897,574,302,78,1429,6000,1851,19.24,80.76,24.92
E02001156,Rochdale 025,9646,1139,829,1159,1118,1153,1445,1191,891,591,130,1968,7678,2803,20.4,79.6,29.06
E02001157,Salford 001,8373,1513,1014,1314,1196,903,928,703,467,293,42,2527,5846,1505,30.18,69.82,17.97
E02001158,Salford 002,6159,989,610,890,825,635,812,672,440,207,79,1599,4560,1398,25.96,74.04,22.7
E02001159,Salford 003,6762,1077,677,1055,1173,879,811,467,430,167,26,1754,5008,1090,25.94,74.06,16.12
E02001160,Salford 004,7137,1348,755,1086,1035,812,799,622,457,193,30,2103,5034,1302,29.47,70.53,18.24
E02001161,Salford 005,5928,634,467,917,853,663,881,705,486,284,38,1101,4827,1513,18.57,81.43,25.52
E02001162,Salford 006,6096,631,534,873,913,702,793,637,635,339,39,1165,4931,1650,19.11,80.89,27.07
E02001163,Salford 007,9488,1077,776,1234,1360,1045,1397,1102,959,458,80,1853,7635,2599,19.53,80.47,27.39
E02001164,Salford 008,7768,1148,722,1399,1529,1008,893,561,375,103,30,1870,5898,1069,24.07,75.93,13.76
E02001165,Salford 009,5968,770,568,870,870,704,872,581,477,211,45,1338,4630,1314,22.42,77.58,22.02
E02001166,Salford 010,7309,1609,1123,1058,808,698,617,632,424,228,112,2732,4577,1396,37.38,62.62,19.1
E02001167,Salford 011,7187,1055,800,1250,1182,803,745,631,443,226,52,1855,5332,1352,25.81,74.19,18.81
E02001168,Salford 012,9582,1340,850,1295,1448,1173,1302,999,726,370,79,2190,7392,2174,22.86,77.14,22.69
E02001169,Salford 013,10370,1234,954,1145,1219,1381,1624,1311,1002,405,95,2188,8182,2813,21.1,78.9,27.13
E02001170,Salford 014,9681,1171,874,904,1266,1329,1382,1027,1026,564,138,2045,7636,2755,21.12,78.88,28.46
E02001171,Salford 015,5913,720,513,714,781,752,861,668,574,267,63,1233,4680,1572,20.85,79.15,26.59
E02001172,Salford 016,15694,3205,1914,2849,2834,1627,1328,890,604,352,91,5119,10575,1937,32.62,67.38,12.34
E02001173,Salford 017,8071,1013,833,2140,1168,936,840,551,391,158,41,1846,6225,1141,22.87,77.13,14.14
E02001174,Salford 018,5576,595,383,1018,908,671,700,603,412,232,54,978,4598,1301,17.54,82.46,23.33
E02001175,Salford 019,7272,1015,738,1066,1189,928,1000,628,458,205,45,1753,5519,1336,24.11,75.89,18.37
E02001176,Salford 020,11467,1281,820,1585,1788,1582,1582,1232,943,546,108,2101,9366,2829,18.32,81.68,24.67
E02001177,Salford 021,13244,1665,1097,2763,2240,1442,1501,1166,808,443,119,2762,10482,2536,20.85,79.15,19.15
E02001178,Salford 022,15136,905,454,6764,3663,1454,994,541,259,82,20,1359,13777,902,8.98,91.02,5.96
E02001179,Salford 023,6765,788,501,1590,1235,681,725,601,404,193,47,1289,5476,1245,19.05,80.95,18.4
E02001180,Salford 024,6545,859,465,1870,1116,727,635,448,286,121,18,1324,5221,873,20.23,79.77,13.34
E02001181,Salford 025,6118,903,603,965,934,751,886,525,362,149,40,1506,4612,1076,24.62,75.38,17.59
E02001182,Salford 026,6566,1035,566,1050,1086,776,841,630,356,174,52,1601,4965,1212,24.38,75.62,18.46
E02001183,Salford 027,6791,990,565,1225,1275,816,815,559,344,168,34,1555,5236,1105,22.9,77.1,16.27
E02001184,Salford 028,15490,1173,687,6107,3674,1450,1152,652,423,154,18,1860,13630,1247,12.01,87.99,8.05
E02001185,Salford 029,9944,1409,950,1371,1274,1117,1439,992,937,386,69,2359,7585,2384,23.72,76.28,23.97
E02001186,Salford 030,10434,1494,993,1495,1625,1269,1445,917,792,333,71,2487,7947,2113,23.84,76.16,20.25
E02001187,Stockport 001,7082,932,660,856,1016,893,1047,814,585,239,40,1592,5490,1678,22.48,77.52,23.69
E02001188,Stockport 002,8591,1283,906,1465,1359,1089,1089,695,482,184,39,2189,6402,1400,25.48,74.52,16.3
E02001189,Stockport 003,8308,1001,652,1153,1158,1097,1288,902,704,301,52,1653,6655,1959,19.9,80.1,23.58
E02001190,Stockport 004,7391,1310,877,1222,1092,846,807,589,346,234,68,2187,5204,1237,29.59,70.41,16.74
E02001191,Stockport 005,5689,533,474,638,609,745,845,810,668,307,60,1007,4682,1845,17.7,82.3,32.43
E02001192,Stockport 006,7004,813,548,863,1120,1047,965,659,507,367,115,1361,5643,1648,19.43,80.57,23.53
E02001193,Stockport 007,6343,757,543,970,1065,859,860,621,421,213,34,1300,5043,1289,20.5,79.5,20.32
E02001194,Stockport 008,6363,823,621,665,799,948,922,732,549,250,54,1444,4919,1585,22.69,77.31,24.91
E02001195,Stockport 009,7299,859,605,959,973,902,1059,879,662,333,68,1464,5835,1942,20.06,79.94,26.61
E02001196,Stockport 010,7796,890,731,787,819,974,1157,920,926,504,88,1621,6175,2438,20.79,79.21,31.27
E02001197,Stockport 011,6373,854,649,675,873,915,961,721,455,245,25,1503,4870,1446,23.58,76.42,22.69
E02001198,Stockport 012,7567,868,750,929,890,869,1024,775,883,443,136,1618,5949,2237,21.38,78.62,29.56
E02001199,Stockport 013,7935,980,677,998,1191,1024,1124,920,639,317,65,1657,6278,1941,20.88,79.12,24.46
E02001200,Stockport 014,7581,1001,573,1400,1201,916,1045,742,471,166,66,1574,6007,1445,20.76,79.24,19.06
E02001201,Stockport 015,5791,774,549,778,880,750,846,539,421,210,44,1323,4468,1214,22.85,77.15,20.96
E02001202,Stockport 016,6312,874,431,1142,1236,834,805,507,324,130,29,1305,5007,990,20.67,79.33,15.68
E02001203,Stockport 017,5898,608,530,464,525,768,927,855,815,336,70,1138,4760,2076,19.29,80.71,35.2
E02001204,Stockport 018,9223,1246,900,1220,1563,1278,1190,930,515,298,83,2146,7077,1826,23.27,76.73,19.8
E02001205,Stockport 019,8187,974,648,1346,1316,1103,1167,827,545,220,41,1622,6565,1633,19.81,80.19,19.95
E02001206,Stockport 020,7250,820,642,737,822,850,1107,876,761,532,103,1462,5788,2272,20.17,79.83,31.34
E02001207,Stockport 021,6977,758,599,788,876,809,1076,993,698,343,37,1357,5620,2071,19.45,80.55,29.68
E02001208,Stockport 022,7572,956,658,1052,1236,949,1047,802,514,294,64,1614,5958,1674,21.32,78.68,22.11
E02001209,Stockport 023,7939,1029,764,1181,1214,1137,1100,722,490,235,67,1793,6146,1514,22.58,77.42,19.07
E02001210,Stockport 024,7405,1052,838,893,968,914,964,726,632,356,62,1890,5515,1776,25.52,74.48,23.98
E02001211,Stockport 025,6408,824,628,662,739,913,898,731,537,362,114,1452,4956,1744,22.66,77.34,27.22
E02001212,Stockport 026,7069,1206,919,1034,1108,910,873,485,339,175,20,2125,4944,1019,30.06,69.94,14.42
E02001213,Stockport 027,10137,1199,992,1290,1301,1442,1522,1145,765,367,114,2191,7946,2391,21.61,78.39,23.59
E02001214,Stockport 028,7654,863,768,909,736,1022,1098,905,795,464,94,1631,6023,2258,21.31,78.69,29.5
E02001215,Stockport 029,5955,671,491,543,553,767,831,817,804,413,65,1162,4793,2099,19.51,80.49,35.25
E02001216,Stockport 030,7481,894,711,721,960,1009,1005,904,777,425,75,1605,5876,2181,21.45,78.55,29.15
E02001217,Stockport 031,6911,829,602,1049,986,853,848,622,648,377,97,1431,5480,1744,20.71,79.29,25.24
E02001218,Stockport 032,5989,652,687,556,603,884,844,740,626,335,62,1339,4650,1763,22.36,77.64,29.44
E02001219,Stockport 033,5424,550,518,573,514,669,811,706,691,328,64,1068,4356,1789,19.69,80.31,32.98
E02001220,Stockport 034,5705,728,572,575,624,815,856,686,567,252,30,1300,4405,1535,22.79,77.21,26.91
E02001221,Stockport 035,5896,625,572,592,520,829,841,741,735,359,82,1197,4699,1917,20.3,79.7,32.51
E02001222,Stockport 036,6447,751,605,770,707,818,834,784,703,398,77,1356,5091,1962,21.03,78.97,30.43
E02001223,Stockport 037,6655,667,674,619,609,867,1042,898,744,430,105,1341,5314,2177,20.15,79.85,32.71
E02001224,Stockport 038,5794,430,455,491,406,697,916,818,959,505,117,885,4909,2399,15.27,84.73,41.4
E02001225,Stockport 039,7383,830,766,741,810,1020,1106,801,783,432,94,1596,5787,2110,21.62,78.38,28.58
E02001226,Stockport 040,7094,954,735,892,937,917,943,733,616,317,50,1689,5405,1716,23.81,76.19,24.19
E02001227,Stockport 041,5848,651,524,506,547,745,840,694,778,456,107,1175,4673,2035,20.09,79.91,34.8
E02001228,Stockport 042,5697,610,545,490,473,761,885,720,686,422,105,1155,4542,1933,20.27,79.73,33.93
E02001229,Tameside 001,10183,1289,857,1253,1452,1438,1573,1141,862,274,44,2146,8037,2321,21.07,78.93,22.79
E02001230,Tameside 002,5977,625,561,802,631,642,920,735,768,262,31,1186,4791,1796,19.84,80.16,30.05
E02001231,Tameside 003,7214,993,816,911,887,1012,1060,784,595,145,11,1809,5405,1535,25.08,74.92,21.28
E02001232,Tameside 004,8487,1256,807,1218,1176,1078,1160,791,636,306,59,2063,6424,1792,24.31,75.69,21.11
E02001233,Tameside 005,7887,1062,750,1036,1012,925,1065,954,720,301,62,1812,6075,2037,22.97,77.03,25.83
E02001234,Tameside 006,7823,1181,820,1139,1143,920,1028,756,546,247,43,2001,5822,1592,25.58,74.42,20.35
E02001235,Tameside 007,7121,974,594,1165,1152,908,905,661,491,233,38,1568,5553,1423,22.02,77.98,19.98
E02001236,Tameside 008,5955,866,600,928,819,710,771,550,424,227,60,1466,4489,1261,24.62,75.38,21.18
E02001237,Tameside 009,7115,939,704,1089,983,912,1033,703,477,211,64,1643,5472,1455,23.09,76.91,20.45
E02001238,Tameside 010,7893,981,644,1064,978,938,1223,949,732,342,42,1625,6268,2065,20.59,79.41,26.16
E02001239,Tameside 011,9439,1291,884,1376,1380,1143,1376,923,690,327,49,2175,7264,1989,23.04,76.96,21.07
E02001240,Tameside 012,6147,744,581,863,793,767,931,653,537,248,30,1325,4822,1468,21.56,78.44,23.88
E02001241,Tameside 013,10859,1741,1175,1910,1745,1451,1257,872,511,163,34,2916,7943,1580,26.85,73.15,14.55
E02001242,Tameside 014,6738,816,581,887,968,849,1001,721,550,301,64,1397,5341,1636,20.73,79.27,24.28
E02001243,Tameside 015,8009,836,622,1067,1003,1016,1210,1002,859,332,62,1458,6551,2255,18.2,81.8,28.16
E02001244,Tameside 016,5397,578,476,635,609,719,787,664,675,210,44,1054,4343,1593,19.53,80.47,29.52
E02001245,Tameside 017,8230,1092,718,1291,1208,1052,1152,850,569,263,35,1810,6420,1717,21.99,78.01,20.86
E02001246,Tameside 018,7355,929,706,991,900,899,1079,809,641,318,83,1635,5720,1851,22.23,77.77,25.17
E02001247,Tameside 019,6942,875,641,990,932,888,1061,720,534,263,38,1516,5426,1555,21.84,78.16,22.4
E02001248,Tameside 020,11397,1751,1206,1733,1765,1487,1444,1059,689,219,44,2957,8440,2011,25.95,74.05,17.64
E02001249,Tameside 021,6286,813,538,975,871,767,887,638,506,244,47,1351,4935,1435,21.49,78.51,22.83
E02001250,Tameside 022,6534,708,524,808,766,867,1075,809,704,244,29,1232,5302,1786,18.86,81.14,27.33
E02001251,Tameside 023,5933,594,452,705,669,690,978,864,675,265,41,1046,4887,1845,17.63,82.37,31.1
E02001252,Tameside 024,7303,777,603,921,869,846,1126,856,753,490,62,1380,5923,2161,18.9,81.1,29.59
E02001253,Tameside 025,4924,503,491,672,572,609,764,576,478,215,44,994,3930,1313,20.19,79.81,26.67
E02001254,Tameside 026,5638,618,525,822,661,720,844,616,581,220,31,1143,4495,1448,20.27,79.73,25.68
E02001255,Tameside 027,6899,1227,756,1008,995,722,897,595,454,211,34,1983,4916,1294,28.74,71.26,18.76
E02001256,Tameside 028,10584,1563,1154,1743,1467,1437,1334,828,618,359,81,2717,7867,1886,25.67,74.33,17.82
E02001257,Tameside 029,9030,1054,812,1131,1105,995,1408,1009,971,491,54,1866,7164,2525,20.66,79.34,27.96
E02001258,Tameside 030,7194,786,604,828,796,939,1117,888,796,371,69,1390,5804,2124,19.32,80.68,29.52
E02001259,Trafford 001,11331,1639,1283,2106,2060,1553,1323,730,325,262,50,2922,8409,1367,25.79,74.21,12.06
E02001260,Trafford 002,7597,898,782,870,864,1070,1135,872,761,282,63,1680,5917,1978,22.11,77.89,26.04
E02001261,Trafford 003,8581,1272,953,1317,1493,1257,1099,606,359,194,31,2225,6356,1190,25.93,74.07,13.87
E02001262,Trafford 004,8647,1096,985,1378,1224,1188,1230,728,447,307,64,2081,6566,1546,24.07,75.93,17.88
E02001263,Trafford 005,8305,983,757,844,895,1109,1320,976,880,452,89,1740,6565,2397,20.95,79.05,28.86
E02001264,Trafford 006,8503,1281,914,1048,1206,1248,1212,766,519,274,35,2195,6308,1594,25.81,74.19,18.75
E02001265,Trafford 007,8149,974,830,961,1010,1129,1170,953,722,319,81,1804,6345,2075,22.14,77.86,25.46
E02001266,Trafford 008,7008,851,712,891,959,909,1134,719,509,264,60,1563,5445,1552,22.3,77.7,22.15
E02001267,Trafford 009,7555,831,620,1000,1021,996,1142,785,579,459,122,1451,6104,1945,19.21,80.79,25.74
E02001268,Trafford 010,6977,732,640,636,775,966,1103,886,751,414,74,1372,5605,2125,19.66,80.34,30.46
E02001269,Trafford 011,8384,1027,846,1088,1374,1179,1107,878,508,309,68,1873,6511,1763,22.34,77.66,21.03
E02001270,Trafford 012,8542,1259,755,968,1450,1352,1066,732,572,287,101,2014,6528,1692,23.58,76.42,19.81
E02001271,Trafford 013,6571,826,661,707,881,889,974,773,512,270,78,1487,5084,1633,22.63,77.37,24.85
E02001272,Trafford 014,8377,1204,801,786,1152,1283,1113,859,684,419,76,2005,6372,2038,23.93,76.07,24.33
E02001273,Trafford 015,10204,1288,901,1298,1667,1742,1210,879,702,402,115,2189,8015,2098,21.45,78.55,20.56
E02001274,Trafford 016,8065,776,913,723,710,1125,1213,1038,942,482,143,1689,6376,2605,20.94,79.06,32.3
E02001275,Trafford 017,8575,1467,1027,1169,1132,909,1107,875,519,315,55,2494,6081,1764,29.08,70.92,20.57
E02001276,Trafford 018,8178,1214,913,904,1151,1204,1025,803,590,304,70,2127,6051,1767,26.01,73.99,21.61
E02001277,Trafford 019,9721,1504,1188,1276,1494,1498,1269,735,550,175,32,2692,7029,1492,27.69,72.31,15.35
E02001278,Trafford 020,8714,1184,991,847,1104,1393,1196,875,681,344,99,2175,6539,1999,24.96,75.04,22.94
E02001279,Trafford 021,8492,1073,953,742,982,1367,1280,942,690,390,73,2026,6466,2095,23.86,76.14,24.67
E02001280,Trafford 022,8434,1056,1050,989,900,1208,1169,861,732,365,104,2106,6328,2062,24.97,75.03,24.45
E02001281,Trafford 023,7617,883,835,653,767,1155,1078,862,822,464,98,1718,5899,2246,22.55,77.45,29.49
E02001282,Trafford 024,10209,1499,1073,1248,1777,1638,1171,831,609,296,67,2572,7637,1803,25.19,74.81,17.66
E02001283,Trafford 025,9763,1176,961,1052,1336,1352,1390,958,883,525,130,2137,7626,2496,21.89,78.11,25.57
E02001284,Trafford 026,8451,1226,1116,724,1014,1351,1305,803,556,279,77,2342,6109,1715,27.71,72.29,20.29
E02001285,Trafford 027,8049,858,943,737,752,1119,1215,970,825,464,166,1801,6248,2425,22.38,77.62,30.13
E02001286,Trafford 028,8355,1008,1023,751,758,1143,1163,917,881,575,136,2031,6324,2509,24.31,75.69,30.03
E02001287,Wigan 001,5995,699,519,754,691,826,981,655,583,226,61,1218,4777,1525,20.32,79.68,25.44
E02001288,Wigan 002,7922,800,670,908,886,993,1267,1014,905,414,65,1470,6452,2398,18.56,81.44,30.27
E02001289,Wigan 003,10103,968,895,1106,1056,1282,1526,1343,1308,549,70,1863,8240,3270,18.44,81.56,32.37
E02001290,Wigan 004,6164,560,596,734,691,812,1046,716,685,269,55,1156,5008,1725,18.75,81.25,27.99
E02001291,Wigan 005,7728,1010,741,1051,1003,936,1138,823,694,291,41,1751,5977,1849,22.66,77.34,23.93
E02001292,Wigan 006,8059,793,577,1015,989,1025,1301,1030,812,436,81,1370,6689,2359,17.0,83.0,29.27
E02001293,Wigan 007,6103,610,545,762,738,732,994,757,702,234,29,1155,4948,1722,18.93,81.07,28.22
E02001294,Wigan 008,7893,858,622,1225,1154,1099,1235,777,559,312,52,1480,6413,1700,18.75,81.25,21.54
E02001295,Wigan 009,7737,959,642,1149,1078,952,1244,857,541,273,42,1601,6136,1713,20.69,79.31,22.14
E02001296,Wigan 010,9773,1730,1132,1533,1534,1122,1158,749,556,228,31,2862,6911,1564,29.28,70.72,16.0
E02001297,Wigan 011,6708,681,674,945,897,908,967,790,586,226,34,1355,5353,1636,20.2,79.8,24.39
E02001298,Wigan 012,8665,1236,943,1339,1273,1183,1056,754,576,226,79,2179,6486,1635,25.15,74.85,18.87
E02001299,Wigan 013,8996,980,829,1319,1150,1258,1407,854,802,326,71,1809,7187,2053,20.11,79.89,22.82
E02001300,Wigan 014,8305,963,723,1198,1124,1035,1156,899,791,343,73,1686,6619,2106,20.3,79.7,25.36
E02001301,Wigan 015,9140,1212,826,1463,1544,1171,1166,798,593,298,69,2038,7102,1758,22.3,77.7,19.23
E02001302,Wigan 016,7999,965,853,1032,948,952,1187,880,793,319,70,1818,6181,2062,22.73,77.27,25.78
E02001303,Wigan 017,8978,1292,951,1369,1299,1197,1204,845,557,221,43,2243,6735,1666,24.98,75.02,18.56
E02001304,Wigan 018,12924,1341,1277,1407,1469,1820,1939,1439,1471,657,104,2618,10306,3671,20.26,79.74,28.4
E02001305,Wigan 019,8247,852,729,1012,1000,1053,1193,1041,1028,298,41,1581,6666,2408,19.17,80.83,29.2
E02001306,Wigan 020,7282,682,587,989,740,914,1127,965,963,286,29,1269,6013,2243,17.43,82.57,30.8
E02001307,Wigan 021,11795,1402,1138,1327,1506,1676,1655,1430,1239,393,29,2540,9255,3091,21.53,78.47,26.21
E02001308,Wigan 022,6128,618,520,746,781,743,967,710,676,300,67,1138,4990,1753,18.57,81.43,28.61
E02001309,Wigan 023,8316,948,729,1193,1215,1073,1157,903,719,299,80,1677,6639,2001,20.17,79.83,24.06
E02001310,Wigan 024,9423,1386,937,1512,1402,1206,1170,892,655,221,42,2323,7100,1810,24.65,75.35,19.21
E02001311,Wigan 025,8347,903,760,1152,1145,1020,1264,988,813,253,49,1663,6684,2103,19.92,80.08,25.19
E02001312,Wigan 026,8436,1079,758,1392,1346,1101,1102,801,638,190,29,1837,6599,1658,21.78,78.22,19.65
E02001313,Wigan 027,8236,1126,850,1109,1168,1009,1140,823,688,238,85,1976,6260,1834,23.99,76.01,22.27
E02001314,Wigan 028,8381,1061,901,1036,1121,1097,1320,1016,624,183,22,1962,6419,1845,23.41,76.59,22.01
E02001315,Wigan 029,8270,1029,706,905,1199,1045,1196,942,894,310,44,1735,6535,2190,20.98,79.02,26.48
E02001316,Wigan 030,6694,770,542,1188,1178,910,891,595,422,172,26,1312,5382,1215,19.6,80.4,18.15
E02001317,Wigan 031,8671,941,875,1160,1023,1195,1324,966,797,317,73,1816,6855,2153,20.94,79.06,24.83
E02001318,Wigan 032,7872,789,779,974,849,1038,1144,1001,860,395,43,1568,6304,2299,19.92,80.08,29.2
E02001319,Wigan 033,7812,929,708,1288,1101,953,1103,858,637,185,50,1637,6175,1730,20.95,79.05,22.15
E02001320,Wigan 034,7655,845,625,1028,1048,994,1227,822,713,307,46,1470,6185,1888,19.2,80.8,24.66
E02001321,Wigan 035,8238,893,835,1098,942,1131,1215,938,818,311,57,1728,6510,2124,20.98,79.02,25.78
E02001322,Wigan 036,7318,672,624,943,759,865,1152,925,906,416,56,1296,6022,2303,17.71,82.29,31.47
E02001323,Wigan 037,7969,948,743,974,1014,1055,1175,876,843,289,52,1691,6278,2060,21.22,78.78,25.85
E02001324,Wigan 038,8501,954,903,1192,1150,1094,1221,892,724,304,67,1857,6644,1987,21.84,78.16,23.37
E02001325,Wigan 039,7948,830,692,900,842,1078,1353,998,868,318,69,1522,6426,2253,19.15,80.85,28.35
E02001326,Wigan 040,7931,898,748,854,900,1102,1187,912,938,349,43,1646,6285,2242,20.75,79.25,28.27
E02001327,Knowsley 001,8362,1552,1010,1261,1174,871,885,1010,460,121,18,2562,5800,1609,30.64,69.36,19.24
E02001328,Knowsley 002,10223,1294,868,1587,1405,1319,1379,1150,833,327,61,2162,8061,2371,21.15,78.85,23.19
E02001329,Knowsley 003,7491,939,652,1196,1028,909,1036,1040,425,193,73,1591,5900,1731,21.24,78.76,23.11
E02001330,Knowsley 004,9056,1341,861,1428,1197,1034,1183,1180,523,253,56,2202,6854,2012,24.32,75.68,22.22
E02001331,Knowsley 005,10121,1317,985,1539,1240,1108,1337,1407,746,362,80,2302,7819,2595,22.74,77.26,25.64
E02001332,Knowsley 006,7368,1074,614,1200,1013,824,1110,690,562,261,20,1688,5680,1533,22.91,77.09,20.81
E02001333,Knowsley 007,8861,1190,751,1461,1228,1017,1212,889,645,382,86,1941,6920,2002,21.9,78.1,22.59
E02001334,Knowsley 008,5917,941,600,1031,741,623,839,571,364,177,30,1541,4376,1142,26.04,73.96,19.3
E02001335,Knowsley 009,8043,931,692,1301,1006,961,1322,841,609,326,54,1623,6420,1830,20.18,79.82,22.75
E02001336,Knowsley 010,7262,1145,651,1189,1022,696,1007,743,433,325,51,1796,5466,1552,24.73,75.27,21.37
E02001337,Knowsley 011,5976,758,593,977,701,659,937,653,383,268,47,1351,4625,1351,22.61,77.39,22.61
E02001338,Knowsley 012,5905,842,560,879,804,591,877,575,483,254,40,1402,4503,1352,23.74,76.26,22.9
E02001339,Knowsley 013,6392,846,680,953,764,771,896,683,506,250,43,1526,4866,1482,23.87,76.13,23.19
E02001340,Knowsley 014,9459,1170,798,1316,1293,1017,1457,1090,771,478,69,1968,7491,2408,20.81,79.19,25.46
E02001341,Knowsley 015,7471,1029,695,1178,920,859,1037,856,512,315,70,1724,5747,1753,23.08,76.92,23.46
E02001342,Knowsley 016,7303,734,538,983,785,748,1213,995,720,481,106,1272,6031,2302,17.42,82.58,31.52
E02001343,Knowsley 017,7318,743,648,938,789,905,1175,1022,689,322,87,1391,5927,2120,19.01,80.99,28.97
E02001344,Knowsley 018,5399,578,447,788,700,595,857,689,399,293,53,1025,4374,1434,18.98,81.02,26.56
E02001345,Knowsley 019,5475,528,433,747,673,620,857,781,531,264,41,961,4514,1617,17.55,82.45,29.53
E02001346,Knowsley 020,7460,989,785,1085,1050,798,1113,840,461,282,57,1774,5686,1640,23.78,76.22,21.98
E02001347,Liverpool 001,7860,1065,753,1241,1031,981,1173,790,495,298,33,1818,6042,1616,23.13,76.87,20.56
E02001348,Liverpool 002,6785,828,573,1051,1009,892,940,767,443,254,28,1401,5384,1492,20.65,79.35,21.99
E02001349,Liverpool 003,7758,896,709,1177,1100,980,1177,880,560,242,37,1605,6153,1719,20.69,79.31,22.16
E02001350,Liverpool 004,8019,1120,786,1143,1073,925,1091,924,519,327,111,1906,6113,1881,23.77,76.23,23.46
E02001351,Liverpool 005,8688,1150,755,1458,1318,1063,1193,945,506,271,29,1905,6783,1751,21.93,78.07,20.15
E02001352,Liverpool 006,7181,902,653,1305,1187,970,840,673,451,172,28,1555,5626,1324,21.65,78.35,18.44
E02001353,Liverpool 007,7301,862,694,1059,898,940,1249,890,426,258,25,1556,5745,1599,21.31,78.69,21.9
E02001354,Liverpool 008,7583,1034,747,1179,1077,862,1005,858,486,297,38,1781,5802,1679,23.49,76.51,22.14
E02001355,Liverpool 009,6640,815,582,1004,973,786,930,744,518,223,65,1397,5243,1550,21.04,78.96,23.34
E02001356,Liverpool 010,8387,1821,866,1324,1454,969,842,542,355,190,24,2687,5700,1111,32.04,67.96,13.25
E02001357,Liverpool 011,7053,1126,793,1013,974,732,940,719,409,298,49,1919,5134,1475,27.21,72.79,20.91
E02001358,Liverpool 012,7012,1063,561,1237,1028,823,970,644,460,196,30,1624,5388,1330,23.16,76.84,18.97
E02001359,Liverpool 013,5391,565,431,746,645,617,867,756,490,248,26,996,4395,1520,18.48,81.52,28.2
E02001360,Liverpool 014,8698,1135,731,1378,1366,1047,1099,983,671,258,30,1866,6832,1942,21.45,78.55,22.33
E02001361,Liverpool 015,7417,893,671,1038,1006,830,1174,862,618,274,51,1564,5853,1805,21.09,78.91,24.34
E02001362,Liverpool 016,7185,746,644,968,889,717,1117,971,611,445,77,1390,5795,2104,19.35,80.65,29.28
E02001363,Liverpool 017,7756,1231,745,1180,1161,866,1073,709,509,237,45,1976,5780,1500,25.48,74.52,19.34
E02001364,Liverpool 018,5900,921,454,1036,867,737,732,561,367,185,40,1375,4525,1153,23.31,76.69,19.54
E02001365,Liverpool 019,9566,1421,841,1763,1668,1135,1134,763,535,242,64,2262,7304,1604,23.65,76.35,16.77
E02001366,Liverpool 020,9012,1115,739,1455,1422,1088,1279,901,596,341,76,1854,7158,1914,20.57,79.43,21.24
E02001367,Liverpool 021,9497,1063,771,1185,1137,1205,1423,1210,918,492,93,1834,7663,2713,19.31,80.69,28.57
E02001368,Liverpool 022,6978,928,554,1095,1003,752,877,873,553,297,46,1482,5496,1769,21.24,78.76,25.35
E02001369,Liverpool 023,8216,821,565,1829,1350,881,973,850,656,251,40,1386,6830,1797,16.87,83.13,21.87
E02001370,Liverpool 024,7194,982,675,1202,998,849,860,759,575,251,43,1657,5537,1628,23.03,76.97,22.63
E02001371,Liverpool 025,7223,1079,762,1125,1031,945,921,676,407,249,28,1841,5382,1360,25.49,74.51,18.83
E02001372,Liverpool 026,5927,582,445,841,720,726,904,784,486,361,78,1027,4900,1709,17.33,82.67,28.83
E02001373,Liverpool 027,9187,1150,841,1528,1365,1166,1289,945,597,270,36,1991,7196,1848,21.67,78.33,20.12
E02001374,Liverpool 028,9570,1058,687,2282,1842,1272,1049,708,472,162,38,1745,7825,1380,18.23,81.77,14.42
E02001375,Liverpool 029,6749,766,638,992,865,815,961,767,569,310,66,1404,5345,1712,20.8,79.2,25.37
E02001376,Liverpool 030,9497,1230,795,2723,1504,1076,863,660,421,202,23,2025,7472,1306,21.32,78.68,13.75
E02001377,Liverpool 031,16073,774,697,10187,1527,862,760,585,452,211,18,1471,14602,1266,9.15,90.85,7.88
E02001378,Liverpool 032,7742,879,649,1176,1078,947,1113,892,599,322,87,1528,6214,1900,19.74,80.26,24.54
E02001380,Liverpool 034,7649,920,621,922,981,955,1138,878,757,399,78,1541,6108,2112,20.15,79.85,27.61
E02001381,Liverpool 035,9875,1415,836,2440,1839,1051,943,695,416,209,31,2251,7624,1351,22.79,77.21,13.68
E02001382,Liverpool 036,6792,817,578,914,790,866,1050,865,599,264,49,1395,5397,1777,20.54,79.46,26.16
E02001383,Liverpool 037,9823,670,431,4644,1404,872,796,489,321,151,45,1101,8722,1006,11.21,88.79,10.24
E02001384,Liverpool 038,11128,810,602,5932,1336,748,619,543,303,200,35,1412,9716,1081,12.69,87.31,9.71
E02001385,Liverpool 039,10011,1945,1247,2033,1783,1179,780,482,329,199,34,3192,6819,1044,31.88,68.12,10.43
E02001386,Liverpool 040,7719,905,658,939,990,863,1095,1002,808,405,54,1563,6156,2269,20.25,79.75,29.39
E02001387,Liverpool 041,7758,863,634,1038,943,966,1148,1012,633,423,98,1497,6261,2166,19.3,80.7,27.92
E02001388,Liverpool 042,8499,962,611,2729,1427,866,736,561,317,221,69,1573,6926,1168,18.51,81.49,13.74
E02001389,Liverpool 043,6892,609,312,1780,1665,865,636,549,301,143,32,921,5971,1025,13.36,86.64,14.87
E02001390,Liverpool 044,9537,1294,906,1706,1517,1110,1198,867,559,321,59,2200,7337,1806,23.07,76.93,18.94
E02001391,Liverpool 045,5762,766,570,824,630,643,897,566,547,275,44,1336,4426,1432,23.19,76.81,24.85
E02001392,Liverpool 046,6051,674,409,587,648,673,911,857,718,484,90,1083,4968,2149,17.9,82.1,35.51
E02001393,Liverpool 047,7502,753,631,1131,580,851,1091,1140,846,391,88,1384,6118,2465,18.45,81.55,32.86
E02001394,Liverpool 048,9661,709,501,2794,1543,1059,1088,840,687,342,98,1210,8451,1967,12.52,87.48,20.36
E02001395,Liverpool 049,6096,801,467,702,922,791,768,756,542,296,51,1268,4828,1645,20.8,79.2,26.98
E02001396,Liverpool 050,7973,819,464,1668,1583,958,857,779,565,253,27,1283,6690,1624,16.09,83.91,20.37
E02001397,Liverpool 051,7358,700,491,826,989,758,1046,1156,784,477,131,1191,6167,2548,16.19,83.81,34.63
E02001398,Liverpool 052,7721,689,452,1502,1362,988,920,800,592,329,87,1141,6580,1808,14.78,85.22,23.42
E02001399,Liverpool 053,7093,925,581,793,930,838,1037,916,650,358,65,1506,5587,1989,21.23,78.77,28.04
E02001400,Liverpool 054,6702,824,535,856,888,814,1073,820,523,284,85,1359,5343,1712,20.28,79.72,25.54
E02001401,Liverpool 055,7704,905,514,1059,1075,809,1078,983,717,492,72,1419,6285,2264,18.42,81.58,29.39
E02001402,Liverpool 056,9217,1147,678,1122,1387,1238,1224,1056,867,402,96,1825,7392,2421,19.8,80.2,26.27
E02001403,Liverpool 057,6684,993,523,1156,1298,753,825,567,352,192,25,1516,5168,1136,22.68,77.32,17.0
E02001404,Liverpool 058,7667,1138,725,1210,1182,914,1071,728,432,220,47,1863,5804,1427,24.3,75.7,18.61
E02001405,Liverpool 059,9688,1652,1062,1444,1477,1047,1173,1018,537,238,40,2714,6974,1833,28.01,71.99,18.92
E02006932,Liverpool 060,17515,266,214,14314,1653,516,264,173,80,25,10,480,17035,288,2.74,97.26,1.64
E02006933,Liverpool 061,8539,370,269,3909,1911,671,603,485,220,97,4,639,7900,806,7.48,92.52,9.44
E02006934,Liverpool 062,8381,246,115,4639,2013,640,372,216,98,34,8,361,8020,356,4.31,95.69,4.25
E02001406,St. Helens 001,7720,646,615,748,659,853,1205,1088,1271,538,97,1261,6459,2994,16.33,83.67,38.78
E02001407,St. Helens 002,5783,440,463,549,480,728,787,939,946,405,46,903,4880,2336,15.61,84.39,40.39
E02001408,St. Helens 003,5561,492,441,692,590,651,839,830,753,243,30,933,4628,1856,16.78,83.22,33.38
E02001409,St. Helens 004,10191,1206,883,1287,1284,1214,1466,1297,1061,421,72,2089,8102,2851,20.5,79.5,27.98
E02001410,St. Helens 005,5856,666,520,750,763,737,824,679,606,255,56,1186,4670,1596,20.25,79.75,27.25
E02001411,St. Helens 006,5882,639,483,765,673,739,845,668,667,345,58,1122,4760,1738,19.08,80.92,29.55
E02001412,St. Helens 007,9071,1075,910,1187,1123,1140,1323,1080,772,389,72,1985,7086,2313,21.88,78.12,25.5
E02001413,St. Helens 008,9291,920,822,1213,1026,1186,1289,1304,1145,336,50,1742,7549,2835,18.75,81.25,30.51
E02001414,St. Helens 009,5470,570,438,520,544,633,827,717,705,436,80,1008,4462,1938,18.43,81.57,35.43
E02001415,St. Helens 010,6836,927,771,1056,976,927,888,614,463,185,29,1698,5138,1291,24.84,75.16,18.89
E02001416,St. Helens 011,6429,964,626,1063,850,767,828,692,392,210,37,1590,4839,1331,24.73,75.27,20.7
E02001417,St. Helens 012,7393,829,555,1249,1101,1029,1092,766,473,234,65,1384,6009,1538,18.72,81.28,20.8
E02001418,St. Helens 013,6015,798,472,988,955,762,778,549,435,242,36,1270,4745,1262,21.11,78.89,20.98
E02001419,St. Helens 014,7291,962,607,1274,1113,842,934,719,526,259,55,1569,5722,1559,21.52,78.48,21.38
E02001420,St. Helens 015,11648,1564,1002,1748,1838,1442,1633,1130,803,407,81,2566,9082,2421,22.03,77.97,20.78
E02001421,St. Helens 016,10548,1144,887,1604,1453,1330,1612,1227,824,386,81,2031,8517,2518,19.25,80.75,23.87
E02001422,St. Helens 017,6865,1061,775,1050,1004,796,885,674,375,219,26,1836,5029,1294,26.74,73.26,18.85
E02001423,St. Helens 018,6494,611,508,799,653,832,1049,888,718,363,73,1119,5375,2042,17.23,82.77,31.44
E02001424,St. Helens 019,14665,2000,1542,2124,2036,1856,1973,1349,1166,528,91,3542,11123,3134,24.15,75.85,21.37
E02001425,St. Helens 020,10249,1054,805,1342,1305,1322,1475,1378,1067,458,43,1859,8390,2946,18.14,81.86,28.74
E02001426,St. Helens 021,5442,540,410,646,612,630,847,625,689,399,44,950,4492,1757,17.46,82.54,32.29
E02001427,St. Helens 022,10359,1319,968,1453,1347,1393,1474,1069,957,342,37,2287,8072,2405,22.08,77.92,23.22
E02001428,St. Helens 023,5526,497,441,542,493,660,813,712,805,497,66,938,4588,2080,16.97,83.03,37.64
E02001429,Sefton 001,6709,624,555,638,650,668,977,1012,964,549,72,1179,5530,2597,17.57,82.43,38.71
E02001430,Sefton 002,6963,597,641,699,600,776,1108,1034,865,540,103,1238,5725,2542,17.78,82.22,36.51
E02001431,Sefton 003,7489,506,361,626,535,670,1036,1233,1302,939,281,867,6622,3755,11.58,88.42,50.14
E02001432,Sefton 004,9044,803,486,1277,1171,1065,1296,1148,934,640,224,1289,7755,2946,14.25,85.75,32.57
E02001433,Sefton 005,7779,1086,794,1039,985,1030,1113,822,601,273,36,1880,5899,1732,24.17,75.83,22.27
E02001434,Sefton 006,7453,951,769,955,927,965,1160,904,561,216,45,1720,5733,1726,23.08,76.92,23.16
E02001435,Sefton 007,8587,1166,822,1172,1218,1081,1256,879,625,302,66,1988,6599,1872,23.15,76.85,21.8
E02001436,Sefton 008,8998,1097,903,1144,1140,1073,1351,1052,734,415,89,2000,6998,2290,22.23,77.77,25.45
E02001437,Sefton 009,9604,675,672,904,677,928,1465,1457,1474,1051,301,1347,8257,4283,14.03,85.97,44.6
E02001438,Sefton 010,7316,801,755,894,800,899,1138,941,702,332,54,1556,5760,2029,21.27,78.73,27.73
E02001439,Sefton 011,6646,727,677,836,703,732,954,851,720,369,77,1404,5242,2017,21.13,78.87,30.35
E02001440,Sefton 012,5902,384,401,469,398,565,840,1002,1184,561,98,785,5117,2845,13.3,86.7,48.2
E02001441,Sefton 013,6426,525,566,597,420,685,916,987,1108,538,84,1091,5335,2717,16.98,83.02,42.28
E02001442,Sefton 014,6188,524,529,574,496,713,845,813,922,632,140,1053,5135,2507,17.02,82.98,40.51
E02001443,Sefton 015,5518,477,520,521,401,652,812,786,787,478,84,997,4521,2135,18.07,81.93,38.69
E02001444,Sefton 016,5562,523,562,600,554,683,802,688,698,376,76,1085,4477,1838,19.51,80.49,33.05
E02001445,Sefton 017,6738,634,513,673,613,802,1009,1006,829,541,118,1147,5591,2494,17.02,82.98,37.01
E02001446,Sefton 018,6776,639,510,830,683,781,1016,883,869,485,80,1149,5627,2317,16.96,83.04,34.19
E02001447,Sefton 019,5728,501,445,607,558,569,827,818,754,528,121,946,4782,2221,16.52,83.48,38.77
E02001448,Sefton 020,6686,704,558,784,648,781,1056,927,718,443,67,1262,5424,2155,18.88,81.12,32.23
E02001449,Sefton 021,9035,893,721,967,907,952,1466,1496,1031,520,82,1614,7421,3129,17.86,82.14,34.63
E02001450,Sefton 022,8256,726,694,789,674,990,1355,1284,1070,514,160,1420,6836,3028,17.2,82.8,36.68
E02001451,Sefton 023,6043,782,562,799,789,598,891,691,500,368,63,1344,4699,1622,22.24,77.76,26.84
E02001452,Sefton 024,6671,932,588,968,861,756,1007,722,453,303,81,1520,5151,1559,22.79,77.21,23.37
E02001453,Sefton 025,8829,955,784,1045,948,1071,1381,1237,852,445,111,1739,7090,2645,19.7,80.3,29.96
E02001454,Sefton 026,6974,685,625,814,751,882,1094,922,650,471,80,1310,5664,2123,18.78,81.22,30.44
E02001455,Sefton 027,7114,706,565,990,852,813,1172,930,641,395,50,1271,5843,2016,17.87,82.13,28.34
E02001456,Sefton 028,7500,774,644,873,911,913,1205,1011,716,354,99,1418,6082,2180,18.91,81.09,29.07
E02001457,Sefton 029,6890,924,640,1112,901,728,1031,821,427,273,33,1564,5326,1554,22.7,77.3,22.55
E02001458,Sefton 030,7721,902,646,1105,1100,1014,1238,888,556,229,43,1548,6173,1716,20.05,79.95,22.23
E02001459,Sefton 031,7184,993,755,972,917,864,1054,805,507,280,37,1748,5436,1629,24.33,75.67,22.68
E02001460,Sefton 032,7571,772,544,1150,963,856,1172,990,675,359,90,1316,6255,2114,17.38,82.62,27.92
E02001461,Sefton 033,6593,779,591,921,791,725,1001,812,639,290,44,1370,5223,1785,20.78,79.22,27.07
E02001462,Sefton 034,7900,1192,730,1404,1105,959,1048,778,502,158,24,1922,5978,1462,24.33,75.67,18.51
E02001463,Sefton 035,7055,961,755,964,949,869,1008,687,542,289,31,1716,5339,1549,24.32,75.68,21.96
E02001464,Sefton 036,7024,1029,670,1142,1030,876,946,682,458,154,37,1699,5325,1331,24.19,75.81,18.95
E02001465,Sefton 037,7267,968,609,1210,1016,832,1042,822,519,206,43,1577,5690,1590,21.7,78.3,21.88
E02001466,Sefton 038,8671,1177,801,1306,1195,987,1181,966,682,324,52,1978,6693,2024,22.81,77.19,23.34
E02001467,Wirral 001,7945,747,581,1004,936,950,1246,1116,854,429,82,1328,6617,2481,16.71,83.29,31.23
E02001468,Wirral 002,7619,787,748,1072,867,1045,1179,943,606,276,96,1535,6084,1921,20.15,79.85,25.21
E02001469,Wirral 003,7765,755,653,895,821,956,1181,1088,843,466,107,1408,6357,2504,18.13,81.87,32.25
E02001470,Wirral 004,8393,908,783,977,986,993,1297,1191,783,398,77,1691,6702,2449,20.15,79.85,29.18
E02001471,Wirral 005,7826,1099,839,1072,1095,968,1075,796,544,282,56,1938,5888,1678,24.76,75.24,21.44
E02001472,Wirral 006,7011,849,728,902,870,863,1096,836,521,267,79,1577,5434,1703,22.49,77.51,24.29
E02001473,Wirral 007,7929,943,762,1105,1062,919,1082,916,731,337,72,1705,6224,2056,21.5,78.5,25.93
E02001474,Wirral 008,7344,1162,792,1337,962,799,969,660,459,183,21,1954,5390,1323,26.61,73.39,18.01
E02001475,Wirral 009,6422,926,745,874,825,720,828,674,529,245,56,1671,4751,1504,26.02,73.98,23.42
E02001476,Wirral 010,7971,1315,780,1305,1256,900,998,708,470,204,35,2095,5876,1417,26.28,73.72,17.78
E02001477,Wirral 011,7681,1292,901,1231,1046,906,966,744,412,164,19,2193,5488,1339,28.55,71.45,17.43
E02001478,Wirral 012,8000,888,717,1018,872,949,1082,1135,867,393,79,1605,6395,2474,20.06,79.94,30.92
E02001479,Wirral 013,6189,662,536,686,658,772,1008,892,670,254,51,1198,4991,1867,19.36,80.64,30.17
E02001480,Wirral 014,7791,780,654,820,770,966,1265,1031,794,500,211,1434,6357,2536,18.41,81.59,32.55
E02001481,Wirral 015,8105,789,715,1022,905,1077,1285,982,867,365,98,1504,6601,2312,18.56,81.44,28.53
E02001482,Wirral 016,8193,962,749,1361,1178,1086,1224,882,476,248,27,1711,6482,1633,20.88,79.12,19.93
E02001483,Wirral 017,7320,747,560,839,831,819,1115,1124,853,373,59,1307,6013,2409,17.86,82.14,32.91
E02001484,Wirral 018,8011,815,743,916,786,977,1142,1032,921,532,147,1558,6453,2632,19.45,80.55,32.85
E02001485,Wirral 019,6913,945,826,966,887,858,913,672,506,269,71,1771,5142,1518,25.62,74.38,21.96
E02001486,Wirral 020,8154,584,467,1038,945,998,1260,1148,1042,495,177,1051,7103,2862,12.89,87.11,35.1
E02001487,Wirral 021,9734,1570,1060,1641,1484,1199,1230,861,495,156,38,2630,7104,1550,27.02,72.98,15.92
E02001488,Wirral 022,8422,1024,831,1114,1154,1080,1306,882,668,307,56,1855,6567,1913,22.03,77.97,22.71
E02001489,Wirral 023,8085,703,616,773,674,953,1228,1334,1124,543,137,1319,6766,3138,16.31,83.69,38.81
E02001490,Wirral 024,8233,890,842,961,963,1053,1191,1022,919,346,46,1732,6501,2333,21.04,78.96,28.34
E02001491,Wirral 025,6870,960,692,943,905,778,885,808,548,283,68,1652,5218,1707,24.05,75.95,24.85
E02001492,Wirral 026,7832,758,761,764,748,1001,1201,992,930,543,134,1519,6313,2599,19.39,80.61,33.18
E02001493,Wirral 027,8275,1189,814,1375,1214,1012,1018,816,546,229,62,2003,6272,1653,24.21,75.79,19.98
E02001494,Wirral 028,7043,691,654,561,528,823,1144,1086,981,446,129,1345,5698,2642,19.1,80.9,37.51
E02001495,Wirral 029,7986,961,829,1091,984,1002,1166,902,653,310,88,1790,6196,1953,22.41,77.59,24.46
E02001496,Wirral 030,6265,649,625,732,649,792,969,776,649,330,94,1274,4991,1849,20.34,79.66,29.51
E02001497,Wirral 031,8188,1114,819,1111,1165,1007,1157,888,631,265,31,1933,6255,1815,23.61,76.39,22.17
E02001498,Wirral 032,7483,901,741,926,846,964,1145,864,677,358,61,1642,5841,1960,21.94,78.06,26.19
E02001499,Wirral 033,6621,669,474,649,602,707,996,989,893,543,99,1143,5478,2524,17.26,82.74,38.12
E02001500,Wirral 034,7536,786,626,749,762,908,1128,1083,950,467,77,1412,6124,2577,18.74,81.26,34.2
E02001501,Wirral 035,8003,924,763,916,961,978,1248,963,825,330,95,1687,6316,2213,21.08,78.92,27.65
E02001502,Wirral 036,9644,1229,772,1239,1424,1151,1295,1074,896,427,137,2001,7643,2534,20.75,79.25,26.28
E02001503,Wirral 037,7451,675,636,760,707,833,1103,1013,1005,574,145,1311,6140,2737,17.59,82.41,36.73
E02001504,Wirral 038,7216,614,532,669,598,800,1014,1076,1170,617,126,1146,6070,2989,15.88,84.12,41.42
E02001505,Wirral 039,6345,688,582,753,772,833,914,710,687,336,70,1270,5075,1803,20.02,79.98,28.42
E02001506,Wirral 040,8765,728,791,654,533,1007,1361,1388,1354,803,146,1519,7246,3691,17.33,82.67,42.11
E02001507,Wirral 041,7139,702,608,778,681,858,1020,890,1044,492,66,1310,5829,2492,18.35,81.65,34.91
E02001508,Wirral 042,8293,970,811,1021,1006,1016,1241,974,733,453,68,1781,6512,2228,21.48,78.52,26.87
E02001509,Barnsley 001,6758,774,631,825,850,796,1026,839,645,308,64,1405,5353,1856,20.79,79.21,27.46
E02001510,Barnsley 002,6049,695,623,875,728,730,920,708,546,198,26,1318,4731,1478,21.79,78.21,24.43
E02001511,Barnsley 003,6215,692,546,800,675,684,920,884,644,319,51,1238,4977,1898,19.92,80.08,30.54
E02001512,Barnsley 004,8124,815,677,984,965,1035,1230,961,856,460,141,1492,6632,2418,18.37,81.63,29.76
E02001513,Barnsley 005,7726,753,649,928,833,957,1257,1013,957,344,35,1402,6324,2349,18.15,81.85,30.4
E02001514,Barnsley 006,7761,1059,721,1155,1152,884,1101,823,573,244,49,1780,5981,1689,22.94,77.06,21.76
E02001515,Barnsley 007,9990,1506,1085,1374,1401,1092,1336,1089,726,334,47,2591,7399,2196,25.94,74.06,21.98
E02001516,Barnsley 008,6123,762,656,973,793,792,887,632,414,177,37,1418,4705,1260,23.16,76.84,20.58
E02001517,Barnsley 009,8173,811,632,949,970,1004,1329,1121,885,401,71,1443,6730,2478,17.66,82.34,30.32
E02001518,Barnsley 010,10604,1209,932,1487,1478,1384,1594,1171,861,395,93,2141,8463,2520,20.19,79.81,23.76
E02001519,Barnsley 011,8056,1177,761,1181,1242,919,1078,800,575,255,68,1938,6118,1698,24.06,75.94,21.08
E02001520,Barnsley 012,11458,1086,938,1364,1304,1382,1752,1444,1351,700,137,2024,9434,3632,17.66,82.34,31.7
E02001521,Barnsley 013,12806,1442,948,2560,2430,1618,1616,1115,713,302,62,2390,10416,2192,18.66,81.34,17.12
E02001522,Barnsley 014,9090,1216,833,1308,1138,1002,1285,1067,801,366,74,2049,7041,2308,22.54,77.46,25.39
E02001523,Barnsley 015,7226,775,515,1209,1016,928,1038,722,665,305,53,1290,5936,1745,17.85,82.15,24.15
E02001524,Barnsley 016,6143,503,558,499,485,766,1091,933,884,371,53,1061,5082,2241,17.27,82.73,36.48
E02001525,Barnsley 017,7018,893,533,1157,1051,897,910,738,540,253,46,1426,5592,1577,20.32,79.68,22.47
E02001526,Barnsley 018,6362,968,656,933,932,714,817,634,469,212,27,1624,4738,1342,25.53,74.47,21.09
E02001527,Barnsley 019,6124,642,513,762,676,747,969,796,648,309,62,1155,4969,1815,18.86,81.14,29.64
E02001528,Barnsley 020,10680,1248,985,1437,1266,1256,1504,1353,1058,484,89,2233,8447,2984,20.91,79.09,27.94
E02001529,Barnsley 021,9521,1143,826,1239,1058,1174,1379,1195,921,525,61,1969,7552,2702,20.68,79.32,28.38
E02001530,Barnsley 022,6743,908,646,983,953,826,1056,720,447,168,36,1554,5189,1371,23.05,76.95,20.33
E02001531,Barnsley 023,7821,972,563,1335,1119,930,1046,889,643,273,51,1535,6286,1856,19.63,80.37,23.73
E02001532,Barnsley 024,10752,1336,1024,1139,1312,1467,1614,1332,1014,416,98,2360,8392,2860,21.95,78.05,26.6
E02001533,Barnsley 025,7750,974,773,1133,1063,893,1061,937,590,256,70,1747,6003,1853,22.54,77.46,23.91
E02001534,Barnsley 026,9865,1243,913,1460,1368,1291,1396,997,755,359,83,2156,7709,2194,21.86,78.14,22.24
E02001535,Barnsley 027,6560,651,580,619,613,877,1119,976,777,289,59,1231,5329,2101,18.77,81.23,32.03
E02001536,Barnsley 028,8574,844,694,1074,899,1127,1307,1058,979,474,118,1538,7036,2629,17.94,82.06,30.66
E02001537,Barnsley 029,8563,1023,791,1253,1061,1121,1306,1010,656,285,57,1814,6749,2008,21.18,78.82,23.45
E02001538,Barnsley 030,8231,981,780,1039,954,897,1227,1062,868,359,64,1761,6470,2353,21.39,78.61,28.59
E02001539,Doncaster 001,6382,999,736,910,830,684,865,654,474,207,23,1735,4647,1358,27.19,72.81,21.28
E02001540,Doncaster 002,11728,1409,1266,1412,1400,1427,1700,1483,1053,492,86,2675,9053,3114,22.81,77.19,26.55
E02001541,Doncaster 003,11277,1198,1078,1392,1431,1321,1675,1389,1139,545,109,2276,9001,3182,20.18,79.82,28.22
E02001542,Doncaster 004,7803,1065,839,1059,913,886,1083,915,667,317,59,1904,5899,1958,24.4,75.6,25.09
E02001543,Doncaster 005,8029,917,806,938,1004,892,1165,1037,773,424,73,1723,6306,2307,21.46,78.54,28.73
E02001544,Doncaster 006,8475,1082,939,1071,1014,1012,1239,910,803,334,71,2021,6454,2118,23.85,76.15,24.99
E02001545,Doncaster 007,8342,747,773,854,796,1050,1275,1267,982,519,79,1520,6822,2847,18.22,81.78,34.13
E02001546,Doncaster 008,9112,682,528,1590,1521,1134,1233,1016,881,438,89,1210,7902,2424,13.28,86.72,26.6
E02001547,Doncaster 009,10922,1590,1256,1572,1450,1258,1561,1105,730,319,81,2846,8076,2235,26.06,73.94,20.46
E02001548,Doncaster 010,8153,1226,762,1316,1149,930,1143,761,582,232,52,1988,6165,1627,24.38,75.62,19.96
E02001549,Doncaster 011,6209,721,616,772,717,798,887,799,562,298,39,1337,4872,1698,21.53,78.47,27.35
E02001550,Doncaster 012,7755,935,798,1093,1042,922,1078,900,583,338,66,1733,6022,1887,22.35,77.65,24.33
E02001551,Doncaster 013,6061,773,514,938,799,737,866,734,466,209,25,1287,4774,1434,21.23,78.77,23.66
E02001552,Doncaster 014,7856,1026,766,1226,1147,963,1005,824,545,293,61,1792,6064,1723,22.81,77.19,21.93
E02001553,Doncaster 015,10339,1395,973,1426,1533,1278,1345,1118,781,406,84,2368,7971,2389,22.9,77.1,23.11
E02001554,Doncaster 016,6020,614,557,688,679,739,991,720,609,383,40,1171,4849,1752,19.45,80.55,29.1
E02001555,Doncaster 017,5289,459,390,606,545,563,789,898,676,313,50,849,4440,1937,16.05,83.95,36.62
E02001556,Doncaster 018,9544,1275,1022,1351,1403,1229,1306,906,648,330,74,2297,7247,1958,24.07,75.93,20.52
E02001557,Doncaster 019,10320,1034,748,1827,1827,1367,1433,1098,591,296,99,1782,8538,2084,17.27,82.73,20.19
E02001558,Doncaster 020,6033,524,428,543,562,715,1020,933,893,371,44,952,5081,2241,15.78,84.22,37.15
E02001559,Doncaster 021,7620,825,714,884,869,933,1194,855,867,394,85,1539,6081,2201,20.2,79.8,28.88
E02001560,Doncaster 022,13422,1799,1221,2990,2603,1740,1396,868,538,216,51,3020,10402,1673,22.5,77.5,12.46
E02001561,Doncaster 023,6736,931,517,1030,1127,884,940,655,377,232,43,1448,5288,1307,21.5,78.5,19.4
E02001562,Doncaster 024,5879,697,516,723,743,679,792,749,546,332,102,1213,4666,1729,20.63,79.37,29.41
E02001563,Doncaster 025,8062,910,685,871,985,944,1113,1037,867,496,154,1595,6467,2554,19.78,80.22,31.68
E02001564,Doncaster 026,7987,835,728,729,783,1017,1207,1230,1010,381,67,1563,6424,2688,19.57,80.43,33.65
E02001565,Doncaster 027,7382,710,625,844,857,927,1044,1095,825,375,80,1335,6047,2375,18.08,81.92,32.17
E02001566,Doncaster 028,9345,1322,888,1678,1727,1260,1181,687,393,189,20,2210,7135,1289,23.65,76.35,13.79
E02001567,Doncaster 029,8958,1148,958,1200,1255,990,1207,1004,727,379,90,2106,6852,2200,23.51,76.49,24.56
E02001568,Doncaster 030,6506,885,563,874,885,784,896,729,629,219,42,1448,5058,1619,22.26,77.74,24.88
E02001569,Doncaster 031,8955,1162,813,1413,1221,1022,1305,972,668,321,58,1975,6980,2019,22.05,77.95,22.55
E02001570,Doncaster 032,7038,833,697,1010,828,794,1023,843,636,321,53,1530,5508,1853,21.74,78.26,26.33
E02001571,Doncaster 033,6164,643,538,701,719,741,948,826,696,302,50,1181,4983,1874,19.16,80.84,30.4
E02001572,Doncaster 034,7485,1018,751,1086,1042,884,1038,794,564,246,62,1769,5716,1666,23.63,76.37,22.26
E02001573,Doncaster 035,7751,1006,829,1074,1056,952,1052,822,576,333,51,1835,5916,1782,23.67,76.33,22.99
E02001574,Doncaster 036,6085,556,592,706,725,762,907,839,694,256,48,1148,4937,1837,18.87,81.13,30.19
E02001575,Doncaster 037,7571,1154,830,1149,1039,783,988,723,554,280,71,1984,5587,1628,26.21,73.79,21.5
E02001576,Doncaster 038,6828,862,656,885,863,953,993,707,598,264,47,1518,5310,1616,22.23,77.77,23.67
E02001577,Doncaster 039,6467,591,444,517,618,672,951,991,1065,536,82,1035,5432,2674,16.0,84.0,41.35
E02001578,Rotherham 001,11573,1680,1249,1582,1816,1543,1516,1115,683,318,71,2929,8644,2187,25.31,74.69,18.9
E02001579,Rotherham 002,9791,1188,930,1272,1279,1180,1329,1169,875,462,107,2118,7673,2613,21.63,78.37,26.69
E02001580,Rotherham 003,8312,848,665,1135,909,993,1191,1053,969,458,91,1513,6799,2571,18.2,81.8,30.93
E02001581,Rotherham 004,5956,761,511,721,755,655,894,821,553,234,51,1272,4684,1659,21.36,78.64,27.85
E02001582,Rotherham 005,7736,920,727,1078,907,940,1167,900,704,325,68,1647,6089,1997,21.29,78.71,25.81
E02001583,Rotherham 006,5677,759,537,792,811,686,793,619,433,194,53,1296,4381,1299,22.83,77.17,22.88
E02001584,Rotherham 007,6823,605,497,821,758,841,1137,1024,800,276,64,1102,5721,2164,16.15,83.85,31.72
E02001585,Rotherham 008,6434,832,624,949,875,809,882,707,481,234,41,1456,4978,1463,22.63,77.37,22.74
E02001586,Rotherham 009,7854,677,532,1172,885,936,1322,961,877,426,66,1209,6645,2330,15.39,84.61,29.67
E02001587,Rotherham 010,5750,738,466,867,601,723,826,676,563,210,80,1204,4546,1529,20.94,79.06,26.59
E02001588,Rotherham 011,7158,976,716,1045,941,830,1019,731,488,341,71,1692,5466,1631,23.64,76.36,22.79
E02001589,Rotherham 012,7940,864,827,881,918,1135,1167,984,784,323,57,1691,6249,2148,21.3,78.7,27.05
E02001590,Rotherham 013,7683,1292,955,1146,1082,843,989,682,473,195,26,2247,5436,1376,29.25,70.75,17.91
E02001591,Rotherham 014,8649,1360,1054,1415,1342,991,1004,759,451,210,63,2414,6235,1483,27.91,72.09,17.15
E02001592,Rotherham 015,8706,935,742,1196,1023,979,1359,1106,954,359,53,1677,7029,2472,19.26,80.74,28.39
E02001593,Rotherham 016,7679,1164,832,1460,1250,888,897,641,350,169,28,1996,5683,1188,25.99,74.01,15.47
E02001594,Rotherham 017,8350,1213,905,1721,1303,1032,871,608,379,239,79,2118,6232,1305,25.37,74.63,15.63
E02001595,Rotherham 018,8312,815,723,1038,951,1007,1363,1142,791,402,80,1538,6774,2415,18.5,81.5,29.05
E02001596,Rotherham 019,8375,815,756,894,880,976,1175,1134,1049,561,135,1571,6804,2879,18.76,81.24,34.38
E02001597,Rotherham 020,9434,1371,899,1447,1238,1032,1237,1063,740,350,57,2270,7164,2210,24.06,75.94,23.43
E02001598,Rotherham 021,9563,1118,925,1117,1005,1191,1464,1145,952,560,86,2043,7520,2743,21.36,78.64,28.68
E02001599,Rotherham 022,6395,559,634,742,695,804,1011,799,725,358,68,1193,5202,1950,18.66,81.34,30.49
E02001600,Rotherham 023,11247,1328,1225,1608,1373,1413,1380,1168,1013,611,128,2553,8694,2920,22.7,77.3,25.96
E02001601,Rotherham 024,4868,487,410,567,533,570,788,648,545,267,53,897,3971,1513,18.43,81.57,31.08
E02001602,Rotherham 025,8956,1017,764,1254,1076,1079,1300,968,995,436,67,1781,7175,2466,19.89,80.11,27.53
E02001603,Rotherham 026,7284,1069,627,1015,925,826,1013,818,652,291,48,1696,5588,1809,23.28,76.72,24.84
E02001604,Rotherham 027,10542,1471,959,1540,1721,1488,1424,879,700,297,63,2430,8112,1939,23.05,76.95,18.39
E02001605,Rotherham 028,7732,924,619,1193,931,927,1176,854,680,349,79,1543,6189,1962,19.96,80.04,25.38
E02001606,Rotherham 029,8064,938,848,1031,949,918,1161,943,859,361,56,1786,6278,2219,22.15,77.85,27.52
E02001607,Rotherham 030,8947,1150,844,1049,1059,1057,1232,1100,992,403,61,1994,6953,2556,22.29,77.71,28.57
E02001608,Rotherham 031,6805,816,667,782,916,908,967,763,717,229,40,1483,5322,1749,21.79,78.21,25.7
E02001609,Rotherham 032,8386,781,692,873,796,1063,1211,1168,1258,466,78,1473,6913,2970,17.56,82.44,35.42
E02001610,Rotherham 033,8430,894,796,929,887,1083,1308,1026,1025,403,79,1690,6740,2533,20.05,79.95,30.05
E02001611,Sheffield 001,7652,760,701,1026,809,967,1061,935,849,425,119,1461,6191,2328,19.09,80.91,30.42
E02001612,Sheffield 002,5782,548,498,756,612,777,925,715,655,233,63,1046,4736,1666,18.09,81.91,28.81
E02001613,Sheffield 003,10179,1086,890,1229,1113,1192,1564,1357,1171,492,85,1976,8203,3105,19.41,80.59,30.5
E02001614,Sheffield 004,10725,938,947,1321,1089,1543,1612,1381,1242,553,99,1885,8840,3275,17.58,82.42,30.54
E02001615,Sheffield 005,7192,538,503,809,693,835,1164,1010,1051,506,83,1041,6151,2650,14.47,85.53,36.85
E02001616,Sheffield 006,7293,753,696,1014,864,908,1066,767,771,393,61,1449,5844,1992,19.87,80.13,27.31
E02001617,Sheffield 007,5875,981,727,869,866,719,761,452,294,174,32,1708,4167,952,29.07,70.93,16.2
E02001618,Sheffield 008,9853,1060,986,1154,1070,1487,1547,1139,954,403,53,2046,7807,2549,20.77,79.23,25.87
E02001619,Sheffield 009,9739,1337,1140,1442,1199,1150,1338,937,769,354,73,2477,7262,2133,25.43,74.57,21.9
E02001620,Sheffield 010,6952,1159,764,1065,963,814,883,564,485,225,30,1923,5029,1304,27.66,72.34,18.76
E02001621,Sheffield 011,6064,919,666,997,877,707,763,504,392,201,38,1585,4479,1135,26.14,73.86,18.72
E02001622,Sheffield 012,8867,1318,765,1400,1223,1088,1152,829,608,402,82,2083,6784,1921,23.49,76.51,21.66
E02001623,Sheffield 013,8472,1318,1152,1276,1061,1007,1013,766,502,305,72,2470,6002,1645,29.15,70.85,19.42
E02001624,Sheffield 014,9895,1369,901,1664,1383,1240,1332,865,762,324,55,2270,7625,2006,22.94,77.06,20.27
E02001625,Sheffield 015,7857,1273,883,1188,1066,844,1025,743,534,251,50,2156,5701,1578,27.44,72.56,20.08
E02001626,Sheffield 016,5850,631,555,766,744,860,851,627,541,240,35,1186,4664,1443,20.27,79.73,24.67
E02001627,Sheffield 017,6105,665,487,1176,1023,757,812,595,372,202,16,1152,4953,1185,18.87,81.13,19.41
E02001628,Sheffield 018,7100,1182,1044,1222,1074,924,577,481,335,216,45,2226,4874,1077,31.35,68.65,15.17
E02001629,Sheffield 019,6960,1038,744,1173,904,870,858,567,445,311,50,1782,5178,1373,25.6,74.4,19.73
E02001630,Sheffield 020,9884,1705,1507,1768,1388,1247,911,627,352,292,87,3212,6672,1358,32.5,67.5,13.74
E02001631,Sheffield 021,7713,858,681,1087,1122,1035,1168,705,626,352,79,1539,6174,1762,19.95,80.05,22.84
E02001632,Sheffield 022,14811,3031,2188,3015,2402,1607,1219,653,369,266,61,5219,9592,1349,35.24,64.76,9.11
E02001633,Sheffield 023,7478,693,624,745,697,972,1152,1037,955,507,96,1317,6161,2595,17.61,82.39,34.7
E02001634,Sheffield 024,9356,915,466,2000,1805,1117,1131,912,621,313,76,1381,7975,1922,14.76,85.24,20.54
E02001635,Sheffield 025,6120,655,542,726,743,753,878,647,707,407,62,1197,4923,1823,19.56,80.44,29.79
E02001636,Sheffield 026,11325,1278,835,3774,1573,1142,1010,715,585,348,65,2113,9212,1713,18.66,81.34,15.13
E02001637,Sheffield 027,8543,1629,1278,1431,1562,1032,637,450,321,173,30,2907,5636,974,34.03,65.97,11.4
E02001638,Sheffield 028,6081,347,221,3402,791,348,350,301,204,100,17,568,5513,622,9.34,90.66,10.23
E02001639,Sheffield 029,6233,607,409,1747,932,743,586,434,435,255,85,1016,5217,1209,16.3,83.7,19.4
E02001640,Sheffield 030,8138,486,362,4340,848,600,515,452,290,187,58,848,7290,987,10.42,89.58,12.13
E02001642,Sheffield 032,10298,1306,1007,1779,1404,1362,1352,877,751,385,75,2313,7985,2088,22.46,77.54,20.28
E02001643,Sheffield 033,6310,689,621,570,552,950,971,808,704,366,79,1310,5000,1957,20.76,79.24,31.01
E02001646,Sheffield 036,9165,463,402,5345,765,606,547,450,346,191,50,865,8300,1037,9.44,90.56,11.31
E02001647,Sheffield 037,6247,685,599,822,675,761,935,658,670,350,92,1284,4963,1770,20.55,79.45,28.33
E02001648,Sheffield 038,10090,601,687,4550,762,926,935,692,563,270,104,1288,8802,1629,12.77,87.23,16.14
E02001649,Sheffield 039,10197,1585,1104,1654,1519,1299,1232,903,621,235,45,2689,7508,1804,26.37,73.63,17.69
E02001650,Sheffield 040,10257,858,630,5091,1358,948,602,378,210,144,38,1488,8769,770,14.51,85.49,7.51
E02001651,Sheffield 041,7878,840,846,537,656,1099,1284,1049,962,514,91,1686,6192,2616,21.4,78.6,33.21
E02001652,Sheffield 042,13272,1074,917,6975,1789,939,652,433,271,193,29,1991,11281,926,15.0,85.0,6.98
E02001653,Sheffield 043,7560,917,662,1876,1198,863,826,518,447,213,40,1579,5981,1218,20.89,79.11,16.11
E02001654,Sheffield 044,6277,634,576,881,748,683,1013,631,629,410,72,1210,5067,1742,19.28,80.72,27.75
E02001655,Sheffield 045,7725,1028,751,1185,989,930,1056,792,668,271,55,1779,5946,1786,23.03,76.97,23.12
E02001656,Sheffield 046,8237,803,639,2485,1136,936,884,634,439,239,42,1442,6795,1354,17.51,82.49,16.44
E02001657,Sheffield 047,9159,1270,946,1158,1198,1400,1195,918,672,344,58,2216,6943,1992,24.19,75.81,21.75
E02001658,Sheffield 048,5549,840,639,961,713,661,714,475,344,158,44,1479,4070,1021,26.65,73.35,18.4
E02001659,Sheffield 049,6021,638,469,944,710,740,937,687,513,318,65,1107,4914,1583,18.39,81.61,26.29
E02001660,Sheffield 050,10284,1146,936,1918,1841,1380,1155,936,569,306,97,2082,8202,1908,20.25,79.75,18.55
E02001661,Sheffield 051,8203,1047,741,1376,1361,985,1002,675,610,316,90,1788,6415,1691,21.8,78.2,20.61
E02001662,Sheffield 052,7444,758,640,1068,866,866,1073,853,766,468,86,1398,6046,2173,18.78,81.22,29.19
E02001663,Sheffield 053,7691,920,647,1130,1443,1235,1098,612,370,198,38,1567,6124,1218,20.37,79.63,15.84
E02001664,Sheffield 054,6364,675,496,875,801,721,858,812,677,400,49,1171,5193,1938,18.4,81.6,30.45
E02001665,Sheffield 055,9619,1070,987,762,771,1343,1526,1251,1115,640,154,2057,7562,3160,21.38,78.62,32.85
E02001666,Sheffield 056,5983,726,579,930,743,710,951,620,475,206,43,1305,4678,1344,21.81,78.19,22.46
E02001669,Sheffield 059,7586,847,587,1236,1263,1046,1081,697,508,272,49,1434,6152,1526,18.9,81.1,20.12
E02001670,Sheffield 060,6377,933,657,1028,868,708,828,566,436,275,78,1590,4787,1355,24.93,75.07,21.25
E02001671,Sheffield 061,5676,438,369,707,564,656,956,864,746,310,66,807,4869,1986,14.22,85.78,34.99
E02001672,Sheffield 062,6075,623,491,823,703,706,890,651,641,443,104,1114,4961,1839,18.34,81.66,30.27
E02001673,Sheffield 063,5270,584,438,748,619,678,926,659,381,188,49,1022,4248,1277,19.39,80.61,24.23
E02001674,Sheffield 064,8615,845,675,796,940,1076,1322,1166,1073,590,132,1520,7095,2961,17.64,82.36,34.37
E02001675,Sheffield 065,8670,908,685,1108,989,1037,1187,1161,1075,437,83,1593,7077,2756,18.37,81.63,31.79
E02001676,Sheffield 066,5779,579,526,535,545,798,941,756,649,355,95,1105,4674,1855,19.12,80.88,32.1
E02001678,Sheffield 068,10295,1137,980,861,918,1296,1562,1408,1254,742,137,2117,8178,3541,20.56,79.44,34.4
E02001679,Sheffield 069,6551,974,619,1001,820,777,882,628,504,273,73,1593,4958,1478,24.32,75.68,22.56
E02001680,Sheffield 070,6449,981,619,1044,898,769,792,572,442,263,69,1600,4849,1346,24.81,75.19,20.87
E02001681,Sheffield 071,7644,851,688,668,776,1036,1124,1007,921,485,88,1539,6105,2501,20.13,79.87,32.72
E02006803,Sheffield 072,8935,868,810,1263,1034,1214,1436,1074,819,381,36,1678,7257,2310,18.78,81.22,25.85
E02006843,Sheffield 073,21171,429,356,17029,2340,588,243,106,55,14,11,785,20386,186,3.71,96.29,0.88
E02006844,Sheffield 074,11223,499,365,7768,1361,548,326,188,92,63,13,864,10359,356,7.7,92.3,3.17
E02006868,Sheffield 075,13564,1826,996,3549,2273,1481,1353,964,717,356,49,2822,10742,2086,20.81,79.19,15.38
E02006869,Sheffield 076,11049,1240,980,1627,1383,1403,1761,1062,946,488,159,2220,8829,2655,20.09,79.91,24.03
E02001708,Newcastle upon Tyne 001,13168,2099,1161,1679,2068,1759,1544,1453,923,400,82,3260,9908,2858,24.76,75.24,21.7
E02001709,Newcastle upon Tyne 002,10128,1160,1033,1106,1167,1422,1356,1202,988,536,158,2193,7935,2884,21.65,78.35,28.48
E02001710,Newcastle upon Tyne 003,9629,1227,917,1471,1216,1140,1325,1100,681,442,110,2144,7485,2333,22.27,77.73,24.23
E02001711,Newcastle upon Tyne 004,9366,1419,912,1307,1137,986,1296,1038,701,445,125,2331,7035,2309,24.89,75.11,24.65
E02001712,Newcastle upon Tyne 005,9501,1003,759,1861,1224,1130,1166,1069,744,401,144,1762,7739,2358,18.55,81.45,24.82
E02001713,Newcastle upon Tyne 006,10229,1240,931,1264,1295,1330,1510,1190,853,472,144,2171,8058,2659,21.22,78.78,25.99
E02001714,Newcastle upon Tyne 007,9480,1130,894,1244,1324,1218,1337,1196,661,364,112,2024,7456,2333,21.35,78.65,24.61
E02001715,Newcastle upon Tyne 008,11449,1788,1232,1681,1663,1410,1388,1081,714,405,87,3020,8429,2287,26.38,73.62,19.98
E02001718,Newcastle upon Tyne 011,6007,842,604,871,749,658,831,685,490,230,47,1446,4561,1452,24.07,75.93,24.17
E02001719,Newcastle upon Tyne 012,8520,857,716,1321,1193,1055,1159,1015,712,402,90,1573,6947,2219,18.46,81.54,26.04
E02001720,Newcastle upon Tyne 013,9299,325,301,6040,647,382,543,493,351,168,49,626,8673,1061,6.73,93.27,11.41
E02001721,Newcastle upon Tyne 014,10321,1187,883,1364,1238,1197,1519,1205,1062,553,113,2070,8251,2933,20.06,79.94,28.42
E02001722,Newcastle upon Tyne 015,9925,1334,956,1627,1139,902,1369,1003,825,663,107,2290,7635,2598,23.07,76.93,26.18
E02001723,Newcastle upon Tyne 016,6639,1091,747,1017,1007,796,744,566,369,244,58,1838,4801,1237,27.68,72.32,18.63
E02001724,Newcastle upon Tyne 017,8975,315,246,5280,893,474,548,471,409,253,86,561,8414,1219,6.25,93.75,13.58
E02001725,Newcastle upon Tyne 018,10178,647,447,4671,1776,834,732,485,341,184,61,1094,9084,1071,10.75,89.25,10.52
E02001726,Newcastle upon Tyne 019,12168,1697,1379,2178,1584,1409,1530,1165,756,385,85,3076,9092,2391,25.28,74.72,19.65
E02001727,Newcastle upon Tyne 020,8395,927,693,1249,1007,944,1284,1089,773,379,50,1620,6775,2291,19.3,80.7,27.29
E02001728,Newcastle upon Tyne 021,9362,1129,870,1358,1117,1094,1319,1103,875,439,58,1999,7363,2475,21.35,78.65,26.44
E02001729,Newcastle upon Tyne 022,14169,1892,1182,4924,2651,1426,940,623,301,181,49,3074,11095,1154,21.7,78.3,8.14
E02001730,Newcastle upon Tyne 023,20450,567,459,14200,2176,921,868,685,388,144,42,1026,19424,1259,5.02,94.98,6.16
E02001731,Newcastle upon Tyne 024,21576,892,749,14103,2508,1105,913,637,399,230,40,1641,19935,1306,7.61,92.39,6.05
E02001732,Newcastle upon Tyne 025,5335,771,544,760,709,565,700,663,408,181,34,1315,4020,1286,24.65,75.35,24.1
E02001733,Newcastle upon Tyne 026,12354,1549,1103,2473,1769,1399,1610,1184,784,400,83,2652,9702,2451,21.47,78.53,19.84
E02001734,Newcastle upon Tyne 027,8517,1356,917,1405,1146,956,969,818,577,301,72,2273,6244,1768,26.69,73.31,20.76
E02001735,Newcastle upon Tyne 028,6733,1103,808,1065,880,734,845,620,411,224,43,1911,4822,1298,28.38,71.62,19.28
E02001736,Newcastle upon Tyne 029,14638,2578,1763,2673,2506,1925,1304,1025,525,283,56,4341,10297,1889,29.66,70.34,12.9
E02001737,Newcastle upon Tyne 030,6037,869,521,1005,760,687,781,583,498,256,77,1390,4647,1414,23.02,76.98,23.42
E02006893,Newcastle upon Tyne 031,10272,1038,692,1205,1014,1060,1466,1493,1441,761,102,1730,8542,3797,16.84,83.16,36.96
E02001738,North Tyneside 001,6056,553,541,462,439,778,849,898,923,549,64,1094,4962,2434,18.06,81.94,40.19
E02001739,North Tyneside 002,7303,706,605,980,820,900,1122,1031,807,303,29,1311,5992,2170,17.95,82.05,29.71
E02001740,North Tyneside 003,6056,772,712,447,616,972,870,700,610,300,57,1484,4572,1667,24.5,75.5,27.53
E02001741,North Tyneside 004,7767,804,578,806,908,866,1112,1047,969,550,127,1382,6385,2693,17.79,82.21,34.67
E02001742,North Tyneside 005,5910,597,505,539,609,833,956,775,698,330,68,1102,4808,1871,18.65,81.35,31.66
E02001743,North Tyneside 006,7699,899,734,792,1078,1175,1196,898,615,235,77,1633,6066,1825,21.21,78.79,23.7
E02001744,North Tyneside 007,7495,996,663,881,1145,982,1051,803,564,328,82,1659,5836,1777,22.13,77.87,23.71
E02001745,North Tyneside 008,6616,783,644,861,955,860,898,737,585,261,32,1427,5189,1615,21.57,78.43,24.41
E02001746,North Tyneside 009,8294,900,917,882,1007,1195,1226,957,747,375,88,1817,6477,2167,21.91,78.09,26.13
E02001747,North Tyneside 010,6222,645,392,551,658,797,905,892,802,495,85,1037,5185,2274,16.67,83.33,36.55
E02001748,North Tyneside 011,8430,1165,887,1036,1343,1310,1061,815,544,231,38,2052,6378,1628,24.34,75.66,19.31
E02001749,North Tyneside 012,6358,646,489,722,836,810,944,888,665,312,46,1135,5223,1911,17.85,82.15,30.06
E02001750,North Tyneside 013,6879,732,610,694,779,931,997,890,746,409,91,1342,5537,2136,19.51,80.49,31.05
E02001751,North Tyneside 014,6145,738,487,766,782,784,909,745,556,313,65,1225,4920,1679,19.93,80.07,27.32
E02001752,North Tyneside 015,6430,818,699,855,881,812,789,691,558,290,37,1517,4913,1576,23.59,76.41,24.51
E02001753,North Tyneside 016,6300,622,446,611,822,868,948,947,630,336,70,1068,5232,1983,16.95,83.05,31.48
E02001754,North Tyneside 017,5878,550,436,629,722,848,895,754,622,329,93,986,4892,1798,16.77,83.23,30.59
E02001755,North Tyneside 018,9175,1068,816,1067,1288,1274,1383,993,778,396,112,1884,7291,2279,20.53,79.47,24.84
E02001756,North Tyneside 019,9523,1164,803,1582,1677,1109,1226,918,604,331,109,1967,7556,1962,20.66,79.34,20.6
E02001757,North Tyneside 020,5804,575,452,668,642,636,989,794,638,357,53,1027,4777,1842,17.69,82.31,31.74
E02001758,North Tyneside 021,5544,652,475,669,778,686,765,816,534,139,30,1127,4417,1519,20.33,79.67,27.4
E02001759,North Tyneside 022,6151,520,385,802,973,869,943,771,562,280,46,905,5246,1659,14.71,85.29,26.97
E02001760,North Tyneside 023,7905,1130,925,1153,1150,961,1085,738,492,221,50,2055,5850,1501,26.0,74.0,18.99
E02001761,North Tyneside 024,5380,537,415,670,694,618,785,695,617,304,45,952,4428,1661,17.7,82.3,30.87
E02001762,North Tyneside 025,6017,647,423,853,813,672,923,922,537,195,32,1070,4947,1686,17.78,82.22,28.02
E02001763,North Tyneside 026,6362,721,569,958,825,791,899,809,517,235,38,1290,5072,1599,20.28,79.72,25.13
E02001764,North Tyneside 027,7826,842,705,1130,1113,1055,1218,951,509,250,53,1547,6279,1763,19.77,80.23,22.53
E02001765,North Tyneside 028,7790,1068,785,1104,1238,1060,905,807,496,252,75,1853,5937,1630,23.79,76.21,20.92
E02001766,North Tyneside 029,7561,925,690,1317,1285,1011,992,714,446,163,18,1615,5946,1341,21.36,78.64,17.74
E02001767,North Tyneside 030,7037,717,571,1051,997,894,1097,841,523,270,76,1288,5749,1710,18.3,81.7,24.3
E02001768,South Tyneside 001,8518,893,783,1222,1219,1153,1229,1030,645,282,62,1676,6842,2019,19.68,80.32,23.7
E02001769,South Tyneside 002,8265,855,591,1543,1155,1099,1206,950,572,247,47,1446,6819,1816,17.5,82.5,21.97
E02001770,South Tyneside 003,6487,478,487,1060,799,895,1030,840,533,300,65,965,5522,1738,14.88,85.12,26.79
E02001771,South Tyneside 004,6581,812,595,801,697,672,956,833,628,428,159,1407,5174,2048,21.38,78.62,31.12
E02001772,South Tyneside 005,5487,535,481,797,651,694,755,653,543,315,63,1016,4471,1574,18.52,81.48,28.69
E02001773,South Tyneside 006,5280,438,416,505,549,514,904,891,653,352,58,854,4426,1954,16.17,83.83,37.01
E02001774,South Tyneside 007,5563,671,430,778,780,656,846,663,525,171,43,1101,4462,1402,19.79,80.21,25.2
E02001775,South Tyneside 008,5550,674,550,753,690,624,797,647,497,278,40,1224,4326,1462,22.05,77.95,26.34
E02001776,South Tyneside 009,8786,1086,759,1331,1325,1035,1247,997,624,297,85,1845,6941,2003,21.0,79.0,22.8
E02001777,South Tyneside 010,6302,683,505,924,871,773,1024,735,491,236,60,1188,5114,1522,18.85,81.15,24.15
E02001778,South Tyneside 011,5932,562,450,928,879,749,884,685,497,235,63,1012,4920,1480,17.06,82.94,24.95
E02001779,South Tyneside 012,5647,694,498,825,708,627,780,734,506,237,38,1192,4455,1515,21.11,78.89,26.83
E02001780,South Tyneside 013,6018,707,545,756,754,573,937,773,627,301,45,1252,4766,1746,20.8,79.2,29.01
E02001781,South Tyneside 014,5378,730,473,833,666,571,789,664,397,206,49,1203,4175,1316,22.37,77.63,24.47
E02001782,South Tyneside 015,9641,1277,926,1244,1270,1111,1326,1161,764,460,102,2203,7438,2487,22.85,77.15,25.8
E02001783,South Tyneside 016,7210,1214,720,1143,1026,736,928,731,440,227,45,1934,5276,1443,26.82,73.18,20.01
E02001784,South Tyneside 017,6635,712,651,831,788,763,1031,879,607,317,56,1363,5272,1859,20.54,79.46,28.02
E02001785,South Tyneside 018,7795,770,694,887,772,892,1238,1118,918,440,66,1464,6331,2542,18.78,81.22,32.61
E02001786,South Tyneside 019,6804,758,599,944,849,700,1127,840,569,370,48,1357,5447,1827,19.94,80.06,26.85
E02001787,South Tyneside 020,5406,659,483,625,659,612,779,697,661,199,32,1142,4264,1589,21.12,78.88,29.39
E02001788,South Tyneside 021,5846,646,461,789,764,662,974,806,484,223,37,1107,4739,1550,18.94,81.06,26.51
E02001789,South Tyneside 022,5677,550,462,514,485,672,922,846,751,406,69,1012,4665,2072,17.83,82.17,36.5
E02001790,South Tyneside 023,6168,622,583,747,717,796,890,766,608,370,69,1205,4963,1813,19.54,80.46,29.39
E02001791,Sunderland 001,5520,504,408,669,592,606,1009,691,634,353,54,912,4608,1732,16.52,83.48,31.38
E02001792,Sunderland 002,6706,496,496,736,606,799,1163,983,809,532,86,992,5714,2410,14.79,85.21,35.94
E02001793,Sunderland 003,8279,1180,771,1342,1101,962,1173,819,511,374,46,1951,6328,1750,23.57,76.43,21.14
E02001794,Sunderland 004,8781,1183,814,1238,1163,998,1195,947,719,433,91,1997,6784,2190,22.74,77.26,24.94
E02001795,Sunderland 005,7456,845,620,994,1008,840,1071,1024,658,352,44,1465,5991,2078,19.65,80.35,27.87
E02001796,Sunderland 006,9692,773,580,1862,1299,1084,1400,1222,916,499,57,1353,8339,2694,13.96,86.04,27.8
E02001797,Sunderland 007,5801,555,499,761,571,825,824,817,658,251,40,1054,4747,1766,18.17,81.83,30.44
E02001798,Sunderland 008,8241,996,762,1190,1002,987,1190,1078,649,335,52,1758,6483,2114,21.33,78.67,25.65
E02001799,Sunderland 009,9718,1317,948,1529,1345,1111,1305,1058,661,372,72,2265,7453,2163,23.31,76.69,22.26
E02001800,Sunderland 010,6842,733,680,934,805,887,915,988,705,183,12,1413,5429,1888,20.65,79.35,27.59
E02001801,Sunderland 011,6707,679,623,1882,876,753,800,549,332,181,32,1302,5405,1094,19.41,80.59,16.31
E02001802,Sunderland 012,6948,1098,688,1130,896,758,910,722,481,239,26,1786,5162,1468,25.71,74.29,21.13
E02001803,Sunderland 013,10024,740,606,3593,1539,1014,951,803,466,279,33,1346,8678,1581,13.43,86.57,15.77
E02001804,Sunderland 014,6539,726,538,905,935,813,908,728,626,290,70,1264,5275,1714,19.33,80.67,26.21
E02001805,Sunderland 015,5781,511,435,765,661,663,889,769,600,403,85,946,4835,1857,16.36,83.64,32.12
E02001806,Sunderland 016,8183,865,714,1511,1107,990,1129,973,560,295,39,1579,6604,1867,19.3,80.7,22.82
E02001807,Sunderland 017,8088,1154,777,1113,1057,1096,1066,876,677,245,27,1931,6157,1825,23.87,76.13,22.56
E02001808,Sunderland 018,6026,689,517,1163,913,686,755,609,426,233,35,1206,4820,1303,20.01,79.99,21.62
E02001809,Sunderland 019,6431,671,538,675,773,754,824,999,866,297,34,1209,5222,2196,18.8,81.2,34.15
E02001810,Sunderland 020,8369,867,726,1108,1124,1122,1154,1291,739,211,27,1593,6776,2268,19.03,80.97,27.1
E02001811,Sunderland 021,8969,1075,892,1312,1128,1047,1266,1017,785,398,49,1967,7002,2249,21.93,78.07,25.08
E02001812,Sunderland 022,10096,869,787,1309,992,1093,1546,1514,1209,674,103,1656,8440,3500,16.4,83.6,34.67
E02001813,Sunderland 023,9815,1314,1018,1598,1327,1185,1406,900,727,300,40,2332,7483,1967,23.76,76.24,20.04
E02001814,Sunderland 024,6185,680,592,901,758,808,893,720,508,286,39,1272,4913,1553,20.57,79.43,25.11
E02001815,Sunderland 025,9944,955,890,1042,1092,1202,1444,1738,1170,383,28,1845,8099,3319,18.55,81.45,33.38
E02001816,Sunderland 026,6894,709,522,923,812,790,1026,935,691,414,72,1231,5663,2112,17.86,82.14,30.64
E02001817,Sunderland 027,6572,770,588,975,793,727,891,803,607,348,70,1358,5214,1828,20.66,79.34,27.81
E02001818,Sunderland 028,9187,1138,906,1352,1246,1165,1310,1016,621,374,59,2044,7143,2070,22.25,77.75,22.53
E02001819,Sunderland 029,6667,570,445,754,654,715,1088,1029,916,451,45,1015,5652,2441,15.22,84.78,36.61
E02001820,Sunderland 030,9204,1176,872,1223,1158,1228,1324,1055,777,349,42,2048,7156,2223,22.25,77.75,24.15
E02001821,Sunderland 031,5539,487,476,716,624,709,1001,802,491,208,25,963,4576,1526,17.39,82.61,27.55
E02001822,Sunderland 032,7615,760,682,1086,914,991,1254,967,634,280,47,1442,6173,1928,18.94,81.06,25.32
E02001823,Sunderland 033,7732,1023,689,1127,1066,931,1140,813,604,298,41,1712,6020,1756,22.14,77.86,22.71
E02001824,Sunderland 034,8661,1018,702,1187,959,960,1244,1094,918,489,90,1720,6941,2591,19.86,80.14,29.92
E02001825,Sunderland 035,7234,679,484,968,783,779,1164,968,863,497,49,1163,6071,2377,16.08,83.92,32.86
E02001826,Sunderland 036,7259,1058,701,1053,980,857,909,834,630,208,29,1759,5500,1701,24.23,75.77,23.43
E02001827,Birmingham 001,6271,824,613,689,651,752,833,724,667,415,103,1437,4834,1909,22.92,77.08,30.44
E02001828,Birmingham 002,7006,788,680,797,699,854,979,743,806,537,123,1468,5538,2209,20.95,79.05,31.53
E02001829,Birmingham 003,8832,1263,963,933,940,1253,1198,835,866,488,93,2226,6606,2282,25.2,74.8,25.84
E02001830,Birmingham 004,9380,901,821,1108,773,1161,1427,1186,1142,694,167,1722,7658,3189,18.36,81.64,34.0
E02001831,Birmingham 005,10166,1360,1070,1530,1265,1204,1408,1012,779,412,126,2430,7736,2329,23.9,76.1,22.91
E02001832,Birmingham 006,7923,882,658,1080,774,992,1237,988,825,397,90,1540,6383,2300,19.44,80.56,29.03
E02001833,Birmingham 007,5793,724,537,791,684,678,860,651,540,283,45,1261,4532,1519,21.77,78.23,26.22
E02001834,Birmingham 008,6048,989,633,1019,814,702,780,492,366,203,50,1622,4426,1111,26.82,73.18,18.37
E02001835,Birmingham 009,8159,976,684,1051,1033,1093,1181,876,699,445,121,1660,6499,2141,20.35,79.65,26.24
E02001836,Birmingham 010,9469,1133,729,1631,1038,1065,1284,1100,878,501,110,1862,7607,2589,19.66,80.34,27.34
E02001837,Birmingham 011,10406,1697,1278,1773,1368,1214,1324,869,555,289,39,2975,7431,1752,28.59,71.41,16.84
E02001838,Birmingham 012,7317,724,616,901,757,894,1103,1098,771,356,97,1340,5977,2322,18.31,81.69,31.73
E02001839,Birmingham 013,6441,837,576,1032,830,709,890,642,547,296,82,1413,5028,1567,21.94,78.06,24.33
E02001840,Birmingham 014,9498,1491,1228,1600,1256,1042,1168,819,531,284,79,2719,6779,1713,28.63,71.37,18.04
E02001841,Birmingham 015,5587,550,484,594,445,668,820,823,777,335,91,1034,4553,2026,18.51,81.49,36.26
E02001842,Birmingham 016,7516,988,777,1213,1012,857,1037,695,583,302,52,1765,5751,1632,23.48,76.52,21.71
E02001843,Birmingham 017,6661,904,599,1084,911,710,908,627,548,317,53,1503,5158,1545,22.56,77.44,23.19
E02001844,Birmingham 018,9795,1041,678,1361,1282,1147,1345,1128,977,659,177,1719,8076,2941,17.55,82.45,30.03
E02001845,Birmingham 019,6517,968,664,1145,859,804,930,522,454,141,30,1632,4885,1147,25.04,74.96,17.6
E02001846,Birmingham 020,8197,1302,818,1363,1186,960,1085,705,504,230,44,2120,6077,1483,25.86,74.14,18.09
E02001847,Birmingham 021,5381,644,421,629,615,638,726,771,572,296,69,1065,4316,1708,19.79,80.21,31.74
E02001848,Birmingham 022,7154,1296,820,1215,972,859,788,523,390,224,67,2116,5038,1204,29.58,70.42,16.83
E02001849,Birmingham 023,8286,1589,792,1491,1350,991,841,634,369,197,32,2381,5905,1232,28.74,71.26,14.87
E02001850,Birmingham 024,8275,1210,878,1450,1205,999,962,666,551,309,45,2088,6187,1571,25.23,74.77,18.98
E02001851,Birmingham 025,8916,1217,842,1367,1186,1088,1276,879,643,343,75,2059,6857,1940,23.09,76.91,21.76
E02001852,Birmingham 026,7226,1067,686,1290,1079,831,914,640,423,247,49,1753,5473,1359,24.26,75.74,18.81
E02001854,Birmingham 028,7750,1072,717,1239,1089,871,1082,717,582,312,69,1789,5961,1680,23.08,76.92,21.68
E02001855,Birmingham 029,9750,1307,1107,1673,1166,1070,1375,865,636,466,85,2414,7336,2052,24.76,75.24,21.05
E02001856,Birmingham 030,9760,1505,1009,1922,1780,1223,1065,671,338,203,44,2514,7246,1256,25.76,74.24,12.87
E02001857,Birmingham 031,14325,1847,1512,3069,2368,1744,1795,999,627,299,65,3359,10966,1990,23.45,76.55,13.89
E02001858,Birmingham 032,9249,1112,965,2113,1337,1212,1106,764,394,209,37,2077,7172,1404,22.46,77.54,15.18
E02001859,Birmingham 033,10723,1628,1396,2456,1693,1322,951,642,326,256,53,3024,7699,1277,28.2,71.8,11.91
E02001860,Birmingham 034,9423,1475,1233,1771,1449,1323,954,603,335,227,53,2708,6715,1218,28.74,71.26,12.93
E02001861,Birmingham 035,10932,1677,1513,2367,1618,1399,1033,691,337,248,49,3190,7742,1325,29.18,70.82,12.12
E02001862,Birmingham 036,10848,1678,1359,1942,1632,1462,1248,771,399,306,51,3037,7811,1527,28.0,72.0,14.08
E02001863,Birmingham 037,8103,1399,1135,1635,1236,1011,718,485,261,191,32,2534,5569,969,31.27,68.73,11.96
E02001864,Birmingham 038,5610,1056,812,964,762,653,613,323,281,116,30,1868,3742,750,33.3,66.7,13.37
E02001865,Birmingham 039,11640,1837,1495,2175,1960,1472,1216,772,431,221,61,3332,8308,1485,28.63,71.37,12.76
E02001866,Birmingham 040,9115,1411,1277,1826,1440,1253,884,515,272,198,39,2688,6427,1024,29.49,70.51,11.23
E02001867,Birmingham 041,7779,1451,1241,1475,1094,1000,644,425,286,135,28,2692,5087,874,34.61,65.39,11.24
E02001868,Birmingham 042,9561,1591,1360,1932,1241,1133,860,615,449,322,58,2951,6610,1444,30.86,69.14,15.1
E02001869,Birmingham 043,6857,1449,1029,1157,985,838,642,383,242,112,20,2478,4379,757,36.14,63.86,11.04
E02001870,Birmingham 044,12739,2369,1994,2401,1808,1545,1114,712,438,295,63,4363,8376,1508,34.25,65.75,11.84
E02001871,Birmingham 045,8228,1252,862,1359,1121,897,953,786,611,283,104,2114,6114,1784,25.69,74.31,21.68
E02001872,Birmingham 046,7387,1229,756,1228,982,829,863,661,509,240,90,1985,5402,1500,26.87,73.13,20.31
E02001873,Birmingham 047,11925,2065,1531,2345,1956,1589,1113,682,394,209,41,3596,8329,1326,30.16,69.84,11.12
E02001874,Birmingham 048,10155,1893,1611,2116,1526,1157,835,524,291,163,39,3504,6651,1017,34.51,65.49,10.01
E02001875,Birmingham 049,9634,1596,1213,2383,1537,1166,811,462,250,184,32,2809,6825,928,29.16,70.84,9.63
E02001876,Birmingham 050,14628,1345,1115,8324,1522,961,672,332,196,130,31,2460,12168,689,16.82,83.18,4.71
E02001877,Birmingham 051,11776,2254,1862,2427,1743,1370,892,617,300,260,51,4116,7660,1228,34.95,65.05,10.43
E02001878,Birmingham 052,9067,1592,1358,1949,1366,1106,779,457,223,195,42,2950,6117,917,32.54,67.46,10.11
E02001879,Birmingham 053,10672,1621,1258,2429,1757,1290,987,663,328,263,76,2879,7793,1330,26.98,73.02,12.46
E02001880,Birmingham 054,9847,1963,1325,1739,1425,1087,1002,658,415,189,44,3288,6559,1306,33.39,66.61,13.26
E02001881,Birmingham 055,10360,2144,1716,1963,1465,1179,827,533,297,184,52,3860,6500,1066,37.26,62.74,10.29
E02001882,Birmingham 056,8645,1453,971,1583,1233,994,856,667,508,312,68,2424,6221,1555,28.04,71.96,17.99
E02001883,Birmingham 057,8278,1432,833,1380,1180,907,1057,681,498,254,56,2265,6013,1489,27.36,72.64,17.99
E02001884,Birmingham 058,10090,2095,1796,2036,1427,1214,747,405,206,125,39,3891,6199,775,38.56,61.44,7.68
E02001886,Birmingham 060,10426,1386,997,2540,1644,1378,1006,723,474,231,47,2383,8043,1475,22.86,77.14,14.15
E02001888,Birmingham 062,6720,1108,837,1122,912,725,744,552,412,255,53,1945,4775,1272,28.94,71.06,18.93
E02001889,Birmingham 063,8967,1658,1473,1859,1179,1097,720,491,268,190,32,3131,5836,981,34.92,65.08,10.94
E02001890,Birmingham 064,11244,1064,745,3190,2018,1371,1098,736,640,311,71,1809,9435,1758,16.09,83.91,15.64
E02001892,Birmingham 066,10994,2174,1652,2021,1532,1281,1067,583,409,236,39,3826,7168,1267,34.8,65.2,11.52
E02001893,Birmingham 067,8494,1185,945,1411,1031,916,1106,819,605,404,72,2130,6364,1900,25.08,74.92,22.37
E02001895,Birmingham 069,8972,1430,1014,1527,1163,993,1050,800,600,311,84,2444,6528,1795,27.24,72.76,20.01
E02001896,Birmingham 070,9568,1774,1340,1909,1424,1176,882,527,266,241,29,3114,6454,1063,32.55,67.45,11.11
E02001897,Birmingham 071,8322,1436,1078,1687,1288,952,817,536,270,203,55,2514,5808,1064,30.21,69.79,12.79
E02001898,Birmingham 072,6284,768,513,994,758,677,973,666,563,322,50,1281,5003,1601,20.39,79.61,25.48
E02001899,Birmingham 073,8336,950,705,1086,1072,1143,984,858,827,570,141,1655,6681,2396,19.85,80.15,28.74
E02001900,Birmingham 074,7307,838,771,1881,918,845,732,577,396,279,70,1609,5698,1322,22.02,77.98,18.09
E02001901,Birmingham 075,8419,1077,520,1818,1523,1027,971,683,457,265,78,1597,6822,1483,18.97,81.03,17.61
E02001902,Birmingham 076,6065,872,579,970,821,702,825,627,391,241,37,1451,4614,1296,23.92,76.08,21.37
E02001903,Birmingham 077,7475,1254,1041,1644,1126,887,655,489,231,125,23,2295,5180,868,30.7,69.3,11.61
E02001904,Birmingham 078,7783,1479,910,1350,1257,946,803,530,286,184,38,2389,5394,1038,30.7,69.3,13.34
E02001905,Birmingham 079,12081,749,723,6532,992,973,753,556,442,274,87,1472,10609,1359,12.18,87.82,11.25
E02001906,Birmingham 080,9160,1231,926,1354,1209,1218,1252,862,654,388,66,2157,7003,1970,23.55,76.45,21.51
E02001907,Birmingham 081,10028,1259,862,1602,1317,1170,1391,963,885,498,81,2121,7907,2427,21.15,78.85,24.2
E02001908,Birmingham 082,8916,1552,1285,1925,1341,1156,692,494,250,195,26,2837,6079,965,31.82,68.18,10.82
E02001909,Birmingham 083,8228,1385,1231,1724,1202,1014,732,471,241,193,35,2616,5612,940,31.79,68.21,11.42
E02001910,Birmingham 084,7210,1108,1023,1614,1036,789,678,483,267,175,37,2131,5079,962,29.56,70.44,13.34
E02001911,Birmingham 085,8479,1467,1110,1408,1202,1075,895,572,478,216,56,2577,5902,1322,30.39,69.61,15.59
E02001913,Birmingham 087,8783,905,550,3028,1266,879,755,590,487,253,70,1455,7328,1400,16.57,83.43,15.94
E02001914,Birmingham 088,6896,843,743,1408,1079,910,747,583,336,207,40,1586,5310,1166,23.0,77.0,16.91
E02001915,Birmingham 089,12260,1742,1069,2212,1888,1547,1488,1062,734,400,118,2811,9449,2314,22.93,77.07,18.87
E02001916,Birmingham 090,9640,1740,1236,1889,1332,1215,941,587,415,229,56,2976,6664,1287,30.87,69.13,13.35
E02001918,Birmingham 092,8984,911,676,1815,1435,1233,1188,900,523,249,54,1587,7397,1726,17.66,82.34,19.21
E02001919,Birmingham 093,6746,740,522,1450,1035,869,768,644,366,276,76,1262,5484,1362,18.71,81.29,20.19
E02001920,Birmingham 094,7598,1145,855,1244,932,950,877,752,621,193,29,2000,5598,1595,26.32,73.68,20.99
E02001921,Birmingham 095,8059,1192,843,1379,1204,995,879,682,560,281,44,2035,6024,1567,25.25,74.75,19.44
E02001922,Birmingham 096,17801,434,342,15444,508,384,281,178,133,75,22,776,17025,408,4.36,95.64,2.29
E02001923,Birmingham 097,10995,1636,1413,2067,1489,1371,1112,891,602,328,86,3049,7946,1907,27.73,72.27,17.34
E02001924,Birmingham 098,6598,940,781,1102,847,751,899,628,353,249,48,1721,4877,1278,26.08,73.92,19.37
E02001925,Birmingham 099,6865,871,543,1576,820,773,670,674,545,297,96,1414,5451,1612,20.6,79.4,23.48
E02001926,Birmingham 100,7903,875,529,2225,1191,941,757,590,423,294,78,1404,6499,1385,17.77,82.23,17.52
E02001927,Birmingham 101,7943,1243,905,1334,1004,961,943,679,498,290,86,2148,5795,1553,27.04,72.96,19.55
E02001928,Birmingham 102,6852,975,671,1058,821,806,867,766,632,205,51,1646,5206,1654,24.02,75.98,24.14
E02001929,Birmingham 103,10102,1792,1297,1782,1509,1190,1141,659,465,223,44,3089,7013,1391,30.58,69.42,13.77
E02001930,Birmingham 104,7874,990,710,1348,1241,1173,984,780,419,192,37,1700,6174,1428,21.59,78.41,18.14
E02001931,Birmingham 105,8167,1039,885,1286,1019,948,1031,908,632,354,65,1924,6243,1959,23.56,76.44,23.99
E02001932,Birmingham 106,7583,1285,804,1472,1020,839,870,587,415,240,51,2089,5494,1293,27.55,72.45,17.05
E02001933,Birmingham 107,7276,989,720,1096,1117,943,938,669,495,237,72,1709,5567,1473,23.49,76.51,20.24
E02001934,Birmingham 108,6968,947,771,1150,896,840,869,667,498,263,67,1718,5250,1495,24.66,75.34,21.46
E02001935,Birmingham 109,7954,1070,887,1072,985,984,975,776,650,418,137,1957,5997,1981,24.6,75.4,24.91
E02001936,Birmingham 110,6529,896,661,819,738,874,875,710,587,320,49,1557,4972,1666,23.85,76.15,25.52
E02001937,Birmingham 111,8153,1309,909,1263,1231,903,970,744,469,302,53,2218,5935,1568,27.2,72.8,19.23
E02001938,Birmingham 112,7965,986,654,1441,1322,1072,1045,708,443,231,63,1640,6325,1445,20.59,79.41,18.14
E02001939,Birmingham 113,6206,761,490,837,659,715,802,747,674,417,104,1251,4955,1942,20.16,79.84,31.29
E02001941,Birmingham 115,6154,982,641,1003,842,657,703,568,425,280,53,1623,4531,1326,26.37,73.63,21.55
E02001942,Birmingham 116,6812,859,659,1088,934,801,908,706,496,297,64,1518,5294,1563,22.28,77.72,22.94
E02001943,Birmingham 117,6357,888,615,946,905,796,874,617,421,258,37,1503,4854,1333,23.64,76.36,20.97
E02001944,Birmingham 118,8154,1103,760,1336,1155,1079,1119,743,571,228,60,1863,6291,1602,22.85,77.15,19.65
E02001945,Birmingham 119,7581,1152,962,1300,963,972,934,669,420,176,33,2114,5467,1298,27.89,72.11,17.12
E02001946,Birmingham 120,7580,928,663,1081,909,893,1056,928,688,363,71,1591,5989,2050,20.99,79.01,27.04
E02001947,Birmingham 121,6276,1055,672,1085,833,607,736,570,405,260,53,1727,4549,1288,27.52,72.48,20.52
E02001948,Birmingham 122,7288,994,626,1233,930,764,1042,745,548,329,77,1620,5668,1699,22.23,77.77,23.31
E02001949,Birmingham 123,6049,1007,585,1023,780,683,757,519,390,233,72,1592,4457,1214,26.32,73.68,20.07
E02001950,Birmingham 124,8312,1019,768,1377,974,976,1163,902,702,362,69,1787,6525,2035,21.5,78.5,24.48
E02001951,Birmingham 125,8867,1501,1008,1388,1254,946,974,961,605,192,38,2509,6358,1796,28.3,71.7,20.25
E02001952,Birmingham 126,9256,1350,1037,1689,1203,1034,1175,864,574,249,81,2387,6869,1768,25.79,74.21,19.1
E02001953,Birmingham 127,6983,839,693,880,786,825,955,772,735,400,98,1532,5451,2005,21.94,78.06,28.71
E02001954,Birmingham 128,7505,1139,902,1203,916,898,832,764,591,222,38,2041,5464,1615,27.2,72.8,21.52
E02001955,Birmingham 129,7348,1163,613,1308,1010,847,858,628,520,331,70,1776,5572,1549,24.17,75.83,21.08
E02001956,Birmingham 130,6763,991,690,1076,893,832,921,626,450,227,57,1681,5082,1360,24.86,75.14,20.11
E02001957,Birmingham 131,7677,958,676,1239,951,907,1111,782,685,297,71,1634,6043,1835,21.28,78.72,23.9
E02006807,Birmingham 132,7822,1067,839,1051,1046,1105,960,791,555,350,58,1906,5916,1754,24.37,75.63,22.42
E02006809,Birmingham 133,10279,1201,1052,1825,1450,1193,1386,1088,592,387,105,2253,8026,2172,21.92,78.08,21.13
E02006895,Birmingham 134,9818,1128,723,3914,2014,819,533,337,200,116,34,1851,7967,687,18.85,81.15,7.0
E02006896,Birmingham 135,7434,640,196,3471,1617,640,391,252,144,74,9,836,6598,479,11.25,88.75,6.44
E02006897,Birmingham 136,8433,904,561,3287,1586,934,599,317,166,66,13,1465,6968,562,17.37,82.63,6.66
E02006898,Birmingham 137,8195,769,449,3039,1806,902,610,381,171,58,10,1218,6977,620,14.86,85.14,7.57
E02006899,Birmingham 138,8386,319,62,4568,2012,667,456,159,99,21,23,381,8005,302,4.54,95.46,3.6
E02006900,Birmingham 139,15672,2915,2388,3180,2241,1931,1222,933,460,350,52,5303,10369,1795,33.84,66.16,11.45
E02006901,Birmingham 140,15561,2947,2460,2901,2481,1956,1187,864,443,275,47,5407,10154,1629,34.75,65.25,10.47
E02001958,Coventry 001,8110,1059,735,1507,1299,942,1057,693,562,236,20,1794,6316,1511,22.12,77.88,18.63
E02001959,Coventry 002,6859,905,666,1019,1052,845,867,594,553,324,34,1571,5288,1505,22.9,77.1,21.94
E02001961,Coventry 004,8498,1349,910,1401,1324,1041,1085,675,465,217,31,2259,6239,1388,26.58,73.42,16.33
E02001962,Coventry 005,7261,1333,808,1333,1295,887,665,478,267,168,27,2141,5120,940,29.49,70.51,12.95
E02001963,Coventry 006,6213,666,610,903,833,772,846,762,480,273,68,1276,4937,1583,20.54,79.46,25.48
E02001964,Coventry 007,10254,2021,1380,1626,1563,1192,950,782,439,268,33,3401,6853,1522,33.17,66.83,14.84
E02001965,Coventry 008,8377,1017,751,1311,1180,993,1085,952,663,355,70,1768,6609,2040,21.11,78.89,24.35
E02001966,Coventry 009,7817,1516,949,1531,1368,971,658,406,229,170,19,2465,5352,824,31.53,68.47,10.54
E02001967,Coventry 010,6749,754,562,857,801,840,898,734,842,368,93,1316,5433,2037,19.5,80.5,30.18
E02001968,Coventry 011,8387,1367,964,1457,1483,1121,828,603,344,178,42,2331,6056,1167,27.79,72.21,13.91
E02001969,Coventry 012,7168,980,748,1273,1128,854,834,567,422,309,53,1728,5440,1351,24.11,75.89,18.85
E02001970,Coventry 013,6085,804,425,1022,856,666,683,535,608,409,77,1229,4856,1629,20.2,79.8,26.77
E02001971,Coventry 014,6076,841,604,916,809,766,815,561,500,214,50,1445,4631,1325,23.78,76.22,21.81
E02001972,Coventry 015,12198,2338,1461,2657,2201,1440,921,672,347,124,37,3799,8399,1180,31.14,68.86,9.67
E02001973,Coventry 016,9288,1409,882,1911,1620,1062,1016,660,489,187,52,2291,6997,1388,24.67,75.33,14.94
E02001974,Coventry 017,9786,1276,859,1483,1512,1223,1263,877,792,415,86,2135,7651,2170,21.82,78.18,22.17
E02001975,Coventry 018,8365,1153,888,1457,1244,1019,1082,725,506,226,65,2041,6324,1522,24.4,75.6,18.19
E02001976,Coventry 019,7862,1005,751,1194,1181,982,956,776,611,337,69,1756,6106,1793,22.34,77.66,22.81
E02001977,Coventry 020,11744,1308,878,4120,1957,1197,944,642,433,208,57,2186,9558,1340,18.61,81.39,11.41
E02001978,Coventry 021,7037,860,660,1378,1140,873,857,602,382,232,53,1520,5517,1269,21.6,78.4,18.03
E02001979,Coventry 022,5888,728,500,773,902,692,724,528,548,404,89,1228,4660,1569,20.86,79.14,26.65
E02001980,Coventry 023,5890,535,407,775,575,670,829,734,872,436,57,942,4948,2099,15.99,84.01,35.64
E02001981,Coventry 024,15819,1932,1377,6922,2308,1360,876,576,300,150,18,3309,12510,1044,20.92,79.08,6.6
E02001982,Coventry 025,8868,1116,727,1649,1474,1013,1020,762,668,356,83,1843,7025,1869,20.78,79.22,21.08
E02001983,Coventry 026,8094,1032,635,1366,1252,1007,1039,784,589,318,72,1667,6427,1763,20.6,79.4,21.78
E02001984,Coventry 027,10902,1400,910,2412,1837,1235,1299,863,600,273,73,2310,8592,1809,21.19,78.81,16.59
E02001985,Coventry 028,12841,831,605,8209,1342,698,533,315,203,86,19,1436,11405,623,11.18,88.82,4.85
E02001986,Coventry 029,8855,1328,758,1604,1353,1028,1029,742,635,318,60,2086,6769,1755,23.56,76.44,19.82
E02001987,Coventry 030,7150,532,334,3033,1200,646,498,374,313,178,42,866,6284,907,12.11,87.89,12.69
E02001988,Coventry 031,17409,797,569,11948,1707,782,627,470,305,145,59,1366,16043,979,7.85,92.15,5.62
E02001989,Coventry 032,6575,867,567,1420,1072,712,726,559,425,180,47,1434,5141,1211,21.81,78.19,18.42
E02001990,Coventry 033,9309,1028,800,1181,1327,1114,1340,1087,861,468,103,1828,7481,2519,19.64,80.36,27.06
E02001991,Coventry 034,9009,705,684,1809,1092,1052,1160,1131,838,415,123,1389,7620,2507,15.42,84.58,27.83
E02001992,Coventry 035,10708,1684,1229,1739,1616,1260,1264,860,710,286,60,2913,7795,1916,27.2,72.8,17.89
E02001993,Coventry 036,8666,1079,842,2113,1198,816,971,740,569,252,86,1921,6745,1647,22.17,77.83,19.01
E02001994,Coventry 037,9035,1136,810,1504,1556,1121,1013,777,698,350,70,1946,7089,1895,21.54,78.46,20.97
E02001995,Coventry 038,10794,1532,651,2711,2402,1095,821,646,547,292,97,2183,8611,1582,20.22,79.78,14.66
E02001996,Coventry 039,7477,1244,817,1327,1219,857,790,567,414,208,34,2061,5416,1223,27.56,72.44,16.36
E02001997,Coventry 040,8758,973,777,1111,1056,1068,1160,1032,923,523,135,1750,7008,2613,19.98,80.02,29.84
E02001998,Coventry 041,5861,612,636,719,710,781,786,608,617,326,66,1248,4613,1617,21.29,78.71,27.59
E02001999,Coventry 042,9967,441,502,5505,490,667,741,670,612,265,74,943,9024,1621,9.46,90.54,16.26
E02006805,Coventry 043,9512,1568,1076,1566,1706,1148,1020,678,439,265,46,2644,6868,1428,27.8,72.2,15.01
E02002000,Dudley 001,7975,1035,799,1146,962,1003,1100,859,653,365,53,1834,6141,1930,23.0,77.0,24.2
E02002001,Dudley 002,6068,644,592,898,663,784,937,652,558,283,57,1236,4832,1550,20.37,79.63,25.54
E02002002,Dudley 003,6844,544,505,640,601,779,1052,902,1082,621,118,1049,5795,2723,15.33,84.67,39.79
E02002003,Dudley 004,9093,993,819,1158,1072,1066,1458,973,878,596,80,1812,7281,2527,19.93,80.07,27.79
E02002004,Dudley 005,7469,925,819,1109,944,902,1079,710,568,365,48,1744,5725,1691,23.35,76.65,22.64
E02002005,Dudley 006,9544,1727,1151,1488,1288,1122,1108,744,618,263,35,2878,6666,1660,30.16,69.84,17.39
E02002006,Dudley 007,6487,812,559,932,903,806,946,708,497,291,33,1371,5116,1529,21.13,78.87,23.57
E02002007,Dudley 008,9016,997,736,1098,1035,1019,1306,936,1113,697,79,1733,7283,2825,19.22,80.78,31.33
E02002008,Dudley 009,8342,911,784,1253,1066,1167,1443,854,536,259,69,1695,6647,1718,20.32,79.68,20.59
E02002009,Dudley 010,6929,1158,891,1040,986,942,784,551,369,185,23,2049,4880,1128,29.57,70.43,16.28
E02002010,Dudley 011,8106,1156,810,1330,1195,1096,977,701,471,299,71,1966,6140,1542,24.25,75.75,19.02
E02002011,Dudley 012,5581,501,485,573,579,619,874,789,723,370,68,986,4595,1950,17.67,82.33,34.94
E02002012,Dudley 013,8496,1176,805,1287,1071,1063,1161,797,635,428,73,1981,6515,1933,23.32,76.68,22.75
E02002013,Dudley 014,6462,529,583,629,536,840,983,862,894,489,117,1112,5350,2362,17.21,82.79,36.55
E02002014,Dudley 015,7907,1287,867,1271,1258,942,917,615,458,242,50,2154,5753,1365,27.24,72.76,17.26
E02002015,Dudley 016,6591,863,575,896,858,791,960,680,596,313,59,1438,5153,1648,21.82,78.18,25.0
E02002016,Dudley 017,7970,1317,871,1207,1084,944,954,749,523,280,41,2188,5782,1593,27.45,72.55,19.99
E02002017,Dudley 018,8714,1056,826,1464,1206,1066,1123,836,702,369,66,1882,6832,1973,21.6,78.4,22.64
E02002018,Dudley 019,8850,886,803,912,776,1111,1354,1064,1233,616,95,1689,7161,3008,19.08,80.92,33.99
E02002019,Dudley 020,8024,1093,893,1184,1057,965,1058,798,615,324,37,1986,6038,1774,24.75,75.25,22.11
E02002020,Dudley 021,9710,1000,784,1255,1138,1247,1375,1047,1210,576,78,1784,7926,2911,18.37,81.63,29.98
E02002021,Dudley 022,7763,1124,655,1505,1225,951,964,597,475,221,46,1779,5984,1339,22.92,77.08,17.25
E02002022,Dudley 023,8822,1295,930,1359,1271,1141,1133,851,538,255,49,2225,6597,1693,25.22,74.78,19.19
E02002023,Dudley 024,5445,582,470,644,680,693,761,612,750,220,33,1052,4393,1615,19.32,80.68,29.66
E02002024,Dudley 025,8862,1170,868,1243,1192,1096,1113,949,773,384,74,2038,6824,2180,23.0,77.0,24.6
E02002025,Dudley 026,8215,1077,771,1186,1138,1011,1222,768,637,350,55,1848,6367,1810,22.5,77.5,22.03
E02002026,Dudley 027,6708,669,606,833,813,836,1025,874,766,253,33,1275,5433,1926,19.01,80.99,28.71
E02002027,Dudley 028,5401,524,472,679,662,707,888,864,472,101,32,996,4405,1469,18.44,81.56,27.2
E02002028,Dudley 029,5874,597,384,666,702,715,831,720,695,462,102,981,4893,1979,16.7,83.3,33.69
E02002029,Dudley 030,6010,617,485,686,679,752,886,738,661,414,92,1102,4908,1905,18.34,81.66,31.7
E02002030,Dudley 031,6551,792,621,949,884,878,875,671,574,253,54,1413,5138,1552,21.57,78.43,23.69
E02002031,Dudley 032,6146,724,565,999,852,723,822,752,476,191,42,1289,4857,1461,20.97,79.03,23.77
E02002032,Dudley 033,10180,1475,1025,1537,1487,1227,1292,937,777,368,55,2500,7680,2137,24.56,75.44,20.99
E02002033,Dudley 034,7970,874,822,1067,990,988,1058,908,825,383,55,1696,6274,2171,21.28,78.72,27.24
E02002034,Dudley 035,8098,869,686,1098,1096,1141,1168,914,710,341,75,1555,6543,2040,19.2,80.8,25.19
E02002035,Dudley 036,6250,668,522,667,695,763,890,879,737,309,120,1190,5060,2045,19.04,80.96,32.72
E02002036,Dudley 037,6694,960,625,1036,962,782,847,685,546,201,50,1585,5109,1482,23.68,76.32,22.14
E02002037,Dudley 038,5979,663,547,682,697,757,849,802,662,275,45,1210,4769,1784,20.24,79.76,29.84
E02002038,Dudley 039,9578,1028,883,1336,1189,1248,1272,1056,1082,417,67,1911,7667,2622,19.95,80.05,27.38
E02002039,Dudley 040,6403,640,795,749,742,781,844,686,671,374,121,1435,4968,1852,22.41,77.59,28.92
E02002040,Dudley 041,6102,579,470,606,534,716,924,905,836,439,93,1049,5053,2273,17.19,82.81,37.25
E02002041,Dudley 042,6180,613,592,626,570,732,842,759,873,483,90,1205,4975,2205,19.5,80.5,35.68
E02002042,Dudley 043,8187,866,777,801,914,1012,1226,1035,952,507,97,1643,6544,2591,20.07,79.93,31.65
E02002043,Sandwell 001,8732,1216,990,1251,1180,1062,1252,908,521,293,59,2206,6526,1781,25.26,74.74,20.4
E02002044,Sandwell 002,7730,1222,847,1236,1142,1008,972,631,445,182,45,2069,5661,1303,26.77,73.23,16.86
E02002045,Sandwell 003,7825,1101,822,1020,1118,973,1060,790,563,341,37,1923,5902,1731,24.58,75.42,22.12
E02002046,Sandwell 004,5668,1007,706,828,761,668,699,574,287,120,18,1713,3955,999,30.22,69.78,17.63
E02002047,Sandwell 005,6799,802,566,979,857,751,876,802,700,389,77,1368,5431,1968,20.12,79.88,28.95
E02002048,Sandwell 006,6480,598,549,851,749,844,983,771,663,395,77,1147,5333,1906,17.7,82.3,29.41
E02002049,Sandwell 007,6153,850,560,987,871,744,828,578,506,166,63,1410,4743,1313,22.92,77.08,21.34
E02002051,Sandwell 009,5692,943,734,857,815,636,695,491,355,148,18,1677,4015,1012,29.46,70.54,17.78
E02002052,Sandwell 010,11567,1777,1256,1802,1688,1475,1447,882,715,399,126,3033,8534,2122,26.22,73.78,18.35
E02002053,Sandwell 011,6899,805,693,957,909,852,998,726,580,305,74,1498,5401,1685,21.71,78.29,24.42
E02002054,Sandwell 012,5608,653,504,709,820,654,772,569,584,297,46,1157,4451,1496,20.63,79.37,26.68
E02002055,Sandwell 013,10063,1372,1072,1442,1638,1318,1197,996,620,325,83,2444,7619,2024,24.29,75.71,20.11
E02002056,Sandwell 014,9333,1562,969,1574,1353,1162,1078,762,566,243,64,2531,6802,1635,27.12,72.88,17.52
E02002057,Sandwell 015,9837,1348,979,1469,1436,1332,1243,945,665,335,85,2327,7510,2030,23.66,76.34,20.64
E02002058,Sandwell 016,12610,1775,1265,1998,2052,1831,1658,1099,606,271,55,3040,9570,2031,24.11,75.89,16.11
E02002059,Sandwell 017,11206,1549,1116,1652,1687,1428,1455,1086,740,405,88,2665,8541,2319,23.78,76.22,20.69
E02002060,Sandwell 018,6915,1118,844,1002,1093,893,753,552,369,265,26,1962,4953,1212,28.37,71.63,17.53
E02002061,Sandwell 019,6193,867,733,931,940,812,625,549,398,281,57,1600,4593,1285,25.84,74.16,20.75
E02002062,Sandwell 020,8811,1426,938,1219,1387,1155,1036,748,536,309,57,2364,6447,1650,26.83,73.17,18.73
E02002063,Sandwell 021,10175,1639,1052,1570,1803,1346,1164,766,518,271,46,2691,7484,1601,26.45,73.55,15.73
E02002064,Sandwell 022,12397,1869,1280,1801,1828,1525,1678,1077,851,406,82,3149,9248,2416,25.4,74.6,19.49
E02002065,Sandwell 023,13403,2303,1747,2226,2213,1770,1325,849,573,338,59,4050,9353,1819,30.22,69.78,13.57
E02002066,Sandwell 024,8125,1278,1019,1298,1228,1076,924,619,441,202,40,2297,5828,1302,28.27,71.73,16.02
E02002067,Sandwell 025,5576,696,591,688,775,612,734,531,595,306,48,1287,4289,1480,23.08,76.92,26.54
E02002068,Sandwell 026,14320,2740,2008,2495,2383,1934,1359,708,406,248,39,4748,9572,1401,33.16,66.84,9.78
E02002069,Sandwell 027,6958,959,630,1092,917,823,931,664,584,321,37,1589,5369,1606,22.84,77.16,23.08
E02002070,Sandwell 028,9814,1652,1105,1465,1570,1307,1064,673,559,342,77,2757,7057,1651,28.09,71.91,16.82
E02002071,Sandwell 029,6604,993,692,990,861,765,863,613,568,228,31,1685,4919,1440,25.51,74.49,21.8
E02002072,Sandwell 030,8678,1071,829,1386,1212,1155,1200,852,598,307,68,1900,6778,1825,21.89,78.11,21.03
E02002073,Sandwell 031,7922,1177,961,1112,1067,982,1044,683,602,237,57,2138,5784,1579,26.99,73.01,19.93
E02002074,Sandwell 032,8105,1136,872,1103,1063,1008,1120,804,650,284,65,2008,6097,1803,24.77,75.23,22.25
E02002075,Sandwell 033,8739,1093,845,1363,1267,1057,1157,834,712,341,70,1938,6801,1957,22.18,77.82,22.39
E02002076,Sandwell 034,11238,1570,1040,1908,2072,1568,1419,786,520,298,57,2610,8628,1661,23.22,76.78,14.78
E02002077,Sandwell 035,10421,1429,1010,1577,1488,1204,1347,1013,854,419,80,2439,7982,2366,23.4,76.6,22.7
E02002078,Sandwell 036,6212,741,575,783,810,777,914,626,616,313,57,1316,4896,1612,21.18,78.82,25.95
E02002079,Sandwell 037,8327,1074,828,1144,1104,960,1205,883,671,364,94,1902,6425,2012,22.84,77.16,24.16
E02002080,Sandwell 038,6874,917,679,950,918,889,941,699,535,283,63,1596,5278,1580,23.22,76.78,22.99
E02006810,Sandwell 039,10441,1325,890,1529,1354,1286,1362,1158,974,508,55,2215,8226,2695,21.21,78.79,25.81
E02002081,Solihull 001,5417,527,392,652,587,588,864,819,633,301,54,919,4498,1807,16.97,83.03,33.36
E02002082,Solihull 002,5863,829,773,934,778,709,711,508,490,112,19,1602,4261,1129,27.32,72.68,19.26
E02002083,Solihull 003,5973,586,505,786,597,688,1015,730,642,331,93,1091,4882,1796,18.27,81.73,30.07
E02002084,Solihull 004,6627,1031,709,1049,833,793,820,615,526,209,42,1740,4887,1392,26.26,73.74,21.0
E02002085,Solihull 005,6570,1066,786,941,902,736,805,602,446,230,56,1852,4718,1334,28.19,71.81,20.3
E02002086,Solihull 006,5965,938,537,1006,730,641,857,544,505,171,36,1475,4490,1256,24.73,75.27,21.06
E02002087,Solihull 007,6303,1015,667,1050,814,683,869,477,490,212,26,1682,4621,1205,26.69,73.31,19.12
E02002088,Solihull 008,9640,1644,992,1621,1296,1084,1176,725,757,303,42,2636,7004,1827,27.34,72.66,18.95
E02002089,Solihull 009,7821,849,717,1130,938,981,1172,829,837,312,56,1566,6255,2034,20.02,79.98,26.01
E02002090,Solihull 010,5929,795,616,800,835,761,838,571,458,220,35,1411,4518,1284,23.8,76.2,21.66
E02002091,Solihull 011,7435,844,623,993,890,878,1147,714,715,467,164,1467,5968,2060,19.73,80.27,27.71
E02002092,Solihull 012,7311,857,715,1012,908,881,1020,753,694,359,112,1572,5739,1918,21.5,78.5,26.23
E02002093,Solihull 013,6918,738,607,1036,877,849,1017,678,654,369,93,1345,5573,1794,19.44,80.56,25.93
E02002094,Solihull 014,6192,602,623,669,554,784,965,794,624,455,122,1225,4967,1995,19.78,80.22,32.22
E02002095,Solihull 015,9068,1091,839,1154,1264,1115,1186,1053,907,381,78,1930,7138,2419,21.28,78.72,26.68
E02002096,Solihull 016,10535,1236,944,1175,1262,1408,1267,1108,1121,780,234,2180,8355,3243,20.69,79.31,30.78
E02002097,Solihull 017,7268,726,667,715,793,960,1203,945,820,362,77,1393,5875,2204,19.17,80.83,30.32
E02002098,Solihull 018,9856,1186,1125,1147,1090,1372,1405,934,837,607,153,2311,7545,2531,23.45,76.55,25.68
E02002099,Solihull 019,6954,653,751,750,655,901,1069,838,741,471,125,1404,5550,2175,20.19,79.81,31.28
E02002101,Solihull 021,6236,726,478,795,851,714,839,716,639,406,72,1204,5032,1833,19.31,80.69,29.39
E02002102,Solihull 022,9010,1113,921,1122,1038,1205,1238,918,770,524,161,2034,6976,2373,22.57,77.43,26.34
E02002103,Solihull 023,6157,722,444,655,652,700,929,805,767,393,90,1166,4991,2055,18.94,81.06,33.38
E02002104,Solihull 024,5964,517,627,726,547,769,1054,891,570,227,36,1144,4820,1724,19.18,80.82,28.91
E02002105,Solihull 025,8355,886,827,951,727,1122,1343,953,940,490,116,1713,6642,2499,20.5,79.5,29.91
E02002106,Solihull 026,9771,1038,991,867,787,1256,1357,1250,1371,640,214,2029,7742,3475,20.77,79.23,35.56
E02002107,Solihull 027,5697,619,458,634,694,743,880,776,573,245,75,1077,4620,1669,18.9,81.1,29.3
E02002108,Solihull 028,10018,1145,1154,965,852,1335,1545,1197,1066,632,127,2299,7719,3022,22.95,77.05,30.17
E02002109,Solihull 029,10956,1358,1127,1438,1473,1703,1574,1019,886,322,56,2485,8471,2283,22.68,77.32,20.84
E02006808,Solihull 030,6565,930,667,837,986,832,880,642,478,252,61,1597,4968,1433,24.33,75.67,21.83
E02002110,Walsall 001,7235,898,744,994,950,954,1187,675,572,226,35,1642,5593,1508,22.7,77.3,20.84
E02002111,Walsall 002,6213,759,619,834,709,778,867,652,652,300,43,1378,4835,1647,22.18,77.82,26.51
E02002112,Walsall 003,5360,545,511,617,599,627,848,649,653,278,33,1056,4304,1613,19.7,80.3,30.09
E02002113,Walsall 004,6366,748,608,922,723,817,992,688,556,261,51,1356,5010,1556,21.3,78.7,24.44
E02002114,Walsall 005,6027,582,444,732,597,718,889,685,785,495,100,1026,5001,2065,17.02,82.98,34.26
E02002115,Walsall 006,6784,895,633,902,812,811,943,659,687,381,61,1528,5256,1788,22.52,77.48,26.36
E02002116,Walsall 007,6682,657,565,699,696,772,1039,918,873,418,45,1222,5460,2254,18.29,81.71,33.73
E02002117,Walsall 008,6506,721,544,875,747,773,1107,838,590,259,52,1265,5241,1739,19.44,80.56,26.73
E02002118,Walsall 009,7459,1054,779,1083,986,777,1045,705,552,403,75,1833,5626,1735,24.57,75.43,23.26
E02002119,Walsall 010,5873,673,507,833,629,704,884,702,583,294,64,1180,4693,1643,20.09,79.91,27.98
E02002120,Walsall 011,6070,687,631,865,701,684,933,825,534,175,35,1318,4752,1569,21.71,78.29,25.85
E02002121,Walsall 012,6808,1080,798,987,938,725,790,595,482,313,100,1878,4930,1490,27.59,72.41,21.89
E02002122,Walsall 013,6818,1390,877,986,1127,733,699,490,347,136,33,2267,4551,1006,33.25,66.75,14.76
E02002123,Walsall 014,6546,954,506,1070,898,716,759,648,629,311,55,1460,5086,1643,22.3,77.7,25.1
E02002124,Walsall 015,7098,747,535,942,739,807,958,772,818,601,179,1282,5816,2370,18.06,81.94,33.39
E02002125,Walsall 016,6288,831,557,845,851,776,906,651,520,298,53,1388,4900,1522,22.07,77.93,24.2
E02002126,Walsall 017,6857,1140,737,1155,919,783,878,621,397,175,52,1877,4980,1245,27.37,72.63,18.16
E02002127,Walsall 018,9885,1862,1185,1619,1547,1229,990,720,446,228,59,3047,6838,1453,30.82,69.18,14.7
E02002128,Walsall 019,5554,638,465,763,621,645,736,700,639,300,47,1103,4451,1686,19.86,80.14,30.36
E02002129,Walsall 020,5898,643,512,745,744,663,830,781,637,313,30,1155,4743,1761,19.58,80.42,29.86
E02002130,Walsall 021,7141,1195,846,1123,1046,843,857,584,423,191,33,2041,5100,1231,28.58,71.42,17.24
E02002131,Walsall 022,7838,764,698,853,783,923,1254,966,1026,482,89,1462,6376,2563,18.65,81.35,32.7
E02002132,Walsall 023,6640,977,739,986,862,808,744,743,456,268,57,1716,4924,1524,25.84,74.16,22.95
E02002133,Walsall 024,6967,788,562,1154,974,900,909,758,584,293,45,1350,5617,1680,19.38,80.62,24.11
E02002134,Walsall 025,9011,1330,918,1426,1339,1184,1216,735,558,257,48,2248,6763,1598,24.95,75.05,17.73
E02002135,Walsall 026,8260,1381,1067,1413,1357,1084,838,592,347,147,34,2448,5812,1120,29.64,70.36,13.56
E02002136,Walsall 027,8165,1216,781,1267,1250,1126,1066,724,494,221,20,1997,6168,1459,24.46,75.54,17.87
E02002137,Walsall 028,6150,527,543,679,524,780,930,743,787,510,127,1070,5080,2167,17.4,82.6,35.24
E02002138,Walsall 029,6645,793,842,978,896,935,814,596,458,291,42,1635,5010,1387,24.6,75.4,20.87
E02002139,Walsall 030,11060,1616,1204,2464,1791,1400,1080,752,419,269,65,2820,8240,1505,25.5,74.5,13.61
E02002140,Walsall 031,8826,1480,1129,1409,1392,1105,857,676,458,279,41,2609,6217,1454,29.56,70.44,16.47
E02002141,Walsall 032,6588,735,579,760,803,810,970,676,780,436,39,1314,5274,1931,19.95,80.05,29.31
E02002142,Walsall 033,7364,1232,927,1165,1094,958,808,601,359,189,31,2159,5205,1180,29.32,70.68,16.02
E02002143,Walsall 034,10761,1988,1492,1884,1753,1365,912,652,460,232,23,3480,7281,1367,32.34,67.66,12.7
E02002144,Walsall 035,6783,720,652,766,770,867,856,868,752,460,72,1372,5411,2152,20.23,79.77,31.73
E02002145,Walsall 036,8101,1504,935,1261,1310,951,883,611,428,195,23,2439,5662,1257,30.11,69.89,15.52
E02002146,Walsall 037,6626,914,869,984,946,869,798,600,374,190,82,1783,4843,1246,26.91,73.09,18.8
E02002147,Walsall 038,8829,1495,953,1471,1293,1042,1027,659,563,274,52,2448,6381,1548,27.73,72.27,17.53
E02002148,Walsall 039,11396,1334,984,1542,1484,1310,1715,1103,1037,792,95,2318,9078,3027,20.34,79.66,26.56
E02002149,Wolverhampton 001,9801,1219,813,1281,1205,1093,1439,1132,1014,498,107,2032,7769,2751,20.73,79.27,28.07
E02002150,Wolverhampton 002,5664,726,602,722,817,708,822,595,410,223,39,1328,4336,1267,23.45,76.55,22.37
E02002151,Wolverhampton 003,5768,805,560,865,793,711,838,640,388,137,31,1365,4403,1196,23.67,76.33,20.74
E02002152,Wolverhampton 004,6311,1054,807,976,804,748,769,504,367,228,54,1861,4450,1153,29.49,70.51,18.27
E02002153,Wolverhampton 005,7275,904,567,1042,860,811,1096,723,696,526,50,1471,5804,1995,20.22,79.78,27.42
E02002154,Wolverhampton 006,6427,997,681,943,1007,783,879,543,349,207,38,1678,4749,1137,26.11,73.89,17.69
E02002155,Wolverhampton 007,6328,1276,900,914,938,755,647,437,299,134,28,2176,4152,898,34.39,65.61,14.19
E02002156,Wolverhampton 008,8146,1004,764,1129,1023,1036,1193,931,630,341,95,1768,6378,1997,21.7,78.3,24.52
E02002157,Wolverhampton 009,7602,889,701,1032,897,1031,1104,814,641,397,96,1590,6012,1948,20.92,79.08,25.62
E02002158,Wolverhampton 010,7293,909,570,960,864,830,1014,800,756,493,97,1479,5814,2146,20.28,79.72,29.43
E02002159,Wolverhampton 011,6418,1106,847,1023,907,891,777,431,287,126,23,1953,4465,867,30.43,69.57,13.51
E02002160,Wolverhampton 012,7503,950,759,1030,988,1045,1018,757,620,303,33,1709,5794,1713,22.78,77.22,22.83
E02002161,Wolverhampton 013,7239,1330,767,1304,1174,901,848,477,274,123,41,2097,5142,915,28.97,71.03,12.64
E02002162,Wolverhampton 014,7696,783,615,751,820,919,1047,907,951,714,189,1398,6298,2761,18.17,81.83,35.88
E02002163,Wolverhampton 015,13017,2277,1211,2140,2376,1628,1497,934,553,340,61,3488,9529,1888,26.8,73.2,14.5
E02002164,Wolverhampton 016,7976,1123,728,2150,1536,1024,660,393,202,129,31,1851,6125,755,23.21,76.79,9.47
E02002165,Wolverhampton 017,8165,886,629,1607,1437,1207,990,699,358,245,107,1515,6650,1409,18.55,81.45,17.26
E02002166,Wolverhampton 018,9663,1347,1073,1430,1344,1246,1191,880,744,349,59,2420,7243,2032,25.04,74.96,21.03
E02002167,Wolverhampton 019,6539,680,512,798,689,815,996,840,738,387,84,1192,5347,2049,18.23,81.77,31.34
E02002168,Wolverhampton 020,12515,1778,1155,3090,2191,1504,1236,803,438,275,45,2933,9582,1561,23.44,76.56,12.47
E02002169,Wolverhampton 021,8734,847,789,947,895,1148,1210,1149,1006,565,178,1636,7098,2898,18.73,81.27,33.18
E02002170,Wolverhampton 022,6259,803,635,915,795,771,898,644,467,291,40,1438,4821,1442,22.97,77.03,23.04
E02002171,Wolverhampton 023,7445,1029,707,1033,958,927,933,793,686,325,54,1736,5709,1858,23.32,76.68,24.96
E02002174,Wolverhampton 026,7651,892,611,1018,974,958,1129,936,696,342,95,1503,6148,2069,19.64,80.36,27.04
E02002175,Wolverhampton 027,7579,1164,790,1144,1129,925,922,684,530,247,44,1954,5625,1505,25.78,74.22,19.86
E02002176,Wolverhampton 028,7447,946,670,1038,909,1007,989,822,701,308,57,1616,5831,1888,21.7,78.3,25.35
E02002177,Wolverhampton 029,10763,1875,1017,1699,1804,1441,1156,876,562,286,47,2892,7871,1771,26.87,73.13,16.45
E02002178,Wolverhampton 030,8150,927,698,1063,1064,978,1127,962,738,473,120,1625,6525,2293,19.94,80.06,28.13
E02002179,Wolverhampton 031,6202,738,546,724,743,835,893,705,606,351,61,1284,4918,1723,20.7,79.3,27.78
E02002180,Wolverhampton 032,6429,791,651,855,794,808,813,647,566,440,64,1442,4987,1717,22.43,77.57,26.71
E02002181,Wolverhampton 033,8275,1275,884,1291,1294,997,1002,728,506,265,33,2159,6116,1532,26.09,73.91,18.51
E02002182,Wolverhampton 034,6436,842,621,939,797,867,806,770,470,253,71,1463,4973,1564,22.73,77.27,24.3
E02006894,Wolverhampton 035,14641,2480,1744,2298,2201,1959,1546,1131,779,386,117,4224,10417,2413,28.85,71.15,16.48
E02002183,Bradford 001,5488,438,448,370,351,621,947,847,901,480,85,886,4602,2313,16.14,83.86,42.15
E02002184,Bradford 002,12967,1268,1344,1146,982,1703,2019,1595,1511,1097,302,2612,10355,4505,20.14,79.86,34.74
E02002185,Bradford 003,5868,725,568,459,603,925,871,725,595,338,59,1293,4575,1717,22.03,77.97,29.26
E02002186,Bradford 004,13317,1563,1007,1512,1525,1651,1974,1704,1464,732,185,2570,10747,4085,19.3,80.7,30.68
E02002187,Bradford 005,5975,700,538,441,571,836,920,811,671,409,78,1238,4737,1969,20.72,79.28,32.95
E02002188,Bradford 006,7699,930,783,845,899,1029,1172,903,740,327,71,1713,5986,2041,22.25,77.75,26.51
E02002189,Bradford 007,6865,1039,936,938,901,861,691,681,458,278,82,1975,4890,1499,28.77,71.23,21.84
E02002190,Bradford 008,11904,1847,1513,1888,1796,1538,1224,1115,574,329,80,3360,8544,2098,28.23,71.77,17.62
E02002191,Bradford 009,9661,1620,1272,1481,1464,1175,1088,770,491,250,50,2892,6769,1561,29.93,70.07,16.16
E02002192,Bradford 010,9176,984,775,837,892,1196,1406,1342,1075,568,101,1759,7417,3086,19.17,80.83,33.63
E02002193,Bradford 011,6185,893,608,906,882,686,838,623,509,193,47,1501,4684,1372,24.27,75.73,22.18
E02002194,Bradford 012,7378,1035,654,950,902,852,1124,833,679,293,56,1689,5689,1861,22.89,77.11,25.22
E02002195,Bradford 013,6306,644,563,493,610,857,1038,887,804,346,64,1207,5099,2101,19.14,80.86,33.32
E02002196,Bradford 014,6333,755,632,760,677,898,1055,804,510,206,36,1387,4946,1556,21.9,78.1,24.57
E02002197,Bradford 015,8894,927,770,1235,1249,1252,1122,972,778,460,129,1697,7197,2339,19.08,80.92,26.3
E02002198,Bradford 016,8039,948,627,907,989,1010,1185,1094,793,407,79,1575,6464,2373,19.59,80.41,29.52
E02002199,Bradford 017,6774,735,517,803,875,916,1102,839,656,284,47,1252,5522,1826,18.48,81.52,26.96
E02002200,Bradford 018,8835,1021,784,951,1142,1228,1280,1032,838,436,123,1805,7030,2429,20.43,79.57,27.49
E02002201,Bradford 019,12167,1604,1069,1697,1724,1598,1729,1355,891,416,84,2673,9494,2746,21.97,78.03,22.57
E02002202,Bradford 020,7376,778,631,1168,1241,1083,992,689,462,262,70,1409,5967,1483,19.1,80.9,20.11
E02002203,Bradford 021,7627,1156,690,1117,1019,1028,995,794,530,249,49,1846,5781,1622,24.2,75.8,21.27
E02002204,Bradford 022,11535,1249,963,1288,1168,1410,1808,1563,1337,640,109,2212,9323,3649,19.18,80.82,31.63
E02002205,Bradford 023,9922,996,797,1101,1056,1330,1718,1412,1069,369,74,1793,8129,2924,18.07,81.93,29.47
E02002206,Bradford 024,8556,1182,839,1129,1107,956,1246,982,672,395,48,2021,6535,2097,23.62,76.38,24.51
E02002207,Bradford 025,7608,1154,1069,1243,1161,1038,761,590,329,218,45,2223,5385,1182,29.22,70.78,15.54
E02002208,Bradford 026,8041,1192,864,1105,1099,854,1089,832,594,354,58,2056,5985,1838,25.57,74.43,22.86
E02002209,Bradford 027,7016,1410,976,1005,1163,761,760,484,295,133,29,2386,4630,941,34.01,65.99,13.41
E02002210,Bradford 028,7790,1233,808,1151,1048,1020,984,736,509,233,68,2041,5749,1546,26.2,73.8,19.85
E02002211,Bradford 029,7355,1117,1030,1271,1034,1003,718,602,343,188,49,2147,5208,1182,29.19,70.81,16.07
E02002212,Bradford 030,8374,1682,1247,1378,1238,1144,727,468,233,228,29,2929,5445,958,34.98,65.02,11.44
E02002213,Bradford 031,7344,853,681,866,841,928,1178,960,708,281,48,1534,5810,1997,20.89,79.11,27.19
E02002214,Bradford 032,6079,987,632,865,849,799,748,616,340,188,55,1619,4460,1199,26.63,73.37,19.72
E02002215,Bradford 033,10460,1661,1491,2070,1631,1311,901,813,319,231,32,3152,7308,1395,30.13,69.87,13.34
E02002216,Bradford 034,9368,1472,1208,1727,1503,1377,834,703,321,190,33,2680,6688,1247,28.61,71.39,13.31
E02002217,Bradford 035,10113,1880,1566,1738,1548,1247,857,678,326,229,44,3446,6667,1277,34.07,65.93,12.63
E02002218,Bradford 036,10055,1689,1324,1337,1441,1338,1087,882,634,278,45,3013,7042,1839,29.97,70.03,18.29
E02002219,Bradford 037,8256,1588,1299,1448,1320,1137,657,459,195,131,22,2887,5369,807,34.97,65.03,9.77
E02002220,Bradford 038,9172,1691,1496,1663,1347,1189,820,543,272,115,36,3187,5985,966,34.75,65.25,10.53
E02002221,Bradford 039,16353,2969,1825,3752,3373,2000,1184,738,289,184,39,4794,11559,1250,29.32,70.68,7.64
E02002222,Bradford 040,8881,1612,1216,1241,1287,1226,905,635,419,279,61,2828,6053,1394,31.84,68.16,15.7
E02002223,Bradford 041,7966,1386,1231,1528,1345,1028,627,482,201,119,19,2617,5349,821,32.85,67.15,10.31
E02002224,Bradford 042,10779,2191,1693,1882,1638,1521,841,556,249,169,39,3884,6895,1013,36.03,63.97,9.4
E02002225,Bradford 043,8255,988,801,902,1024,1134,1264,1039,730,318,55,1789,6466,2142,21.67,78.33,25.95
E02002226,Bradford 044,15106,2099,1937,5016,2095,1761,974,677,294,215,38,4036,11070,1224,26.72,73.28,8.1
E02002227,Bradford 045,6605,1205,822,1156,1079,819,703,440,235,127,19,2027,4578,821,30.69,69.31,12.43
E02002228,Bradford 046,7741,1340,1034,1173,1233,842,856,615,392,203,53,2374,5367,1263,30.67,69.33,16.32
E02002229,Bradford 047,7698,889,1061,1099,845,893,1117,878,576,266,74,1950,5748,1794,25.33,74.67,23.3
E02002230,Bradford 048,9680,1793,1288,1895,1701,1311,774,577,184,137,20,3081,6599,918,31.83,68.17,9.48
E02002231,Bradford 049,13177,2096,1725,1981,1906,1753,1456,1183,669,341,67,3821,9356,2260,29.0,71.0,17.15
E02002232,Bradford 050,7423,1304,1073,1154,1101,953,711,578,311,191,47,2377,5046,1127,32.02,67.98,15.18
E02002233,Bradford 051,9793,2075,1684,1621,1505,1141,775,544,269,150,29,3759,6034,992,38.38,61.62,10.13
E02002234,Bradford 052,8220,1663,1107,1114,1254,905,954,639,377,170,37,2770,5450,1223,33.7,66.3,14.88
E02002235,Bradford 053,7577,1390,1121,1184,1215,939,725,526,302,156,19,2511,5066,1003,33.14,66.86,13.24
E02002236,Bradford 054,6186,949,701,823,847,742,800,590,414,278,42,1650,4536,1324,26.67,73.33,21.4
E02002237,Bradford 055,8681,1494,1029,1227,1283,997,1067,737,494,283,70,2523,6158,1584,29.06,70.94,18.25
E02002238,Bradford 056,6302,961,811,833,862,832,767,630,380,196,30,1772,4530,1236,28.12,71.88,19.61
E02002239,Bradford 057,11119,1742,1253,1478,1755,1395,1547,1000,630,271,48,2995,8124,1949,26.94,73.06,17.53
E02002240,Bradford 058,11015,1330,1018,1427,1378,1485,1793,1335,823,367,59,2348,8667,2584,21.32,78.68,23.46
E02002241,Bradford 059,12134,1978,1287,1568,1697,1474,1529,1322,774,407,98,3265,8869,2601,26.91,73.09,21.44
E02002242,Bradford 060,7843,907,661,997,925,952,1141,1052,767,369,72,1568,6275,2260,19.99,80.01,28.82
E02002243,Bradford 061,9364,1274,902,1237,1226,1158,1286,1050,831,349,51,2176,7188,2281,23.24,76.76,24.36
E02002244,Calderdale 001,6218,695,566,792,626,756,948,792,702,282,59,1261,4957,1835,20.28,79.72,29.51
E02002245,Calderdale 002,5428,850,634,800,683,673,792,501,354,123,18,1484,3944,996,27.34,72.66,18.35
E02002246,Calderdale 003,9581,939,804,1099,960,1244,1556,1316,1049,522,92,1743,7838,2979,18.19,81.81,31.09
E02002247,Calderdale 004,9243,863,901,751,874,1428,1829,1345,885,298,69,1764,7479,2597,19.08,80.92,28.1
E02002248,Calderdale 005,7827,1063,820,1114,1071,961,1144,828,584,223,19,1883,5944,1654,24.06,75.94,21.13
E02002249,Calderdale 006,5630,888,557,949,770,698,723,508,382,125,30,1445,4185,1045,25.67,74.33,18.56
E02002250,Calderdale 007,8561,843,778,968,803,1169,1432,1212,926,369,61,1621,6940,2568,18.93,81.07,30.0
E02002251,Calderdale 008,8729,950,604,1383,1559,1106,1211,825,613,373,105,1554,7175,1916,17.8,82.2,21.95
E02002252,Calderdale 009,6787,967,603,820,853,824,928,787,652,291,62,1570,5217,1792,23.13,76.87,26.4
E02002253,Calderdale 010,8837,1708,1097,1406,1430,1076,868,608,339,253,52,2805,6032,1252,31.74,68.26,14.17
E02002254,Calderdale 011,6282,657,605,705,661,788,1058,793,633,297,85,1262,5020,1808,20.09,79.91,28.78
E02002255,Calderdale 012,8089,1374,1119,1456,1296,1115,634,523,266,229,77,2493,5596,1095,30.82,69.18,13.54
E02002256,Calderdale 013,9554,1144,908,1154,1166,1318,1439,1120,867,328,110,2052,7502,2425,21.48,78.52,25.38
E02002257,Calderdale 014,6831,1203,951,1273,1056,878,604,514,229,104,19,2154,4677,866,31.53,68.47,12.68
E02002258,Calderdale 015,9218,1011,831,1217,1102,1226,1461,1129,785,387,69,1842,7376,2370,19.98,80.02,25.71
E02002259,Calderdale 016,7121,894,689,944,957,909,933,762,590,348,95,1583,5538,1795,22.23,77.77,25.21
E02002260,Calderdale 017,9369,1029,755,1418,1238,1210,1387,1108,844,327,53,1784,7585,2332,19.04,80.96,24.89
E02002261,Calderdale 018,8304,1036,676,1105,1138,972,1239,990,728,378,42,1712,6592,2138,20.62,79.38,25.75
E02002262,Calderdale 019,7951,740,697,1031,887,1021,1291,884,885,413,102,1437,6514,2284,18.07,81.93,28.73
E02002263,Calderdale 020,6510,766,632,718,721,895,1011,888,640,196,43,1398,5112,1767,21.47,78.53,27.14
E02002264,Calderdale 021,7085,771,694,711,818,983,1023,817,773,405,90,1465,5620,2085,20.68,79.32,29.43
E02002265,Calderdale 022,5704,617,439,654,667,747,933,761,575,225,86,1056,4648,1647,18.51,81.49,28.87
E02002266,Calderdale 023,5787,554,442,709,634,782,883,723,693,308,59,996,4791,1783,17.21,82.79,30.81
E02002267,Calderdale 024,7934,827,780,963,892,1037,1237,965,864,297,72,1607,6327,2198,20.25,79.75,27.7
E02002268,Calderdale 025,10625,1289,1001,1463,1346,1400,1486,1126,927,489,98,2290,8335,2640,21.55,78.45,24.85
E02002269,Calderdale 026,9522,1069,924,1063,1076,1366,1507,1228,900,306,83,1993,7529,2517,20.93,79.07,26.43
E02002270,Calderdale 027,8728,1031,833,967,953,1285,1483,1122,791,226,37,1864,6864,2176,21.36,78.64,24.93
E02002271,Kirklees 001,7283,872,704,853,891,925,1026,796,710,401,105,1576,5707,2012,21.64,78.36,27.63
E02002272,Kirklees 002,9689,1248,945,1218,1307,1219,1370,1056,902,351,73,2193,7496,2382,22.63,77.37,24.58
E02002273,Kirklees 003,6793,840,542,850,858,898,1031,769,658,284,63,1382,5411,1774,20.34,79.66,26.12
E02002274,Kirklees 004,7260,889,707,765,898,947,1124,838,703,327,62,1596,5664,1930,21.98,78.02,26.58
E02002275,Kirklees 005,8602,1039,695,1174,1090,1191,1213,912,798,401,89,1734,6868,2200,20.16,79.84,25.58
E02002276,Kirklees 006,7550,972,843,954,970,898,1027,790,710,335,51,1815,5735,1886,24.04,75.96,24.98
E02002277,Kirklees 007,6898,1034,765,1001,1033,879,837,546,502,258,43,1799,5099,1349,26.08,73.92,19.56
E02002278,Kirklees 008,6801,894,704,834,868,905,910,749,648,226,63,1598,5203,1686,23.5,76.5,24.79
E02002279,Kirklees 009,6243,777,610,810,811,825,912,668,550,232,48,1387,4856,1498,22.22,77.78,23.99
E02002280,Kirklees 010,6996,1070,933,1136,1066,900,684,609,380,189,29,2003,4993,1207,28.63,71.37,17.25
E02002281,Kirklees 011,11709,1717,1235,1664,1674,1521,1386,1129,823,467,93,2952,8757,2512,25.21,74.79,21.45
E02002282,Kirklees 012,7665,1261,1014,1244,1229,1016,735,594,368,167,37,2275,5390,1166,29.68,70.32,15.21
E02002283,Kirklees 013,7585,1021,864,1388,1147,1060,792,731,389,169,24,1885,5700,1313,24.85,75.15,17.31
E02002284,Kirklees 014,6133,725,501,833,774,759,934,724,541,291,51,1226,4907,1607,19.99,80.01,26.2
E02002285,Kirklees 015,8162,918,710,929,990,1023,1281,1009,834,399,69,1628,6534,2311,19.95,80.05,28.31
E02002286,Kirklees 016,6581,1079,801,962,1021,878,743,590,333,140,34,1880,4701,1097,28.57,71.43,16.67
E02002287,Kirklees 017,7463,1031,862,1290,1239,985,874,573,354,205,50,1893,5570,1182,25.37,74.63,15.84
E02002288,Kirklees 018,9813,1459,944,1349,1396,1250,1359,923,708,346,79,2403,7410,2056,24.49,75.51,20.95
E02002289,Kirklees 019,7012,1281,1052,1252,1060,951,639,432,226,99,20,2333,4679,777,33.27,66.73,11.08
E02002290,Kirklees 020,6387,660,592,639,642,836,927,841,831,371,48,1252,5135,2091,19.6,80.4,32.74
E02002291,Kirklees 021,6604,779,637,751,754,851,979,728,773,284,68,1416,5188,1853,21.44,78.56,28.06
E02002292,Kirklees 022,5752,602,566,669,639,705,898,785,542,266,80,1168,4584,1673,20.31,79.69,29.09
E02002293,Kirklees 023,9252,1789,1357,1533,1597,1264,758,516,276,133,29,3146,6106,954,34.0,66.0,10.31
E02002294,Kirklees 024,11005,1720,1522,1982,1522,1503,1107,934,455,215,45,3242,7763,1649,29.46,70.54,14.98
E02002295,Kirklees 025,7339,1267,860,1087,1105,896,937,584,406,171,26,2127,5212,1187,28.98,71.02,16.17
E02002296,Kirklees 026,6952,733,543,826,745,902,1022,763,827,481,110,1276,5676,2181,18.35,81.65,31.37
E02002297,Kirklees 027,6863,773,690,796,856,886,944,834,688,329,67,1463,5400,1918,21.32,78.68,27.95
E02002298,Kirklees 028,6745,779,613,883,734,782,1057,852,665,317,63,1392,5353,1897,20.64,79.36,28.12
E02002299,Kirklees 029,7569,1152,756,1825,1187,961,720,488,274,177,29,1908,5661,968,25.21,74.79,12.79
E02002300,Kirklees 030,8057,1075,700,857,1059,1121,1045,899,762,446,93,1775,6282,2200,22.03,77.97,27.31
E02002301,Kirklees 031,8476,1384,1022,1540,1445,1174,801,587,294,189,40,2406,6070,1110,28.39,71.61,13.1
E02002302,Kirklees 032,6278,686,589,713,647,900,1030,740,682,244,47,1275,5003,1713,20.31,79.69,27.29
E02002303,Kirklees 033,6595,788,571,853,834,895,948,682,561,367,96,1359,5236,1706,20.61,79.39,25.87
E02002304,Kirklees 034,6903,677,471,1813,1067,794,807,594,402,227,51,1148,5755,1274,16.63,83.37,18.46
E02002305,Kirklees 035,6252,906,647,1122,846,712,844,598,339,203,35,1553,4699,1175,24.84,75.16,18.79
E02002306,Kirklees 036,6122,609,512,706,611,841,1013,913,591,281,45,1121,5001,1830,18.31,81.69,29.89
E02002307,Kirklees 037,5904,649,518,799,723,657,992,663,578,267,58,1167,4737,1566,19.77,80.23,26.52
E02002308,Kirklees 038,6450,752,572,870,868,912,934,718,531,239,54,1324,5126,1542,20.53,79.47,23.91
E02002309,Kirklees 039,7062,943,717,1444,1045,919,742,568,380,245,59,1660,5402,1252,23.51,76.49,17.73
E02002310,Kirklees 040,5988,705,495,1032,830,766,796,551,507,243,63,1200,4788,1364,20.04,79.96,22.78
E02002311,Kirklees 041,6542,819,629,897,818,842,975,768,514,221,59,1448,5094,1562,22.13,77.87,23.88
E02002312,Kirklees 042,10953,896,598,5485,1286,817,777,563,342,154,35,1494,9459,1094,13.64,86.36,9.99
E02002313,Kirklees 043,8351,1398,1198,1531,1358,1146,771,485,288,150,26,2596,5755,949,31.09,68.91,11.36
E02002314,Kirklees 044,5901,634,516,715,609,709,904,710,667,347,90,1150,4751,1814,19.49,80.51,30.74
E02002315,Kirklees 045,6829,854,665,1118,993,890,956,709,416,182,46,1519,5310,1353,22.24,77.76,19.81
E02002316,Kirklees 046,6505,722,558,665,657,846,1012,852,792,333,68,1280,5225,2045,19.68,80.32,31.44
E02002317,Kirklees 047,7482,1216,901,1035,978,949,887,684,492,294,46,2117,5365,1516,28.29,71.71,20.26
E02002318,Kirklees 048,6405,746,489,969,729,749,936,757,677,279,74,1235,5170,1787,19.28,80.72,27.9
E02002319,Kirklees 049,6785,878,595,791,1002,951,964,742,545,261,56,1473,5312,1604,21.71,78.29,23.64
E02002320,Kirklees 050,6173,593,459,637,691,781,980,882,728,365,57,1052,5121,2032,17.04,82.96,32.92
E02002321,Kirklees 051,6957,619,679,1381,598,832,972,848,712,265,51,1298,5659,1876,18.66,81.34,26.97
E02002322,Kirklees 052,6429,694,555,594,708,925,1129,877,668,228,51,1249,5180,1824,19.43,80.57,28.37
E02002323,Kirklees 053,8457,850,839,878,940,1047,1347,1080,964,452,60,1689,6768,2556,19.97,80.03,30.22
E02002324,Kirklees 054,6726,720,570,693,727,874,985,881,893,303,80,1290,5436,2157,19.18,80.82,32.07
E02002325,Kirklees 055,8952,1023,857,979,914,1149,1415,1093,1002,422,98,1880,7072,2615,21.0,79.0,29.21
E02002326,Kirklees 056,6258,713,650,558,626,945,1018,747,688,271,42,1363,4895,1748,21.78,78.22,27.93
E02002327,Kirklees 057,9990,1121,963,927,988,1401,1607,1298,1100,480,105,2084,7906,2983,20.86,79.14,29.86
E02002328,Kirklees 058,7076,706,670,650,663,953,1228,1015,763,345,83,1376,5700,2206,19.45,80.55,31.18
E02002329,Kirklees 059,12223,1257,1308,1181,1183,1772,2050,1734,1252,419,67,2565,9658,3472,20.99,79.01,28.41
E02002330,Leeds 001,6572,660,506,618,561,750,977,974,1014,467,45,1166,5406,2500,17.74,82.26,38.04
E02002331,Leeds 002,7029,629,536,970,888,909,877,708,817,568,127,1165,5864,2220,16.57,83.43,31.58
E02002332,Leeds 003,6143,706,562,701,627,736,958,773,700,317,63,1268,4875,1853,20.64,79.36,30.16
E02002333,Leeds 004,7637,746,588,790,882,963,1109,1074,921,438,126,1334,6303,2559,17.47,82.53,33.51
E02002334,Leeds 005,7110,857,653,614,651,934,965,927,967,473,69,1510,5600,2436,21.24,78.76,34.26
E02002335,Leeds 006,7500,809,713,746,684,937,1138,1005,963,425,80,1522,5978,2473,20.29,79.71,32.97
E02002336,Leeds 007,6596,746,674,586,549,925,1041,837,746,427,65,1420,5176,2075,21.53,78.47,31.46
E02002337,Leeds 008,7388,873,725,933,840,1025,1072,810,700,360,50,1598,5790,1920,21.63,78.37,25.99
E02002338,Leeds 009,6817,811,717,802,780,977,876,725,690,353,86,1528,5289,1854,22.41,77.59,27.2
E02002339,Leeds 010,5351,700,423,779,690,657,760,616,457,218,51,1123,4228,1342,20.99,79.01,25.08
E02002340,Leeds 011,5554,570,471,725,607,644,770,737,667,296,67,1041,4513,1767,18.74,81.26,31.81
E02002341,Leeds 012,7218,933,626,730,739,955,963,910,795,475,92,1559,5659,2272,21.6,78.4,31.48
E02002342,Leeds 013,5579,691,452,531,674,684,756,713,622,401,55,1143,4436,1791,20.49,79.51,32.1
E02002343,Leeds 014,5717,777,509,728,741,769,817,632,470,237,37,1286,4431,1376,22.49,77.51,24.07
E02002344,Leeds 015,7566,915,619,868,984,1016,960,903,752,461,88,1534,6032,2204,20.27,79.73,29.13
E02002345,Leeds 016,5635,674,516,559,617,693,796,758,617,328,77,1190,4445,1780,21.12,78.88,31.59
E02002346,Leeds 017,5842,786,556,839,873,740,718,588,454,252,36,1342,4500,1330,22.97,77.03,22.77
E02002347,Leeds 018,6278,1057,631,820,876,823,774,586,428,221,62,1688,4590,1297,26.89,73.11,20.66
E02002348,Leeds 019,6216,803,563,887,882,722,782,714,485,285,93,1366,4850,1577,21.98,78.02,25.37
E02002349,Leeds 020,5752,709,453,778,910,791,703,624,458,266,60,1162,4590,1408,20.2,79.8,24.48
E02002350,Leeds 021,6034,719,561,823,641,770,774,597,665,406,78,1280,4754,1746,21.21,78.79,28.94
E02002351,Leeds 022,5346,584,423,537,510,648,845,745,644,367,43,1007,4339,1799,18.84,81.16,33.65
E02002352,Leeds 023,7416,935,648,999,1079,1037,981,830,570,279,58,1583,5833,1737,21.35,78.65,23.42
E02002353,Leeds 024,5939,891,546,755,827,850,830,628,338,219,55,1437,4502,1240,24.2,75.8,20.88
E02002354,Leeds 025,7702,1005,723,973,1180,1047,980,780,582,334,98,1728,5974,1794,22.44,77.56,23.29
E02002356,Leeds 027,8324,1212,761,1070,1220,1130,1076,785,690,325,55,1973,6351,1855,23.7,76.3,22.28
E02002357,Leeds 028,7915,1014,690,1298,1225,981,903,753,604,371,76,1704,6211,1804,21.53,78.47,22.79
E02002358,Leeds 029,7801,1107,689,1092,1073,894,956,907,731,305,47,1796,6005,1990,23.02,76.98,25.51
E02002359,Leeds 030,6449,630,577,746,584,865,987,802,790,394,74,1207,5242,2060,18.72,81.28,31.94
E02002360,Leeds 031,6696,862,610,1136,1049,873,838,629,388,263,48,1472,5224,1328,21.98,78.02,19.83
E02002361,Leeds 032,5886,796,675,806,770,855,803,574,313,224,70,1471,4415,1181,24.99,75.01,20.06
E02002362,Leeds 033,7744,1077,694,1352,1180,971,980,722,467,248,53,1771,5973,1490,22.87,77.13,19.24
E02002363,Leeds 034,6718,591,389,1383,1366,825,831,598,395,273,67,980,5738,1333,14.59,85.41,19.84
E02002364,Leeds 035,5708,780,534,883,749,640,802,608,391,237,84,1314,4394,1320,23.02,76.98,23.13
E02002366,Leeds 037,8067,1108,846,1263,1035,1101,893,711,600,400,110,1954,6113,1821,24.22,75.78,22.57
E02002367,Leeds 038,6173,1003,696,1033,1012,769,717,448,292,161,42,1699,4474,943,27.52,72.48,15.28
E02002368,Leeds 039,8281,1204,687,954,1203,1165,1109,823,744,344,48,1891,6390,1959,22.84,77.16,23.66
E02002369,Leeds 040,7345,1192,852,1085,1005,899,960,647,423,237,45,2044,5301,1352,27.83,72.17,18.41
E02002370,Leeds 041,7052,1155,758,1234,989,748,812,630,458,213,55,1913,5139,1356,27.13,72.87,19.23
E02002371,Leeds 042,10215,1512,1131,2007,1595,1307,1173,799,393,251,47,2643,7572,1490,25.87,74.13,14.59
E02002373,Leeds 044,9519,216,180,7215,689,388,269,238,181,99,44,396,9123,562,4.16,95.84,5.9
E02002374,Leeds 045,6835,737,425,2038,1156,664,642,561,385,194,33,1162,5673,1173,17.0,83.0,17.16
E02002375,Leeds 046,6271,869,749,1506,904,609,722,511,264,120,17,1618,4653,912,25.8,74.2,14.54
E02002376,Leeds 047,7788,1516,1204,1299,1101,996,809,430,263,150,20,2720,5068,863,34.93,65.07,11.08
E02002377,Leeds 048,7863,1530,1094,1670,1259,977,596,406,198,122,11,2624,5239,737,33.37,66.63,9.37
E02002379,Leeds 050,5558,1050,738,961,769,545,657,408,296,111,23,1788,3770,838,32.17,67.83,15.08
E02002380,Leeds 051,5161,561,390,798,711,592,762,615,435,259,38,951,4210,1347,18.43,81.57,26.1
E02002381,Leeds 052,6051,737,391,1093,979,832,758,648,398,189,26,1128,4923,1261,18.64,81.36,20.84
E02002382,Leeds 053,8579,2050,1254,1711,1329,1071,640,295,139,75,15,3304,5275,524,38.51,61.49,6.11
E02002383,Leeds 054,8467,338,241,6566,529,270,221,179,88,28,7,579,7888,302,6.84,93.16,3.57
E02002384,Leeds 055,13254,1566,795,6535,1820,982,653,475,268,143,17,2361,10893,903,17.81,82.19,6.81
E02002385,Leeds 056,8757,576,384,4634,1366,693,433,347,216,91,17,960,7797,671,10.96,89.04,7.66
E02002386,Leeds 057,8539,865,675,973,937,1030,1214,1157,1041,522,125,1540,6999,2845,18.03,81.97,33.32
E02002387,Leeds 058,5698,787,532,1128,831,631,771,448,350,183,37,1319,4379,1018,23.15,76.85,17.87
E02002388,Leeds 059,7616,1109,776,1346,1360,930,851,582,394,213,55,1885,5731,1244,24.75,75.25,16.33
E02002389,Leeds 060,7274,1251,914,1077,949,858,843,633,432,264,53,2165,5109,1382,29.76,70.24,19.0
E02002390,Leeds 061,6345,812,562,1056,854,755,926,656,454,220,50,1374,4971,1380,21.65,78.35,21.75
E02002391,Leeds 062,7412,931,575,1104,1163,984,1038,770,513,286,48,1506,5906,1617,20.32,79.68,21.82
E02002392,Leeds 063,11468,387,283,8998,801,362,273,208,104,44,8,670,10798,364,5.84,94.16,3.17
E02002393,Leeds 064,9232,1833,854,2086,1640,1193,799,457,227,124,19,2687,6545,827,29.11,70.89,8.96
E02002394,Leeds 065,8321,1744,993,1459,1208,1105,881,456,323,131,21,2737,5584,931,32.89,67.11,11.19
E02002395,Leeds 066,6842,975,664,1074,986,786,837,660,492,317,51,1639,5203,1520,23.95,76.05,22.22
E02002396,Leeds 067,8775,1040,630,1824,1382,1020,1118,805,571,321,64,1670,7105,1761,19.03,80.97,20.07
E02002397,Leeds 068,7494,971,672,1201,974,864,1099,768,617,277,51,1643,5851,1713,21.92,78.08,22.86
E02002398,Leeds 069,7178,665,599,949,753,823,1065,920,842,492,70,1264,5914,2324,17.61,82.39,32.38
E02002399,Leeds 070,6121,959,675,1012,891,742,745,555,339,184,19,1634,4487,1097,26.69,73.31,17.92
E02002400,Leeds 071,8809,1307,752,2030,1582,1100,925,563,351,180,19,2059,6750,1113,23.37,76.63,12.63
E02002401,Leeds 072,6570,1229,859,1082,815,744,749,541,370,160,21,2088,4482,1092,31.78,68.22,16.62
E02002402,Leeds 073,5427,542,393,756,594,677,961,680,526,272,26,935,4492,1504,17.23,82.77,27.71
E02002403,Leeds 074,5985,604,489,875,659,730,813,621,694,397,103,1093,4892,1815,18.26,81.74,30.33
E02002404,Leeds 075,10808,1351,839,3592,1968,1110,835,604,376,106,27,2190,8618,1113,20.26,79.74,10.3
E02002405,Leeds 076,8703,1228,837,1148,1158,1049,1133,886,726,456,82,2065,6638,2150,23.73,76.27,24.7
E02002406,Leeds 077,6869,727,612,769,712,908,958,873,888,383,39,1339,5530,2183,19.49,80.51,31.78
E02002407,Leeds 078,6487,1027,721,1166,1003,751,769,482,334,179,55,1748,4739,1050,26.95,73.05,16.19
E02002408,Leeds 079,7212,887,608,1008,1019,954,960,788,618,289,81,1495,5717,1776,20.73,79.27,24.63
E02002409,Leeds 080,5885,755,554,849,742,734,858,642,474,243,34,1309,4576,1393,22.24,77.76,23.67
E02002410,Leeds 081,6651,852,469,1058,993,815,939,702,512,263,48,1321,5330,1525,19.86,80.14,22.93
E02002411,Leeds 082,8815,1323,676,2344,1693,1036,812,464,279,160,28,1999,6816,931,22.68,77.32,10.56
E02002412,Leeds 083,7004,916,612,1164,1047,887,939,635,507,265,32,1528,5476,1439,21.82,78.18,20.55
E02002414,Leeds 085,6817,1233,720,1297,984,913,679,448,328,176,39,1953,4864,991,28.65,71.35,14.54
E02002415,Leeds 086,7558,1354,1007,1540,1211,1067,741,406,147,80,5,2361,5197,638,31.24,68.76,8.44
E02002416,Leeds 087,6784,748,575,882,729,712,982,759,914,425,58,1323,5461,2156,19.5,80.5,31.78
E02002417,Leeds 088,6671,844,564,978,804,789,855,767,716,304,50,1408,5263,1837,21.11,78.89,27.54
E02002418,Leeds 089,6903,785,621,1023,808,938,953,814,690,233,38,1406,5497,1775,20.37,79.63,25.71
E02002419,Leeds 090,8253,1356,800,1323,1343,1013,943,706,459,264,46,2156,6097,1475,26.12,73.88,17.87
E02002420,Leeds 091,8548,1298,919,1476,1248,1127,985,680,501,275,39,2217,6331,1495,25.94,74.06,17.49
E02002421,Leeds 092,6041,946,744,1030,819,698,767,521,321,161,34,1690,4351,1037,27.98,72.02,17.17
E02002422,Leeds 093,6124,721,467,817,876,763,837,748,588,263,44,1188,4936,1643,19.4,80.6,26.83
E02002423,Leeds 094,5720,823,622,825,782,682,764,619,392,173,38,1445,4275,1222,25.26,74.74,21.36
E02002424,Leeds 095,7522,900,668,1115,976,981,1161,760,628,284,49,1568,5954,1721,20.85,79.15,22.88
E02002425,Leeds 096,8342,957,719,1076,958,1066,1166,995,913,408,84,1676,6666,2400,20.09,79.91,28.77
E02002426,Leeds 097,7652,888,700,967,896,1013,1155,801,722,446,64,1588,6064,2033,20.75,79.25,26.57
E02002427,Leeds 098,6716,830,581,882,803,723,953,797,728,355,64,1411,5305,1944,21.01,78.99,28.95
E02002428,Leeds 099,7888,1202,723,1224,1304,940,1018,719,475,257,26,1925,5963,1477,24.4,75.6,18.72
E02002429,Leeds 100,8285,1009,756,1152,1116,1100,1140,845,766,356,45,1765,6520,2012,21.3,78.7,24.28
E02002430,Leeds 101,7702,1473,900,1322,1007,888,911,569,424,180,28,2373,5329,1201,30.81,69.19,15.59
E02002431,Leeds 102,8264,1099,733,1460,1301,1143,1067,699,523,203,36,1832,6432,1461,22.17,77.83,17.68
E02002432,Leeds 103,7168,878,709,930,824,1003,1041,757,670,300,56,1587,5581,1783,22.14,77.86,24.87
E02002433,Leeds 104,6435,679,429,1083,943,835,932,675,525,297,37,1108,5327,1534,17.22,82.78,23.84
E02002434,Leeds 105,10066,1604,1051,1627,1647,1420,1326,705,494,163,29,2655,7411,1391,26.38,73.62,13.82
E02002435,Leeds 106,7558,970,635,1076,1059,972,1055,737,664,327,63,1605,5953,1791,21.24,78.76,23.7
E02002436,Leeds 107,6596,843,633,979,816,806,992,685,567,238,37,1476,5120,1527,22.38,77.62,23.15
E02002437,Leeds 108,6048,672,551,763,647,802,1037,800,516,217,43,1223,4825,1576,20.22,79.78,26.06
E02006852,Leeds 109,11620,1129,787,3670,1607,1178,1137,962,691,375,84,1916,9704,2112,16.49,83.51,18.18
E02006861,Leeds 110,13893,468,274,10388,1046,566,411,295,232,162,51,742,13151,740,5.34,94.66,5.33
E02006875,Leeds 111,13597,205,54,10375,1892,594,272,124,63,8,10,259,13338,205,1.9,98.1,1.51
E02006876,Leeds 112,8414,791,470,2875,1772,857,666,467,306,158,52,1261,7153,983,14.99,85.01,11.68
E02002438,Wakefield 001,8684,1401,899,1344,1245,842,1136,879,623,255,60,2300,6384,1817,26.49,73.51,20.92
E02002439,Wakefield 002,8452,938,641,1332,1246,1061,1307,863,639,343,82,1579,6873,1927,18.68,81.32,22.8
E02002440,Wakefield 003,7973,1022,838,975,1072,965,1116,924,684,310,67,1860,6113,1985,23.33,76.67,24.9
E02002441,Wakefield 004,9347,1178,795,1480,1348,1189,1266,852,790,368,81,1973,7374,2091,21.11,78.89,22.37
E02002442,Wakefield 005,7303,788,554,1120,996,883,1258,837,558,263,46,1342,5961,1704,18.38,81.62,23.33
E02002443,Wakefield 006,6289,755,506,884,871,811,1001,751,510,175,25,1261,5028,1461,20.05,79.95,23.23
E02002444,Wakefield 007,6315,705,518,876,860,804,974,765,562,215,36,1223,5092,1578,19.37,80.63,24.99
E02002445,Wakefield 008,7920,897,697,970,1043,1010,1136,855,840,361,111,1594,6326,2167,20.13,79.87,27.36
E02002446,Wakefield 009,5890,538,442,712,665,725,961,836,668,272,71,980,4910,1847,16.64,83.36,31.36
E02002447,Wakefield 010,6275,758,556,854,802,743,921,715,574,299,53,1314,4961,1641,20.94,79.06,26.15
E02002448,Wakefield 011,8061,1121,718,1245,1041,824,1172,884,643,358,55,1839,6222,1940,22.81,77.19,24.07
E02002449,Wakefield 012,9194,1233,831,1255,1271,1205,1357,897,740,317,88,2064,7130,2042,22.45,77.55,22.21
E02002450,Wakefield 013,7339,878,644,996,981,1016,1147,783,619,238,37,1522,5817,1677,20.74,79.26,22.85
E02002451,Wakefield 014,7732,794,616,789,876,949,1224,1081,862,450,91,1410,6322,2484,18.24,81.76,32.13
E02002452,Wakefield 015,8594,1049,654,1343,1172,1166,1242,882,714,311,61,1703,6891,1968,19.82,80.18,22.9
E02002453,Wakefield 016,9788,1261,854,1464,1435,1205,1370,1040,806,287,66,2115,7673,2199,21.61,78.39,22.47
E02002454,Wakefield 017,8703,962,757,1614,1627,1255,991,718,422,285,72,1719,6984,1497,19.75,80.25,17.2
E02002455,Wakefield 018,6391,925,748,866,850,731,886,618,488,222,57,1673,4718,1385,26.18,73.82,21.67
E02002456,Wakefield 019,8056,882,705,1229,1405,1185,1136,795,535,158,26,1587,6469,1514,19.7,80.3,18.79
E02002457,Wakefield 020,8075,1156,811,1107,1209,1073,1032,818,556,240,73,1967,6108,1687,24.36,75.64,20.89
E02002458,Wakefield 021,9133,1124,811,1108,1119,1259,1261,1065,908,399,79,1935,7198,2451,21.19,78.81,26.84
E02002459,Wakefield 022,9731,1294,1011,1418,1384,1381,1385,894,645,252,67,2305,7426,1858,23.69,76.31,19.09
E02002460,Wakefield 023,7101,721,588,673,771,867,1011,1038,836,499,97,1309,5792,2470,18.43,81.57,34.78
E02002461,Wakefield 024,11490,1581,1030,1577,1803,1433,1559,1155,894,401,57,2611,8879,2507,22.72,77.28,21.82
E02002462,Wakefield 025,7515,828,671,873,903,1011,1083,930,815,334,67,1499,6016,2146,19.95,80.05,28.56
E02002463,Wakefield 026,10260,1810,1173,1401,1505,1234,1251,825,658,325,78,2983,7277,1886,29.07,70.93,18.38
E02002464,Wakefield 027,8693,1224,727,1303,1144,987,1205,952,737,356,58,1951,6742,2103,22.44,77.56,24.19
E02002465,Wakefield 028,6068,520,408,898,722,700,970,801,657,338,54,928,5140,1850,15.29,84.71,30.49
E02002466,Wakefield 029,9255,1078,834,1045,1093,1217,1309,1139,1015,440,85,1912,7343,2679,20.66,79.34,28.95
E02002467,Wakefield 030,9033,1273,879,1595,1561,1277,1061,733,431,187,36,2152,6881,1387,23.82,76.18,15.35
E02002468,Wakefield 031,6236,652,540,764,723,871,886,770,641,309,80,1192,5044,1800,19.11,80.89,28.86
E02002469,Wakefield 032,6438,778,578,786,723,768,995,799,732,255,24,1356,5082,1810,21.06,78.94,28.11
E02002470,Wakefield 033,6171,485,494,510,517,732,977,900,997,477,82,979,5192,2456,15.86,84.14,39.8
E02002471,Wakefield 034,11183,1185,936,1292,1308,1316,1697,1556,1217,576,100,2121,9062,3449,18.97,81.03,30.84
E02002472,Wakefield 035,5911,495,486,729,637,786,953,846,673,251,55,981,4930,1825,16.6,83.4,30.87
E02002473,Wakefield 036,6647,701,507,803,750,764,1034,955,766,328,39,1208,5439,2088,18.17,81.83,31.41
E02002474,Wakefield 037,6713,948,627,817,939,808,974,767,516,267,50,1575,5138,1600,23.46,76.54,23.83
E02002475,Wakefield 038,6371,747,511,606,676,830,966,874,754,329,78,1258,5113,2035,19.75,80.25,31.94
E02002476,Wakefield 039,6432,984,629,979,861,732,881,626,474,228,38,1613,4819,1366,25.08,74.92,21.24
E02002477,Wakefield 040,6556,786,610,885,795,778,958,801,572,297,74,1396,5160,1744,21.29,78.71,26.6
E02002478,Wakefield 041,6297,834,632,809,874,734,970,700,495,213,36,1466,4831,1444,23.28,76.72,22.93
E02002479,Wakefield 042,8377,885,696,1136,1007,947,1229,1108,920,355,94,1581,6796,2477,18.87,81.13,29.57
E02002480,Wakefield 043,5798,594,439,783,782,633,810,813,632,278,34,1033,4765,1757,17.82,82.18,30.3
E02002481,Wakefield 044,7313,995,666,1035,1028,878,1000,781,550,308,72,1661,5652,1711,22.71,77.29,23.4
E02002482,Wakefield 045,7209,1062,753,971,1000,890,920,737,579,252,45,1815,5394,1613,25.18,74.82,22.37
E02001682,Gateshead 001,8442,955,709,953,1070,1121,1238,989,864,455,88,1664,6778,2396,19.71,80.29,28.38
E02001683,Gateshead 002,9054,889,738,1025,1115,1136,1494,1157,933,463,104,1627,7427,2657,17.97,82.03,29.35
E02001684,Gateshead 003,6642,824,520,984,1072,786,855,780,490,274,57,1344,5298,1601,20.23,79.77,24.1
E02001685,Gateshead 004,8176,1020,805,1194,1247,973,1059,787,684,340,67,1825,6351,1878,22.32,77.68,22.97
E02001686,Gateshead 005,6671,557,496,760,754,853,1103,886,785,411,66,1053,5618,2148,15.78,84.22,32.2
E02001688,Gateshead 007,7806,876,582,1358,1544,1117,910,693,454,231,41,1458,6348,1419,18.68,81.32,18.18
E02001689,Gateshead 008,8828,1141,826,2189,1280,909,886,750,513,259,75,1967,6861,1597,22.28,77.72,18.09
E02001690,Gateshead 009,7221,749,596,918,955,948,1119,872,665,336,63,1345,5876,1936,18.63,81.37,26.81
E02001691,Gateshead 010,9558,1210,773,2117,1874,1223,1014,656,390,254,47,1983,7575,1347,20.75,79.25,14.09
E02001692,Gateshead 011,6432,944,666,1019,954,798,865,614,366,184,22,1610,4822,1186,25.03,74.97,18.44
E02001693,Gateshead 012,5644,660,490,716,754,640,836,672,507,308,61,1150,4494,1548,20.38,79.62,27.43
E02001694,Gateshead 013,6459,662,556,858,873,792,1040,760,598,289,31,1218,5241,1678,18.86,81.14,25.98
E02001695,Gateshead 014,6138,557,550,710,727,761,939,898,581,336,79,1107,5031,1894,18.04,81.96,30.86
E02001696,Gateshead 015,9153,1155,934,1176,1220,1130,1229,1093,712,432,72,2089,7064,2309,22.82,77.18,25.23
E02001697,Gateshead 016,7404,738,609,850,943,1052,1181,910,701,332,88,1347,6057,2031,18.19,81.81,27.43
E02001698,Gateshead 017,7011,600,542,582,598,824,945,1018,1202,626,74,1142,5869,2920,16.29,83.71,41.65
E02001699,Gateshead 018,6697,685,554,901,828,766,1014,919,627,355,48,1239,5458,1949,18.5,81.5,29.1
E02001700,Gateshead 019,10193,1060,912,1127,1251,1325,1591,1316,1011,531,69,1972,8221,2927,19.35,80.65,28.72
E02001701,Gateshead 020,6310,547,531,630,714,793,1001,788,786,430,90,1078,5232,2094,17.08,82.92,33.19
E02001702,Gateshead 021,7908,1014,881,1079,1036,890,1156,840,593,359,60,1895,6013,1852,23.96,76.04,23.42
E02001703,Gateshead 022,5482,508,462,549,471,673,915,726,742,371,65,970,4512,1904,17.69,82.31,34.73
E02001704,Gateshead 023,6843,680,534,966,871,834,1170,631,674,424,59,1214,5629,1788,17.74,82.26,26.13
E02001705,Gateshead 024,6969,706,605,792,837,880,1047,968,724,337,73,1311,5658,2102,18.81,81.19,30.16
E02001706,Gateshead 025,7792,1080,717,919,1146,1045,996,859,681,291,58,1797,5995,1889,23.06,76.94,24.24
E02001707,Gateshead 026,8110,776,760,930,927,1054,1194,959,916,483,111,1536,6574,2469,18.94,81.06,30.44
E02006841,Gateshead 027,9612,675,419,3775,1947,882,734,579,398,173,30,1094,8518,1180,11.38,88.62,12.28
E02006842,Gateshead 028,5500,698,654,924,833,591,623,487,352,265,73,1352,4148,1177,24.58,75.42,21.4
E02000001,City of London 001,9721,1006,615,2101,1309,1175,1339,1025,720,313,118,1621,8100,2176,16.68,83.32,22.38
E02000002,Barking and Dagenham 001,7735,1380,967,1122,1099,1053,835,505,401,268,105,2347,5388,1279,30.34,69.66,16.54
E02000003,Barking and Dagenham 002,11174,1769,1124,1754,1928,1487,1272,886,575,301,78,2893,8281,1840,25.89,74.11,16.47
E02000004,Barking and Dagenham 003,6687,928,588,1219,881,785,866,598,444,262,116,1516,5171,1420,22.67,77.33,21.24
E02000005,Barking and Dagenham 004,10432,1882,1318,1570,1737,1475,1144,629,413,211,53,3200,7232,1306,30.67,69.33,12.52
E02000007,Barking and Dagenham 006,10048,1787,1297,1571,1399,1353,1193,659,446,256,87,3084,6964,1448,30.69,69.31,14.41
E02000008,Barking and Dagenham 007,12662,2161,1551,1870,1874,1855,1511,935,552,303,50,3712,8950,1840,29.32,70.68,14.53
E02000009,Barking and Dagenham 008,11829,2242,1462,1824,2106,1687,1216,734,338,188,32,3704,8125,1292,31.31,68.69,10.92
E02000010,Barking and Dagenham 009,9204,1605,1101,1369,1399,1343,1175,605,334,205,68,2706,6498,1212,29.4,70.6,13.17
E02000011,Barking and Dagenham 010,6994,1106,764,1140,1047,967,870,492,330,217,61,1870,5124,1100,26.74,73.26,15.73
E02000012,Barking and Dagenham 011,11291,1798,1263,2124,1791,1452,1196,820,481,282,84,3061,8230,1667,27.11,72.89,14.76
E02000013,Barking and Dagenham 012,8948,1544,1208,1356,1342,1267,976,668,385,161,41,2752,6196,1255,30.76,69.24,14.03
E02000014,Barking and Dagenham 013,9949,1772,1110,1496,1500,1359,1184,781,462,227,58,2882,7067,1528,28.97,71.03,15.36
E02000015,Barking and Dagenham 014,8190,1490,947,1391,1254,1109,921,566,305,172,35,2437,5753,1078,29.76,70.24,13.16
E02000016,Barking and Dagenham 015,10021,2151,1062,1751,2414,1327,748,345,159,56,8,3213,6808,568,32.06,67.94,5.67
E02000017,Barking and Dagenham 016,9275,1476,908,1641,1907,1311,869,618,315,202,28,2384,6891,1163,25.7,74.3,12.54
E02000018,Barking and Dagenham 017,9649,1799,1205,1563,1573,1363,992,604,326,183,41,3004,6645,1154,31.13,68.87,11.96
E02000019,Barking and Dagenham 018,9174,1649,1111,1450,1371,1352,1049,643,370,140,39,2760,6414,1192,30.09,69.91,12.99
E02000020,Barking and Dagenham 019,13355,2557,1603,2230,2356,1863,1345,676,416,233,76,4160,9195,1401,31.15,68.85,10.49
E02000021,Barking and Dagenham 020,8944,1622,1092,1426,1303,1255,983,619,385,214,45,2714,6230,1263,30.34,69.66,14.12
E02000022,Barking and Dagenham 021,8183,1759,1184,1243,1613,1157,656,355,147,55,14,2943,5240,571,35.96,64.04,6.98
E02000023,Barking and Dagenham 022,8024,1783,1087,1271,1310,1165,767,377,150,98,16,2870,5154,641,35.77,64.23,7.99
E02006799,Barking and Dagenham 023,11138,1974,1361,1595,1884,1542,1260,765,441,248,68,3335,7803,1522,29.94,70.06,13.66
E02000024,Barnet 001,11057,1224,1015,1364,1407,1527,1595,1284,952,530,159,2239,8818,2925,20.25,79.75,26.45
E02000025,Barnet 002,8347,1062,737,956,1249,1197,1242,864,640,320,80,1799,6548,1904,21.55,78.45,22.81
E02000026,Barnet 003,6593,878,635,744,872,843,928,759,573,302,59,1513,5080,1693,22.95,77.05,25.68
E02000027,Barnet 004,9638,1229,1068,1240,1276,1348,1383,1004,673,356,61,2297,7341,2094,23.83,76.17,21.73
E02000028,Barnet 005,6809,918,595,836,1063,1013,935,641,456,277,75,1513,5296,1449,22.22,77.78,21.28
E02000029,Barnet 006,9451,1433,1032,1231,1426,1391,1237,820,564,263,54,2465,6986,1701,26.08,73.92,18.0
E02000030,Barnet 007,9241,922,1024,1018,887,1158,1490,1148,906,542,146,1946,7295,2742,21.06,78.94,29.67
E02000031,Barnet 008,7856,977,678,901,1177,1077,1024,771,664,426,161,1655,6201,2022,21.07,78.93,25.74
E02000032,Barnet 009,7771,880,920,921,817,1105,1203,865,669,343,48,1800,5971,1925,23.16,76.84,24.77
E02000033,Barnet 010,8903,1133,865,1172,1300,1285,1307,870,560,335,76,1998,6905,1841,22.44,77.56,20.68
E02000034,Barnet 011,9356,1214,913,1166,1419,1441,1229,846,712,323,93,2127,7229,1974,22.73,77.27,21.1
E02000035,Barnet 012,9077,1228,684,1216,1717,1304,1022,768,633,383,122,1912,7165,1906,21.06,78.94,21.0
E02000036,Barnet 013,11645,1836,1225,1620,1704,1573,1441,1010,753,375,108,3061,8584,2246,26.29,73.71,19.29
E02000037,Barnet 014,10552,1717,1300,1227,1500,1310,1126,1061,836,371,104,3017,7535,2372,28.59,71.41,22.48
E02000038,Barnet 015,11479,1416,1149,1499,1899,1759,1571,1037,661,343,145,2565,8914,2186,22.35,77.65,19.04
E02000039,Barnet 016,7255,956,775,913,1022,1055,1007,650,544,288,45,1731,5524,1527,23.86,76.14,21.05
E02000040,Barnet 017,8452,1215,1015,1071,1330,1133,974,771,583,275,85,2230,6222,1714,26.38,73.62,20.28
E02000041,Barnet 018,10034,1519,1075,1360,1546,1394,1138,920,578,374,130,2594,7440,2002,25.85,74.15,19.95
E02000042,Barnet 019,12247,1618,1078,1624,2206,2068,1417,954,708,445,129,2696,9551,2236,22.01,77.99,18.26
E02000043,Barnet 020,8206,1193,931,931,1093,1377,977,772,535,320,77,2124,6082,1704,25.88,74.12,20.77
E02000044,Barnet 021,8876,1319,1018,1238,1429,1318,1173,719,455,169,38,2337,6539,1381,26.33,73.67,15.56
E02000045,Barnet 022,10945,1495,1133,1611,1830,1750,1434,849,570,231,42,2628,8317,1692,24.01,75.99,15.46
E02000046,Barnet 023,7623,968,553,1096,1661,1238,893,544,396,223,51,1521,6102,1214,19.95,80.05,15.93
E02000047,Barnet 024,12422,1882,1313,1880,2078,1840,1526,938,617,284,64,3195,9227,1903,25.72,74.28,15.32
E02000048,Barnet 025,10707,1519,1032,1352,1698,1533,1285,986,776,413,113,2551,8156,2288,23.83,76.17,21.37
E02000049,Barnet 026,9476,1542,1218,1455,1597,1395,1157,627,344,124,17,2760,6716,1112,29.13,70.87,11.73
E02000050,Barnet 027,11010,1448,1124,1654,1740,1726,1287,950,690,303,88,2572,8438,2031,23.36,76.64,18.45
E02000051,Barnet 028,9872,1221,890,1388,1615,1395,1143,835,746,517,122,2111,7761,2220,21.38,78.62,22.49
E02000052,Barnet 029,10613,1260,926,1705,1927,1747,1199,884,625,282,58,2186,8427,1849,20.6,79.4,17.42
E02000053,Barnet 030,16685,2469,1525,3521,3754,2155,1596,923,457,228,57,3994,12691,1665,23.94,76.06,9.98
E02000054,Barnet 031,7648,910,635,1419,1386,1112,911,641,404,205,25,1545,6103,1275,20.2,79.8,16.67
E02000055,Barnet 032,11994,1539,978,2496,2147,1542,1257,887,590,399,159,2517,9477,2035,20.99,79.01,16.97
E02000056,Barnet 033,9609,1253,1119,1182,1061,1475,1207,892,854,410,156,2372,7237,2312,24.69,75.31,24.06
E02000057,Barnet 034,8165,1434,862,1484,1453,986,719,523,425,215,64,2296,5869,1227,28.12,71.88,15.03
E02000058,Barnet 035,10951,1511,1127,1590,1603,1505,1186,986,906,427,110,2638,8313,2429,24.09,75.91,22.18
E02000059,Barnet 036,11873,1621,950,1883,2397,1735,1431,946,536,310,64,2571,9302,1856,21.65,78.35,15.63
E02000060,Barnet 037,12353,2325,1544,2026,1948,1434,1018,855,563,435,205,3869,8484,2058,31.32,68.68,16.66
E02000061,Barnet 038,9175,1049,786,1449,1637,1465,1040,751,501,380,117,1835,7340,1749,20.0,80.0,19.06
E02000062,Barnet 039,7021,911,730,1307,1181,1063,859,524,281,145,20,1641,5380,970,23.37,76.63,13.82
E02000063,Barnet 040,7955,998,791,1240,1341,1208,1036,675,403,203,60,1789,6166,1341,22.49,77.51,16.86
E02000064,Barnet 041,6927,815,647,1279,1329,919,812,540,357,182,47,1462,5465,1126,21.11,78.89,16.26
E02000065,Bexley 001,8951,1412,1290,1333,1200,1460,1193,602,267,160,34,2702,6249,1063,30.19,69.81,11.88
E02000066,Bexley 002,10182,1483,1263,1606,1481,1386,1360,799,531,210,63,2746,7436,1603,26.97,73.03,15.74
E02000067,Bexley 003,10454,1647,1125,1708,1829,1453,1191,717,497,237,50,2772,7682,1501,26.52,73.48,14.36
E02000068,Bexley 004,8203,1366,931,1386,1379,1094,964,553,293,187,50,2297,5906,1083,28.0,72.0,13.2
E02000069,Bexley 005,6911,993,663,1027,1009,899,860,620,475,304,61,1656,5255,1460,23.96,76.04,21.13
E02000070,Bexley 006,8079,932,727,1161,1019,1030,1202,853,684,390,81,1659,6420,2008,20.53,79.47,24.85
E02000071,Bexley 007,7646,1035,766,1172,1057,1030,1071,758,453,235,69,1801,5845,1515,23.55,76.45,19.81
E02000072,Bexley 008,13039,2293,1624,2133,2032,1816,1598,766,477,247,53,3917,9122,1543,30.04,69.96,11.83
E02000073,Bexley 009,10859,1248,1068,1424,1373,1421,1633,1141,951,516,84,2316,8543,2692,21.33,78.67,24.79
E02000074,Bexley 010,8683,1191,995,1192,1310,1153,1196,786,536,257,67,2186,6497,1646,25.18,74.82,18.96
E02000075,Bexley 011,8221,875,706,972,975,1004,1223,999,886,475,106,1581,6640,2466,19.23,80.77,30.0
E02000077,Bexley 013,8214,985,787,1164,1246,1062,1170,800,566,362,72,1772,6442,1800,21.57,78.43,21.91
E02000078,Bexley 014,7922,958,700,1012,1236,997,1031,871,654,371,92,1658,6264,1988,20.93,79.07,25.09
E02000079,Bexley 015,8768,1104,718,1207,1338,1149,1085,809,646,557,155,1822,6946,2167,20.78,79.22,24.71
E02000080,Bexley 016,10338,1295,944,1514,1538,1310,1374,1052,750,437,124,2239,8099,2363,21.66,78.34,22.86
E02000081,Bexley 017,8086,978,772,1005,1074,1053,1132,807,717,408,140,1750,6336,2072,21.64,78.36,25.62
E02000082,Bexley 018,9228,1147,906,1280,1332,1237,1267,913,685,380,81,2053,7175,2059,22.25,77.75,22.31
E02000083,Bexley 019,11568,1571,1244,1738,1840,1599,1540,876,749,326,85,2815,8753,2036,24.33,75.67,17.6
E02000084,Bexley 020,11081,1439,924,1390,1542,1448,1573,1232,922,515,96,2363,8718,2765,21.32,78.68,24.95
E02000085,Bexley 021,8044,1013,792,1205,1164,949,1112,783,626,338,62,1805,6239,1809,22.44,77.56,22.49
E02000086,Bexley 022,7281,833,665,971,857,945,1151,845,662,310,42,1498,5783,1859,20.57,79.43,25.53
E02000087,Bexley 023,8033,838,761,993,961,1110,1215,812,752,490,101,1599,6434,2155,19.91,80.09,26.83
E02000088,Bexley 024,7798,1004,666,1090,998,1049,1041,828,694,339,89,1670,6128,1950,21.42,78.58,25.01
E02000089,Bexley 025,7804,982,731,951,933,1051,1148,814,629,434,131,1713,6091,2008,21.95,78.05,25.73
E02000090,Bexley 026,9483,1039,694,1722,1392,1152,1139,824,775,531,215,1733,7750,2345,18.27,81.73,24.73
E02000091,Bexley 027,9977,1045,848,1488,1180,1208,1413,972,935,691,197,1893,8084,2795,18.97,81.03,28.01
E02000092,Bexley 028,6783,948,728,970,977,811,899,653,457,266,74,1676,5107,1450,24.71,75.29,21.38
E02006785,Bexley 029,6651,740,655,935,979,819,944,680,515,324,60,1395,5256,1579,20.97,79.03,23.74
E02000093,Brent 001,11059,1719,985,1610,1811,1357,1248,1157,714,362,96,2704,8355,2329,24.45,75.55,21.06
E02000094,Brent 002,9277,1325,950,1435,1485,1273,1070,873,560,257,49,2275,7002,1739,24.52,75.48,18.75
E02000095,Brent 003,9894,1458,824,1378,1632,1180,1163,1030,667,387,175,2282,7612,2259,23.06,76.94,22.83
E02000096,Brent 004,7454,1036,560,965,1048,881,793,925,766,393,87,1596,5858,2171,21.41,78.59,29.13
E02000097,Brent 005,9027,1322,886,1334,1297,1206,1127,942,538,311,64,2208,6819,1855,24.46,75.54,20.55
E02000098,Brent 006,8347,1214,847,1282,1255,1035,987,837,545,299,46,2061,6286,1727,24.69,75.31,20.69
E02000099,Brent 007,8872,1473,773,1447,1500,1110,1042,720,407,301,99,2246,6626,1527,25.32,74.68,17.21
E02000100,Brent 008,8725,854,700,2000,1268,877,984,997,657,311,77,1554,7171,2042,17.81,82.19,23.4
E02000101,Brent 009,9562,1431,1018,1313,1526,1236,1203,828,598,336,73,2449,7113,1835,25.61,74.39,19.19
E02000102,Brent 010,7577,1152,978,1233,995,963,971,674,390,188,33,2130,5447,1285,28.11,71.89,16.96
E02000103,Brent 011,9232,1425,1012,1439,1356,1153,1224,744,495,308,76,2437,6795,1623,26.4,73.6,17.58
E02000104,Brent 012,7255,1010,610,1037,1180,907,858,739,487,342,85,1620,5635,1653,22.33,77.67,22.78
E02000105,Brent 013,9746,1483,933,1328,1800,1429,1144,830,485,276,38,2416,7330,1629,24.79,75.21,16.71
E02000106,Brent 014,10694,1658,1019,1762,1789,1419,1323,896,500,264,64,2677,8017,1724,25.03,74.97,16.12
E02000107,Brent 015,11551,1359,902,2396,2211,1641,1276,924,585,213,44,2261,9290,1766,19.57,80.43,15.29
E02000108,Brent 016,6556,932,693,896,1138,882,764,634,395,189,33,1625,4931,1251,24.79,75.21,19.08
E02000109,Brent 017,13524,1682,1105,3490,2507,1589,1278,933,561,299,80,2787,10737,1873,20.61,79.39,13.85
E02000110,Brent 018,8578,1038,623,1704,1570,1152,962,817,475,201,36,1661,6917,1529,19.36,80.64,17.82
E02000111,Brent 019,10946,1624,1057,1357,1950,1681,1344,1057,514,288,74,2681,8265,1933,24.49,75.51,17.66
E02000112,Brent 020,10530,1295,935,1520,1966,1569,1370,1044,447,313,71,2230,8300,1875,21.18,78.82,17.81
E02000113,Brent 021,9646,1604,1335,1523,1175,1154,1347,827,420,220,41,2939,6707,1508,30.47,69.53,15.63
E02000114,Brent 022,9968,1102,699,2296,2082,1328,1018,741,433,219,50,1801,8167,1443,18.07,81.93,14.48
E02000115,Brent 023,8716,901,505,1930,1785,1164,1003,713,417,249,49,1406,7310,1428,16.13,83.87,16.38
E02000116,Brent 024,9407,1436,909,1800,1685,1349,1079,630,329,161,29,2345,7062,1149,24.93,75.07,12.21
E02000117,Brent 025,12868,2086,1535,1988,1774,1705,1742,1066,557,363,52,3621,9247,2038,28.14,71.86,15.84
E02000118,Brent 026,10445,1443,1070,1580,1764,1444,1423,938,468,271,44,2513,7932,1721,24.06,75.94,16.48
E02000119,Brent 027,9060,1650,1143,1499,1284,1076,1150,623,401,200,34,2793,6267,1258,30.83,69.17,13.89
E02000120,Brent 028,9247,1165,565,1758,1957,1390,1021,713,467,186,25,1730,7517,1391,18.71,81.29,15.04
E02000121,Brent 029,10761,1605,1019,1588,2037,1505,1200,968,526,267,46,2624,8137,1807,24.38,75.62,16.79
E02000122,Brent 030,7710,916,711,1172,1208,1032,1056,778,489,273,75,1627,6083,1615,21.1,78.9,20.95
E02000123,Brent 031,15615,2283,1638,2579,2571,2352,2109,1193,543,292,55,3921,11694,2083,25.11,74.89,13.34
E02000124,Brent 032,10006,1389,819,1663,1942,1478,1188,768,497,222,40,2208,7798,1527,22.07,77.93,15.26
E02000125,Brent 033,10156,1431,735,1546,1772,1524,1374,892,491,317,74,2166,7990,1774,21.33,78.67,17.47
E02000126,Brent 034,7760,1286,807,1287,1190,1041,1003,571,360,186,29,2093,5667,1146,26.97,73.03,14.77
E02000127,Bromley 001,9396,1357,1103,1231,1505,1323,1232,770,505,304,66,2460,6936,1645,26.18,73.82,17.51
E02000128,Bromley 002,7763,1090,701,913,1155,1112,1084,699,646,314,49,1791,5972,1708,23.07,76.93,22.0
E02000130,Bromley 004,8757,1290,697,1050,1586,1402,1186,748,538,221,39,1987,6770,1546,22.69,77.31,17.65
E02000131,Bromley 005,10687,1377,676,1633,2858,1948,1114,574,362,121,24,2053,8634,1081,19.21,80.79,10.12
E02000132,Bromley 006,10263,1275,640,1359,2365,1588,1175,792,621,347,101,1915,8348,1861,18.66,81.34,18.13
E02000133,Bromley 007,10620,1232,1029,1035,1177,1756,1602,1040,931,627,191,2261,8359,2789,21.29,78.71,26.26
E02000134,Bromley 008,12099,1686,887,1652,2398,1891,1452,1027,698,312,96,2573,9526,2133,21.27,78.73,17.63
E02000135,Bromley 009,10690,1431,1015,1719,2002,1622,1396,805,394,231,75,2446,8244,1505,22.88,77.12,14.08
E02000136,Bromley 010,5788,701,589,683,652,731,809,582,530,392,119,1290,4498,1623,22.29,77.71,28.04
E02000137,Bromley 011,8539,1072,640,978,1350,1284,1104,824,735,421,131,1712,6827,2111,20.05,79.95,24.72
E02000138,Bromley 012,8551,882,483,889,1419,1174,1185,925,870,581,143,1365,7186,2519,15.96,84.04,29.46
E02000139,Bromley 013,7992,1203,629,868,1466,1405,1063,700,407,203,48,1832,6160,1358,22.92,77.08,16.99
E02000140,Bromley 014,8833,1460,1113,1311,1196,1139,1181,622,526,222,63,2573,6260,1433,29.13,70.87,16.22
E02000141,Bromley 015,7449,1043,601,935,1321,1313,1001,622,383,203,27,1644,5805,1235,22.07,77.93,16.58
E02000142,Bromley 016,8852,1201,869,988,1238,1386,1207,827,668,370,98,2070,6782,1963,23.38,76.62,22.18
E02000144,Bromley 018,10024,1338,779,1377,1906,1567,1260,734,662,337,64,2117,7907,1797,21.12,78.88,17.93
E02000145,Bromley 019,9122,1637,1038,1319,1352,1194,1105,671,532,237,37,2675,6447,1477,29.32,70.68,16.19
E02000146,Bromley 020,9624,1300,829,1124,1675,1549,1246,793,607,372,129,2129,7495,1901,22.12,77.88,19.75
E02000147,Bromley 021,8252,975,931,917,780,1138,1318,943,759,403,88,1906,6346,2193,23.1,76.9,26.58
E02000148,Bromley 022,6749,876,655,697,722,952,997,753,671,349,77,1531,5218,1850,22.68,77.32,27.41
E02000149,Bromley 023,8183,1161,806,1066,1189,1082,1187,747,581,307,57,1967,6216,1692,24.04,75.96,20.68
E02000150,Bromley 024,8703,1063,990,1086,914,1309,1428,847,632,359,75,2053,6650,1913,23.59,76.41,21.98
E02000151,Bromley 025,7647,1053,695,658,874,1171,1065,852,819,374,86,1748,5899,2131,22.86,77.14,27.87
E02000152,Bromley 026,8003,1316,852,1030,1162,1116,1090,637,470,268,62,2168,5835,1437,27.09,72.91,17.96
E02000153,Bromley 027,7846,942,964,789,768,1200,1246,844,689,335,69,1906,5940,1937,24.29,75.71,24.69
E02000154,Bromley 028,8517,1080,732,1071,1180,1131,1159,953,765,366,80,1812,6705,2164,21.28,78.72,25.41
E02000155,Bromley 029,6930,731,575,793,715,886,1066,843,767,491,63,1306,5624,2164,18.85,81.15,31.23
E02000156,Bromley 030,12217,1330,1317,1390,1081,1645,1843,1474,1154,771,212,2647,9570,3611,21.67,78.33,29.56
E02000157,Bromley 031,8209,938,949,747,778,1237,1193,862,829,581,95,1887,6322,2367,22.99,77.01,28.83
E02000158,Bromley 032,7863,1104,908,822,926,996,1126,747,731,401,102,2012,5851,1981,25.59,74.41,25.19
E02000159,Bromley 033,6960,686,730,812,594,971,1128,791,740,416,92,1416,5544,2039,20.34,79.66,29.3
E02000160,Bromley 034,8028,784,972,898,672,1208,1393,837,751,411,102,1756,6272,2101,21.87,78.13,26.17
E02000161,Bromley 035,8788,1190,922,772,1149,1423,1150,890,829,385,78,2112,6676,2182,24.03,75.97,24.83
E02000162,Bromley 036,7003,753,735,740,651,981,1034,710,773,477,149,1488,5515,2109,21.25,78.75,30.12
E02000163,Bromley 037,7721,924,740,770,800,1071,1165,941,788,452,70,1664,6057,2251,21.55,78.45,29.15
E02000165,Bromley 039,6977,869,703,858,900,940,1033,837,597,223,17,1572,5405,1674,22.53,77.47,23.99
E02006782,Bromley 040,8051,1077,783,949,1068,1107,1165,831,640,350,81,1860,6191,1902,23.1,76.9,23.62
E02006787,Bromley 041,8148,1178,853,791,1099,1414,1151,807,531,274,50,2031,6117,1662,24.93,75.07,20.4
E02006789,Bromley 042,6492,626,621,664,580,748,1068,823,957,366,39,1247,5245,2185,19.21,80.79,33.66
E02000166,Camden 001,9320,997,962,1224,1233,1222,1290,1069,853,396,74,1959,7361,2392,21.02,78.98,25.67
E02000167,Camden 002,9684,1309,894,973,1519,1521,1258,833,826,420,131,2203,7481,2210,22.75,77.25,22.82
E02000168,Camden 003,9687,1005,815,1601,1869,1394,1211,864,624,252,52,1820,7867,1792,18.79,81.21,18.5
E02000169,Camden 004,9771,1386,1265,1240,1301,1532,1143,701,677,387,139,2651,7120,1904,27.13,72.87,19.49
E02000170,Camden 005,9993,1129,920,1854,2009,1458,1040,739,535,251,58,2049,7944,1583,20.5,79.5,15.84
E02000171,Camden 006,9513,1191,809,1348,1816,1402,1169,799,630,271,78,2000,7513,1778,21.02,78.98,18.69
E02000172,Camden 007,12402,1639,1328,2515,2161,1533,1412,827,590,298,99,2967,9435,1814,23.92,76.08,14.63
E02000173,Camden 008,10230,1408,793,1593,2162,1715,968,687,515,312,77,2201,8029,1591,21.52,78.48,15.55
E02000174,Camden 009,10467,1018,899,2427,2108,1201,1220,843,492,233,26,1917,8550,1594,18.31,81.69,15.23
E02000175,Camden 010,11701,1033,754,2834,3010,1612,935,749,515,216,43,1787,9914,1523,15.27,84.73,13.02
E02000176,Camden 011,7940,980,501,928,1836,1400,924,548,543,216,64,1481,6459,1371,18.65,81.35,17.27
E02000177,Camden 012,10458,1211,996,2198,1852,1326,1105,714,594,325,137,2207,8251,1770,21.1,78.9,16.92
E02000178,Camden 013,10673,1262,709,2319,2444,1484,1044,706,476,198,31,1971,8702,1411,18.47,81.53,13.22
E02000179,Camden 014,7596,1084,680,1046,1363,1125,846,602,515,263,72,1764,5832,1452,23.22,76.78,19.12
E02000180,Camden 015,10161,1006,844,2885,1978,1123,992,678,426,182,47,1850,8311,1333,18.21,81.79,13.12
E02000181,Camden 016,9486,1204,688,1742,2254,1373,876,635,416,234,64,1892,7594,1349,19.95,80.05,14.22
E02000182,Camden 017,9074,1278,798,1491,1717,1315,973,567,508,286,141,2076,6998,1502,22.88,77.12,16.55
E02000183,Camden 018,8885,990,731,1211,1568,1296,1158,894,688,281,68,1721,7164,1931,19.37,80.63,21.73
E02000184,Camden 019,10819,1023,856,3372,2166,1188,1034,606,348,185,41,1879,8940,1180,17.37,82.63,10.91
E02000185,Camden 020,10191,1211,995,1776,1756,1433,1107,914,642,271,86,2206,7985,1913,21.65,78.35,18.77
E02000186,Camden 021,8500,698,559,2330,1774,1042,918,547,398,183,51,1257,7243,1179,14.79,85.21,13.87
E02000187,Camden 022,11598,1439,1247,3399,1744,1257,1043,732,432,253,52,2686,8912,1469,23.16,76.84,12.67
E02000188,Camden 023,9060,1060,938,2899,1228,916,859,577,328,215,40,1998,7062,1160,22.05,77.95,12.8
E02000189,Camden 024,7227,914,542,2279,1331,720,610,429,225,148,29,1456,5771,831,20.15,79.85,11.5
E02000190,Camden 025,8974,712,501,3502,1352,866,748,633,427,191,42,1213,7761,1293,13.52,86.48,14.41
E02000191,Camden 026,8885,454,323,4320,1286,834,706,485,319,121,37,777,8108,962,8.75,91.25,10.83
E02000192,Camden 027,8996,857,644,2015,1644,1230,1147,788,407,196,68,1501,7495,1459,16.69,83.31,16.22
E02000193,Camden 028,8738,512,406,2487,1683,1167,983,729,544,173,54,918,7820,1500,10.51,89.49,17.17
E02000194,Croydon 001,9491,1193,865,1241,1889,1601,1232,747,448,212,63,2058,7433,1470,21.68,78.32,15.49
E02000195,Croydon 002,9872,1249,961,1333,1422,1376,1403,1059,635,362,72,2210,7662,2128,22.39,77.61,21.56
E02000196,Croydon 003,8055,1032,741,1282,1269,1008,1097,814,489,286,37,1773,6282,1626,22.01,77.99,20.19
E02000197,Croydon 004,9642,1342,1013,1308,1555,1359,1279,872,553,303,58,2355,7287,1786,24.42,75.58,18.52
E02000198,Croydon 005,8757,1431,1051,1194,1266,1307,1261,692,341,183,31,2482,6275,1247,28.34,71.66,14.24
E02000199,Croydon 006,8342,1115,1009,1140,1137,1246,1364,787,339,178,27,2124,6218,1331,25.46,74.54,15.96
E02000200,Croydon 007,8886,1197,833,1160,1573,1400,1260,704,427,261,71,2030,6856,1463,22.84,77.16,16.46
E02000201,Croydon 008,9274,1620,1003,1381,1553,1326,1245,618,306,198,24,2623,6651,1146,28.28,71.72,12.36
E02000202,Croydon 009,8483,1154,925,1103,1177,1174,1322,803,481,302,42,2079,6404,1628,24.51,75.49,19.19
E02000203,Croydon 010,8106,1232,847,1122,1284,1158,1095,718,394,230,26,2079,6027,1368,25.65,74.35,16.88
E02000204,Croydon 011,9711,1430,1063,1437,1389,1327,1327,916,498,267,57,2493,7218,1738,25.67,74.33,17.9
E02000206,Croydon 013,10224,1636,1134,1429,1657,1441,1321,813,414,299,80,2770,7454,1606,27.09,72.91,15.71
E02000207,Croydon 014,9138,1314,1002,1409,1455,1231,1383,763,386,176,19,2316,6822,1344,25.34,74.66,14.71
E02000208,Croydon 015,10944,1899,1326,1674,1812,1735,1250,695,338,169,46,3225,7719,1248,29.47,70.53,11.4
E02000209,Croydon 016,8781,1330,1131,1210,1365,1294,1205,736,296,179,35,2461,6320,1246,28.03,71.97,14.19
E02000210,Croydon 017,8454,1223,838,1107,1417,1285,1279,717,364,196,28,2061,6393,1305,24.38,75.62,15.44
E02000211,Croydon 018,8068,823,729,1000,935,955,1289,997,820,425,95,1552,6516,2337,19.24,80.76,28.97
E02000212,Croydon 019,9367,1576,1239,1279,1522,1405,1227,634,307,164,14,2815,6552,1119,30.05,69.95,11.95
E02000213,Croydon 020,11475,2114,1087,1878,2217,1668,1308,690,353,142,18,3201,8274,1203,27.9,72.1,10.48
E02000214,Croydon 021,6217,710,619,774,728,798,1020,786,465,265,52,1329,4888,1568,21.38,78.62,25.22
E02000215,Croydon 022,11588,1548,888,1932,2477,1599,1393,829,549,303,70,2436,9152,1751,21.02,78.98,15.11
E02000216,Croydon 023,7096,1033,572,759,1287,984,741,657,564,377,122,1605,5491,1720,22.62,77.38,24.24
E02000217,Croydon 024,12391,2035,1214,2050,2657,1796,1369,712,355,163,40,3249,9142,1270,26.22,73.78,10.25
E02000218,Croydon 025,6606,970,868,889,671,841,969,730,404,216,48,1838,4768,1398,27.82,72.18,21.16
E02000219,Croydon 026,7462,609,653,870,629,841,1244,1063,944,471,138,1262,6200,2616,16.91,83.09,35.06
E02000220,Croydon 027,13392,1973,840,2588,3438,1875,1160,743,442,231,102,2813,10579,1518,21.01,78.99,11.34
E02000221,Croydon 028,10780,1602,1373,1585,1576,1464,1437,798,551,280,114,2975,7805,1743,27.6,72.4,16.17
E02000222,Croydon 029,8338,1167,661,1167,1634,1229,1028,700,486,231,35,1828,6510,1452,21.92,78.08,17.41
E02000223,Croydon 030,8585,1631,1461,1314,990,1057,1072,478,344,211,27,3092,5493,1060,36.02,63.98,12.35
E02000224,Croydon 031,8092,1290,698,1093,1562,1133,1012,634,416,220,34,1988,6104,1304,24.57,75.43,16.11
E02000225,Croydon 032,7529,1045,981,1017,906,968,1121,742,498,212,39,2026,5503,1491,26.91,73.09,19.8
E02000226,Croydon 033,7527,726,753,962,759,866,1202,1007,761,404,87,1479,6048,2259,19.65,80.35,30.01
E02000227,Croydon 034,11457,1533,1059,1489,1465,1467,1626,1340,971,421,86,2592,8865,2818,22.62,77.38,24.6
E02000228,Croydon 035,7783,928,703,733,817,1024,1146,982,866,455,129,1631,6152,2432,20.96,79.04,31.25
E02000229,Croydon 036,6729,1088,884,876,863,797,1010,576,371,191,73,1972,4757,1211,29.31,70.69,18.0
E02000230,Croydon 037,10618,1333,984,1296,1564,1457,1515,1094,802,444,129,2317,8301,2469,21.82,78.18,23.25
E02000231,Croydon 038,7583,751,759,881,724,960,1211,1075,728,404,90,1510,6073,2297,19.91,80.09,30.29
E02000232,Croydon 039,6267,717,655,662,636,830,945,772,640,348,62,1372,4895,1822,21.89,78.11,29.07
E02000233,Croydon 040,6378,929,638,748,1017,890,824,600,384,259,89,1567,4811,1332,24.57,75.43,20.88
E02000234,Croydon 041,8948,1232,912,1074,1274,1276,1257,886,650,321,66,2144,6804,1923,23.96,76.04,21.49
E02000235,Croydon 042,6966,861,674,810,814,984,1081,824,587,264,67,1535,5431,1742,22.04,77.96,25.01
E02000236,Croydon 043,8136,1244,780,791,1152,1143,1149,916,646,249,66,2024,6112,1877,24.88,75.12,23.07
E02000237,Croydon 044,7589,965,659,737,815,897,1194,946,854,407,115,1624,5965,2322,21.4,78.6,30.6
E02006788,Croydon 045,7583,1122,894,1042,1074,1080,1179,640,352,174,26,2016,5567,1192,26.59,73.41,15.72
E02000238,Ealing 001,9364,1373,1033,1302,1529,1360,1180,815,520,213,39,2406,6958,1587,25.69,74.31,16.95
E02000239,Ealing 002,8767,1103,832,1234,1429,1148,1121,913,612,308,67,1935,6832,1900,22.07,77.93,21.67
E02000240,Ealing 003,10041,1620,1200,1343,1576,1400,1239,832,509,265,57,2820,7221,1663,28.08,71.92,16.56
E02000241,Ealing 004,6710,979,699,890,1146,899,857,635,372,193,40,1678,5032,1240,25.01,74.99,18.48
E02000242,Ealing 005,6824,911,700,1048,1098,971,829,676,359,198,34,1611,5213,1267,23.61,76.39,18.57
E02000243,Ealing 006,8413,1179,799,1132,1407,1151,1043,811,486,373,32,1978,6435,1702,23.51,76.49,20.23
E02000244,Ealing 007,7520,1049,666,971,1356,1169,886,698,453,241,31,1715,5805,1423,22.81,77.19,18.92
E02000245,Ealing 008,8309,1597,942,1099,1271,1083,1069,636,338,225,49,2539,5770,1248,30.56,69.44,15.02
E02000246,Ealing 009,8545,1478,1090,1183,1164,1039,1122,764,407,237,61,2568,5977,1469,30.05,69.95,17.19
E02000247,Ealing 010,10522,1805,1185,1323,1625,1500,1171,884,533,374,122,2990,7532,1913,28.42,71.58,18.18
E02000248,Ealing 011,7738,1126,592,1224,1509,1112,909,606,380,240,40,1718,6020,1266,22.2,77.8,16.36
E02000249,Ealing 012,7419,1054,757,1030,1113,1033,928,645,473,309,77,1811,5608,1504,24.41,75.59,20.27
E02000250,Ealing 013,6225,884,590,677,694,927,859,756,517,264,57,1474,4751,1594,23.68,76.32,25.61
E02000251,Ealing 014,7357,1000,788,936,1060,1006,1024,780,455,286,22,1788,5569,1543,24.3,75.7,20.97
E02000252,Ealing 015,11666,1324,736,3544,2110,1563,1019,727,381,222,40,2060,9606,1370,17.66,82.34,11.74
E02000253,Ealing 016,9257,1422,1129,1126,1204,1333,1183,843,597,350,70,2551,6706,1860,27.56,72.44,20.09
E02000254,Ealing 017,8385,1122,881,1047,1270,1176,1122,918,541,234,74,2003,6382,1767,23.89,76.11,21.07
E02000255,Ealing 018,9133,1291,944,1199,1241,1264,1228,888,635,338,105,2235,6898,1966,24.47,75.53,21.53
E02000256,Ealing 019,8885,1150,714,1394,1644,1348,1101,737,474,265,58,1864,7021,1534,20.98,79.02,17.27
E02000257,Ealing 020,14622,1742,1048,2663,2774,2297,1601,1142,792,435,128,2790,11832,2497,19.08,80.92,17.08
E02000258,Ealing 021,7030,974,639,1225,1205,1123,745,554,337,179,49,1613,5417,1119,22.94,77.06,15.92
E02000259,Ealing 022,5984,906,661,690,802,956,779,639,346,163,42,1567,4417,1190,26.19,73.81,19.89
E02000260,Ealing 023,9423,1391,1020,1073,1420,1346,1193,990,558,373,59,2411,7012,1980,25.59,74.41,21.01
E02000261,Ealing 024,12100,1604,1157,2387,2314,1672,1287,790,561,262,66,2761,9339,1679,22.82,77.18,13.88
E02000262,Ealing 025,8797,1182,712,1415,1627,1325,1141,688,433,208,66,1894,6903,1395,21.53,78.47,15.86
E02000263,Ealing 026,12051,1790,1384,1379,1769,1939,1546,1135,640,379,90,3174,8877,2244,26.34,73.66,18.62
E02000264,Ealing 027,8452,881,634,1583,1442,1225,1052,756,517,288,74,1515,6937,1635,17.92,82.08,19.34
E02000265,Ealing 028,10582,1628,879,1532,1885,1701,1303,750,578,264,62,2507,8075,1654,23.69,76.31,15.63
E02000266,Ealing 029,11525,1688,1344,1679,1743,1691,1511,981,511,307,70,3032,8493,1869,26.31,73.69,16.22
E02000267,Ealing 030,7222,1189,680,824,1158,1225,967,603,335,194,47,1869,5353,1179,25.88,74.12,16.33
E02000268,Ealing 031,8913,968,682,1459,1465,1321,1229,848,589,300,52,1650,7263,1789,18.51,81.49,20.07
E02000269,Ealing 032,7826,1144,632,1108,1224,1201,1064,729,445,211,68,1776,6050,1453,22.69,77.31,18.57
E02000270,Ealing 033,7845,1294,747,1228,1404,1119,910,565,330,200,48,2041,5804,1143,26.02,73.98,14.57
E02000271,Ealing 034,6892,978,590,869,1041,1117,1036,614,435,169,43,1568,5324,1261,22.75,77.25,18.3
E02000272,Ealing 035,6434,875,589,754,807,1019,937,657,479,268,49,1464,4970,1453,22.75,77.25,22.58
E02000274,Ealing 037,14191,2339,1677,1746,2255,2229,1834,1193,606,267,45,4016,10175,2111,28.3,71.7,14.88
E02000275,Ealing 038,7578,1139,773,891,1135,1042,967,788,501,284,58,1912,5666,1631,25.23,74.77,21.52
E02000276,Ealing 039,6472,963,548,870,1169,1113,767,536,321,155,30,1511,4961,1042,23.35,76.65,16.1
E02006791,Ealing 040,6787,898,459,955,1231,1224,910,561,406,128,15,1357,5430,1110,19.99,80.01,16.35
E02000277,Enfield 001,7670,1134,923,1261,1066,958,1033,587,430,235,43,2057,5613,1295,26.82,73.18,16.88
E02000278,Enfield 002,9757,1624,1296,1551,1411,1215,1226,618,485,262,69,2920,6837,1434,29.93,70.07,14.7
E02000279,Enfield 003,13062,2277,1728,2224,2059,1713,1589,820,428,203,21,4005,9057,1472,30.66,69.34,11.27
E02000280,Enfield 004,8507,1254,807,996,1178,1176,1181,864,660,306,85,2061,6446,1915,24.23,75.77,22.51
E02000281,Enfield 005,9221,1589,957,1304,1387,1269,1232,659,504,261,59,2546,6675,1483,27.61,72.39,16.08
E02000282,Enfield 006,9966,1863,1306,1572,1389,1339,1234,638,448,161,16,3169,6797,1263,31.8,68.2,12.67
E02000283,Enfield 007,8854,1313,1116,1514,1126,1176,1231,679,427,221,51,2429,6425,1378,27.43,72.57,15.56
E02000284,Enfield 008,8646,1225,786,1112,1351,1297,1124,792,601,288,70,2011,6635,1751,23.26,76.74,20.25
E02000285,Enfield 009,6423,757,581,825,752,861,1057,706,548,285,51,1338,5085,1590,20.83,79.17,24.75
E02000286,Enfield 010,8512,994,547,998,1363,1162,1102,946,789,480,131,1541,6971,2346,18.1,81.9,27.56
E02000287,Enfield 011,7197,821,676,919,886,878,1011,812,700,372,122,1497,5700,2006,20.8,79.2,27.87
E02000288,Enfield 012,11404,1850,1470,1797,1667,1591,1419,795,490,275,50,3320,8084,1610,29.11,70.89,14.12
E02000289,Enfield 013,6549,708,705,756,657,856,1031,707,681,386,62,1413,5136,1836,21.58,78.42,28.03
E02000290,Enfield 014,6815,1266,943,1035,996,960,727,465,246,157,20,2209,4606,888,32.41,67.59,13.03
E02000291,Enfield 015,10283,1556,817,1456,1948,1361,1205,818,570,429,123,2373,7910,1940,23.08,76.92,18.87
E02000292,Enfield 016,9827,1440,1114,1468,1519,1312,1318,805,512,299,40,2554,7273,1656,25.99,74.01,16.85
E02000293,Enfield 017,6451,778,590,714,744,827,1009,727,621,350,91,1368,5083,1789,21.21,78.79,27.73
E02000294,Enfield 018,9503,1379,1221,1489,1294,1191,1291,777,531,288,42,2600,6903,1638,27.36,72.64,17.24
E02000295,Enfield 019,8947,1250,949,1087,1336,1288,1142,747,600,425,123,2199,6748,1895,24.58,75.42,21.18
E02000296,Enfield 020,10567,1308,954,1635,1889,1517,1270,786,650,438,120,2262,8305,1994,21.41,78.59,18.87
E02000297,Enfield 021,9586,1099,798,1271,1339,1204,1349,1097,857,460,112,1897,7689,2526,19.79,80.21,26.35
E02000298,Enfield 022,8060,978,736,951,1035,1167,1260,848,649,359,77,1714,6346,1933,21.27,78.73,23.98
E02000299,Enfield 023,10162,1620,1295,1629,1459,1365,1307,804,403,234,46,2915,7247,1487,28.69,71.31,14.63
E02000300,Enfield 024,9065,1472,1018,1487,1350,1223,1116,724,421,213,41,2490,6575,1399,27.47,72.53,15.43
E02000301,Enfield 025,10907,1812,1413,1772,1652,1435,1314,748,474,238,49,3225,7682,1509,29.57,70.43,13.84
E02000302,Enfield 026,8552,1234,754,1089,1299,1208,1150,859,634,266,59,1988,6564,1818,23.25,76.75,21.26
E02000303,Enfield 027,9179,1405,1176,1569,1302,1228,1147,695,417,202,38,2581,6598,1352,28.12,71.88,14.73
E02000304,Enfield 028,8078,928,718,1014,1014,1089,1250,891,699,376,99,1646,6432,2065,20.38,79.62,25.56
E02000305,Enfield 029,8966,1035,676,1322,1682,1391,1179,813,514,270,84,1711,7255,1681,19.08,80.92,18.75
E02000306,Enfield 030,9238,1558,1135,1415,1487,1252,1111,635,401,211,33,2693,6545,1280,29.15,70.85,13.86
E02000307,Enfield 031,10080,1382,1124,1597,1574,1222,1354,925,557,297,48,2506,7574,1827,24.86,75.14,18.12
E02000308,Enfield 032,8521,1105,743,1432,1597,1216,985,670,512,230,31,1848,6673,1443,21.69,78.31,16.93
E02000309,Enfield 033,12410,2063,1569,2022,1952,1846,1502,829,401,193,33,3632,8778,1456,29.27,70.73,11.73
E02000311,Enfield 035,10863,1452,992,1912,1810,1475,1285,958,643,280,56,2444,8419,1937,22.5,77.5,17.83
E02000312,Enfield 036,11774,1390,780,2054,2470,1733,1442,911,580,349,65,2170,9604,1905,18.43,81.57,16.18
E02006793,Enfield 037,10192,1619,1358,1686,1700,1412,1199,640,328,203,47,2977,7215,1218,29.21,70.79,11.95
E02000313,Greenwich 001,7470,1116,955,1068,1141,1231,1051,552,274,69,13,2071,5399,908,27.72,72.28,12.16
E02000314,Greenwich 002,16074,2517,1883,2968,2818,2912,1870,723,283,78,22,4400,11674,1106,27.37,72.63,6.88
E02000315,Greenwich 003,9649,1663,1294,1290,1469,1343,1259,670,366,224,71,2957,6692,1331,30.65,69.35,13.79
E02000316,Greenwich 004,15129,1939,1009,3179,4194,2282,1255,731,369,129,42,2948,12181,1271,19.49,80.51,8.4
E02000317,Greenwich 005,8166,1425,908,1259,1340,1214,989,551,322,130,28,2333,5833,1031,28.57,71.43,12.63
E02000318,Greenwich 006,10520,1601,981,1496,1923,1663,1296,771,519,238,32,2582,7938,1560,24.54,75.46,14.83
E02000319,Greenwich 007,11701,1869,979,1907,2665,1755,1285,710,344,150,37,2848,8853,1241,24.34,75.66,10.61
E02000320,Greenwich 008,7330,1202,752,1095,1123,1127,950,614,318,119,30,1954,5376,1081,26.66,73.34,14.75
E02000321,Greenwich 009,7703,1252,790,1200,1324,1121,930,602,322,114,48,2042,5661,1086,26.51,73.49,14.1
E02000323,Greenwich 011,11331,1858,1169,1830,2268,1702,1218,683,364,192,47,3027,8304,1286,26.71,73.29,11.35
E02000324,Greenwich 012,7934,1185,934,1175,1257,1191,902,627,399,216,48,2119,5815,1290,26.71,73.29,16.26
E02000326,Greenwich 014,7457,1129,652,1088,1377,1264,856,559,340,159,33,1781,5676,1091,23.88,76.12,14.63
E02000327,Greenwich 015,7129,1233,780,1398,1314,900,868,389,165,70,12,2013,5116,636,28.24,71.76,8.92
E02000328,Greenwich 016,6870,848,550,945,1252,1102,749,624,483,258,59,1398,5472,1424,20.35,79.65,20.73
E02000329,Greenwich 017,6421,846,602,876,1064,888,860,657,378,200,50,1448,4973,1285,22.55,77.45,20.01
E02000331,Greenwich 019,8364,1169,882,1331,1554,1243,967,573,378,211,56,2051,6313,1218,24.52,75.48,14.56
E02000332,Greenwich 020,7619,1061,671,964,1130,1285,1049,714,495,200,50,1732,5887,1459,22.73,77.27,19.15
E02000333,Greenwich 021,6484,802,437,933,1208,1054,738,491,484,250,87,1239,5245,1312,19.11,80.89,20.23
E02000334,Greenwich 022,6619,881,644,892,1032,988,938,628,384,194,38,1525,5094,1244,23.04,76.96,18.79
E02000335,Greenwich 023,6832,987,546,728,1011,1056,946,686,526,283,63,1533,5299,1558,22.44,77.56,22.8
E02000337,Greenwich 025,8265,1105,906,1090,1214,1225,1176,743,542,226,38,2011,6254,1549,24.33,75.67,18.74
E02000339,Greenwich 027,6307,767,593,761,816,927,847,724,505,286,81,1360,4947,1596,21.56,78.44,25.31
E02000340,Greenwich 028,6667,762,484,992,1002,955,802,643,577,358,92,1246,5421,1670,18.69,81.31,25.05
E02000341,Greenwich 029,8218,1252,1001,1071,1326,1159,1047,642,470,211,39,2253,5965,1362,27.42,72.58,16.57
E02000342,Greenwich 030,6208,810,603,1420,888,747,698,508,306,176,52,1413,4795,1042,22.76,77.24,16.78
E02000343,Greenwich 031,6916,982,718,903,971,917,965,663,492,239,66,1700,5216,1460,24.58,75.42,21.11
E02000344,Greenwich 032,6547,899,566,845,969,871,858,654,560,261,64,1465,5082,1539,22.38,77.62,23.51
E02006786,Greenwich 033,7459,1194,765,1099,1135,1061,1076,592,378,147,12,1959,5500,1129,26.26,73.74,15.14
E02006927,Greenwich 034,10462,1660,986,1368,1772,1473,1226,818,721,347,91,2646,7816,1977,25.29,74.71,18.9
E02006928,Greenwich 035,12139,1513,804,3849,3027,1430,786,438,235,45,12,2317,9822,730,19.09,80.91,6.01
E02006929,Greenwich 036,13019,1915,942,3009,3364,1704,957,582,316,196,34,2857,10162,1128,21.94,78.06,8.66
E02006930,Greenwich 037,9127,1341,553,1967,2218,1346,741,473,305,167,16,1894,7233,961,20.75,79.25,10.53
E02006931,Greenwich 038,9806,1209,716,1882,2015,1445,1024,672,510,255,78,1925,7881,1515,19.63,80.37,15.45
E02000345,Hackney 001,9679,2465,1480,1432,1502,1098,674,515,353,127,33,3945,5734,1028,40.76,59.24,10.62
E02000346,Hackney 002,8177,1365,670,1369,1801,1068,855,581,286,145,37,2035,6142,1049,24.89,75.11,12.83
E02000347,Hackney 003,8858,2074,1248,1314,1460,950,774,512,313,155,58,3322,5536,1038,37.5,62.5,11.72
E02000348,Hackney 004,9051,2278,1292,1295,1430,951,847,556,229,134,39,3570,5481,958,39.44,60.56,10.58
E02000350,Hackney 006,10055,1579,958,1755,2553,1291,957,529,306,105,22,2537,7518,962,25.23,74.77,9.57
E02000351,Hackney 007,9853,972,572,2251,2980,1258,882,489,277,135,37,1544,8309,938,15.67,84.33,9.52
E02000352,Hackney 008,7232,1114,695,992,1543,1079,789,499,292,163,66,1809,5423,1020,25.01,74.99,14.1
E02000353,Hackney 009,8181,978,555,1355,2134,1194,902,529,311,184,39,1533,6648,1063,18.74,81.26,12.99
E02000354,Hackney 010,10661,1394,848,1812,2686,1517,1135,666,413,159,31,2242,8419,1269,21.03,78.97,11.9
E02000355,Hackney 011,9260,1059,715,1475,2398,1369,1005,617,344,233,45,1774,7486,1239,19.16,80.84,13.38
E02000356,Hackney 012,7411,827,591,1126,1955,1192,894,455,243,112,16,1418,5993,826,19.13,80.87,11.15
E02000357,Hackney 013,6553,1051,866,910,1067,803,757,568,342,160,29,1917,4636,1099,29.25,70.75,16.77
E02000358,Hackney 014,11914,1209,851,2132,3397,1782,1182,686,427,205,43,2060,9854,1361,17.29,82.71,11.42
E02000359,Hackney 015,6680,877,555,1147,1559,979,747,390,271,131,24,1432,5248,816,21.44,78.56,12.22
E02000360,Hackney 016,12145,1653,1278,1941,2726,1708,1307,868,373,253,38,2931,9214,1532,24.13,75.87,12.61
E02000361,Hackney 017,9136,925,628,1901,2643,1283,877,500,227,129,23,1553,7583,879,17.0,83.0,9.62
E02000362,Hackney 018,7492,905,706,1355,1849,1035,783,462,246,121,30,1611,5881,859,21.5,78.5,11.47
E02000363,Hackney 019,11878,1847,1452,1766,2391,1671,1364,751,367,214,55,3299,8579,1387,27.77,72.23,11.68
E02000364,Hackney 020,10462,1124,745,1787,2848,1432,1048,772,486,183,37,1869,8593,1478,17.86,82.14,14.13
E02000365,Hackney 021,15488,1362,782,3245,5162,2010,1256,856,521,230,64,2144,13344,1671,13.84,86.16,10.79
E02000366,Hackney 022,9274,1247,833,1479,1894,1380,1128,676,360,191,86,2080,7194,1313,22.43,77.57,14.16
E02000367,Hackney 023,11712,1349,841,2094,3523,1840,1158,542,278,75,12,2190,9522,907,18.7,81.3,7.74
E02000368,Hackney 024,10641,1304,927,1988,2567,1459,1077,688,413,188,30,2231,8410,1319,20.97,79.03,12.4
E02000369,Hackney 025,14682,1731,1156,2612,4474,2055,1250,745,438,189,32,2887,11795,1404,19.66,80.34,9.56
E02000370,Hackney 026,10060,1214,783,2015,2646,1425,1061,527,236,128,25,1997,8063,916,19.85,80.15,9.11
E02000371,Hackney 027,16469,1054,945,6363,4256,1809,1037,540,274,150,41,1999,14470,1005,12.14,87.86,6.1
E02006918,Hackney 028,9450,1655,1079,1389,2237,1349,870,472,254,112,33,2734,6716,871,28.93,71.07,9.22
E02006921,Hackney 029,8666,2099,1104,1225,1353,1024,827,594,257,162,21,3203,5463,1034,36.96,63.04,11.93
E02000372,Hammersmith and Fulham 001,9789,1145,870,2261,1652,1333,1191,700,379,212,46,2015,7774,1337,20.58,79.42,13.66
E02000373,Hammersmith and Fulham 002,6628,1006,900,1100,1007,880,828,483,259,131,34,1906,4722,907,28.76,71.24,13.68
E02000374,Hammersmith and Fulham 003,6767,845,672,1325,1189,887,804,502,332,170,41,1517,5250,1045,22.42,77.58,15.44
E02000375,Hammersmith and Fulham 004,7146,970,588,1339,1339,1026,862,547,285,154,36,1558,5588,1022,21.8,78.2,14.3
E02000376,Hammersmith and Fulham 005,6873,739,434,1450,1544,1021,840,414,265,136,30,1173,5700,845,17.07,82.93,12.29
E02000377,Hammersmith and Fulham 006,8186,1034,564,1646,1535,1136,1039,636,376,161,59,1598,6588,1232,19.52,80.48,15.05
E02000378,Hammersmith and Fulham 007,6464,762,383,1209,1371,1016,752,504,306,136,25,1145,5319,971,17.71,82.29,15.02
E02000379,Hammersmith and Fulham 008,7908,1104,700,1174,1305,1241,987,580,449,280,88,1804,6104,1397,22.81,77.19,17.67
E02000380,Hammersmith and Fulham 009,5737,859,441,953,901,939,733,448,303,138,22,1300,4437,911,22.66,77.34,15.88
E02000381,Hammersmith and Fulham 010,7926,1033,728,1488,1277,1333,941,565,413,116,32,1761,6165,1126,22.22,77.78,14.21
E02000382,Hammersmith and Fulham 011,5893,681,488,979,1222,858,811,426,295,113,20,1169,4724,854,19.84,80.16,14.49
E02000383,Hammersmith and Fulham 012,8869,747,407,2122,1794,1217,1012,666,567,251,86,1154,7715,1570,13.01,86.99,17.7
E02000384,Hammersmith and Fulham 013,7453,809,577,1416,1415,1089,841,586,397,260,63,1386,6067,1306,18.6,81.4,17.52
E02000385,Hammersmith and Fulham 014,5870,423,242,1671,1437,901,545,345,225,63,18,665,5205,651,11.33,88.67,11.09
E02000386,Hammersmith and Fulham 015,8039,879,697,1761,1503,1092,945,608,367,161,26,1576,6463,1162,19.6,80.4,14.45
E02000387,Hammersmith and Fulham 016,5980,567,413,1500,1182,822,634,411,303,134,14,980,5000,862,16.39,83.61,14.41
E02000388,Hammersmith and Fulham 017,8692,963,529,1912,1794,1251,931,565,442,254,51,1492,7200,1312,17.17,82.83,15.09
E02000389,Hammersmith and Fulham 018,8509,1005,671,1730,1433,1190,1016,663,496,261,44,1676,6833,1464,19.7,80.3,17.21
E02000390,Hammersmith and Fulham 019,6316,822,462,1366,1229,979,640,387,291,117,23,1284,5032,818,20.33,79.67,12.95
E02000391,Hammersmith and Fulham 020,8072,1039,642,1404,1378,1295,965,694,421,191,43,1681,6391,1349,20.83,79.17,16.71
E02000392,Hammersmith and Fulham 021,9483,1206,817,1957,1836,1438,1030,577,405,189,28,2023,7460,1199,21.33,78.67,12.64
E02000393,Hammersmith and Fulham 022,5928,823,395,1089,1230,951,648,358,259,150,25,1218,4710,792,20.55,79.45,13.36
E02000394,Hammersmith and Fulham 023,9284,1235,730,1808,1837,1368,1052,626,426,181,21,1965,7319,1254,21.17,78.83,13.51
E02000395,Hammersmith and Fulham 024,6251,731,453,1183,1027,871,766,499,437,228,56,1184,5067,1220,18.94,81.06,19.52
E02000396,Hammersmith and Fulham 025,7080,1047,755,1149,1041,1081,923,530,398,134,22,1802,5278,1084,25.45,74.55,15.31
E02000397,Haringey 001,8561,1119,713,1330,1784,1345,1135,598,332,172,33,1832,6729,1135,21.4,78.6,13.26
E02000398,Haringey 002,7865,1248,978,1175,1261,1086,1056,623,258,148,32,2226,5639,1061,28.3,71.7,13.49
E02000400,Haringey 004,8098,1081,822,1235,1372,1280,1026,636,412,194,40,1903,6195,1282,23.5,76.5,15.83
E02000401,Haringey 005,6604,853,862,1019,912,980,995,553,272,140,18,1715,4889,983,25.97,74.03,14.88
E02000402,Haringey 006,6612,947,739,1036,978,978,973,514,276,139,32,1686,4926,961,25.5,74.5,14.53
E02000403,Haringey 007,8217,967,623,1425,1921,1364,935,511,265,171,35,1590,6627,982,19.35,80.65,11.95
E02000404,Haringey 008,7738,969,702,1335,1587,1140,884,550,366,187,18,1671,6067,1121,21.59,78.41,14.49
E02000405,Haringey 009,6398,971,688,666,844,1146,895,636,352,175,25,1659,4739,1188,25.93,74.07,18.57
E02000406,Haringey 010,7176,823,641,1319,1477,1041,926,499,298,135,17,1464,5712,949,20.4,79.6,13.22
E02000407,Haringey 011,7609,1037,808,1239,1257,1283,946,538,296,186,19,1845,5764,1039,24.25,75.75,13.65
E02000408,Haringey 012,8446,1145,956,1662,1281,1229,1074,577,325,188,9,2101,6345,1099,24.88,75.12,13.01
E02000409,Haringey 013,6156,832,628,1025,984,845,777,602,281,163,19,1460,4696,1065,23.72,76.28,17.3
E02000410,Haringey 014,6614,833,736,843,967,1153,897,597,383,168,37,1569,5045,1185,23.72,76.28,17.92
E02000411,Haringey 015,10789,1319,974,2892,1926,1404,1190,560,364,152,8,2293,8496,1084,21.25,78.75,10.05
E02000412,Haringey 016,7771,840,601,1514,1790,1147,842,527,299,188,23,1441,6330,1037,18.54,81.46,13.34
E02000413,Haringey 017,7575,1080,896,876,1032,1272,1072,622,429,229,67,1976,5599,1347,26.09,73.91,17.78
E02000414,Haringey 018,7088,941,630,1099,1416,1150,853,535,279,167,18,1571,5517,999,22.16,77.84,14.09
E02000415,Haringey 019,7286,839,505,1349,1582,1161,765,528,326,213,18,1344,5942,1085,18.45,81.55,14.89
E02000416,Haringey 020,8134,1087,643,1220,1702,1302,995,612,415,130,28,1730,6404,1185,21.27,78.73,14.57
E02000417,Haringey 021,6569,753,543,852,1026,1084,843,673,455,279,61,1296,5273,1468,19.73,80.27,22.35
E02000418,Haringey 022,5341,699,464,517,746,824,833,630,443,154,31,1163,4178,1258,21.77,78.23,23.55
E02000419,Haringey 023,8974,1072,574,1838,2201,1401,904,454,328,178,24,1646,7328,984,18.34,81.66,10.97
E02000420,Haringey 024,8251,1067,615,1389,1635,1323,978,683,394,143,24,1682,6569,1244,20.39,79.61,15.08
E02000421,Haringey 025,8258,995,825,1666,1512,1246,997,515,278,189,35,1820,6438,1017,22.04,77.96,12.32
E02000422,Haringey 026,8380,1046,775,1424,1752,1234,964,590,359,193,43,1821,6559,1185,21.73,78.27,14.14
E02000423,Haringey 027,7457,761,413,1690,1860,1127,739,444,245,151,27,1174,6283,867,15.74,84.26,11.63
E02000424,Haringey 028,6762,830,552,1102,1277,1082,930,559,292,108,30,1382,5380,989,20.44,79.56,14.63
E02000425,Haringey 029,7891,1961,1454,1046,1115,894,660,415,191,132,23,3415,4476,761,43.28,56.72,9.64
E02000426,Haringey 030,6109,694,540,716,937,951,798,581,562,250,80,1234,4875,1473,20.2,79.8,24.11
E02000427,Haringey 031,6903,707,374,1476,1638,1172,729,435,226,123,23,1081,5822,807,15.66,84.34,11.69
E02000428,Haringey 032,8247,1027,729,1879,1628,1081,932,480,293,169,29,1756,6491,971,21.29,78.71,11.77
E02000429,Haringey 033,6893,925,533,738,1212,1200,962,633,466,187,37,1458,5435,1323,21.15,78.85,19.19
E02000430,Haringey 034,7072,790,407,1148,1574,1181,937,573,328,104,30,1197,5875,1035,16.93,83.07,14.64
E02000431,Haringey 035,6103,706,472,1031,1234,979,708,417,352,168,36,1178,4925,973,19.3,80.7,15.94
E02000432,Haringey 036,6124,622,374,1153,1532,925,697,447,255,103,16,996,5128,821,16.26,83.74,13.41
E02006794,Haringey 037,8576,1482,990,1173,1504,1221,1088,564,317,207,30,2472,6104,1118,28.82,71.18,13.04
E02000433,Harrow 001,8230,957,673,921,1013,993,954,864,887,693,275,1630,6600,2719,19.81,80.19,33.04
E02000434,Harrow 002,9609,1268,850,1298,1427,1343,1108,1046,709,447,113,2118,7491,2315,22.04,77.96,24.09
E02000435,Harrow 003,7773,1034,743,1013,1054,1008,902,838,686,392,103,1777,5996,2019,22.86,77.14,25.97
E02000436,Harrow 004,5543,561,464,571,503,700,805,809,692,378,60,1025,4518,1939,18.49,81.51,34.98
E02000437,Harrow 005,8574,1109,873,1051,1168,1040,1172,948,702,405,106,1982,6592,2161,23.12,76.88,25.2
E02000438,Harrow 006,7883,976,756,1042,984,1032,1026,909,599,406,153,1732,6151,2067,21.97,78.03,26.22
E02000439,Harrow 007,9044,1381,902,1333,1448,1193,1121,812,508,301,45,2283,6761,1666,25.24,74.76,18.42
E02000440,Harrow 008,9637,1354,953,1360,1209,1339,1263,1058,669,358,74,2307,7330,2159,23.94,76.06,22.4
E02000441,Harrow 009,7088,969,639,749,978,963,931,803,630,344,82,1608,5480,1859,22.69,77.31,26.23
E02000442,Harrow 010,9086,1365,871,1475,1546,1204,1108,859,404,214,40,2236,6850,1517,24.61,75.39,16.7
E02000443,Harrow 011,10327,1686,1123,1589,1646,1362,1229,828,480,312,72,2809,7518,1692,27.2,72.8,16.38
E02000444,Harrow 012,8781,1287,889,1191,1343,1184,1041,922,539,313,72,2176,6605,1846,24.78,75.22,21.02
E02000445,Harrow 013,11298,1810,1100,1654,2010,1492,1337,891,567,362,75,2910,8388,1895,25.76,74.24,16.77
E02000447,Harrow 015,7282,1012,710,924,1017,985,994,763,590,229,58,1722,5560,1640,23.65,76.35,22.52
E02000448,Harrow 016,6942,867,699,678,880,945,968,795,643,349,118,1566,5376,1905,22.56,77.44,27.44
E02000449,Harrow 017,8367,1060,799,1307,1365,1119,1052,830,484,295,56,1859,6508,1665,22.22,77.78,19.9
E02000451,Harrow 019,6544,791,609,827,819,915,901,766,559,290,67,1400,5144,1682,21.39,78.61,25.7
E02000452,Harrow 020,8705,1428,701,1230,1921,1334,854,638,376,179,44,2129,6576,1237,24.46,75.54,14.21
E02000453,Harrow 021,8256,1218,759,1177,1454,1151,1020,742,452,237,46,1977,6279,1477,23.95,76.05,17.89
E02000454,Harrow 022,7013,1024,757,687,793,1008,970,767,620,316,71,1781,5232,1774,25.4,74.6,25.3
E02000455,Harrow 023,10221,1638,683,1684,2327,1387,962,649,531,307,53,2321,7900,1540,22.71,77.29,15.07
E02000456,Harrow 024,7282,1016,665,1052,1120,1068,917,711,420,247,66,1681,5601,1444,23.08,76.92,19.83
E02000457,Harrow 025,6603,800,635,822,918,931,898,714,548,293,44,1435,5168,1599,21.73,78.27,24.22
E02000459,Harrow 027,9267,1406,967,1357,1607,1257,1104,781,506,238,44,2373,6894,1569,25.61,74.39,16.93
E02000460,Harrow 028,6858,1111,789,997,1141,918,844,556,305,168,29,1900,4958,1058,27.7,72.3,15.43
E02000461,Harrow 029,7630,945,1013,1380,1170,1163,764,552,348,230,65,1958,5672,1195,25.66,74.34,15.66
E02000462,Harrow 030,6807,888,736,929,1005,1026,927,604,432,215,45,1624,5183,1296,23.86,76.14,19.04
E02000463,Harrow 031,8296,1147,1022,1172,1059,1179,1182,824,463,206,42,2169,6127,1535,26.15,73.85,18.5
E02006795,Harrow 032,8016,1069,802,1057,1236,1168,1014,867,478,291,34,1871,6145,1670,23.34,76.66,20.83
E02006882,Harrow 033,14198,1802,1214,2055,2172,1699,1842,1672,1096,518,128,3016,11182,3414,21.24,78.76,24.05
E02000464,Havering 001,7755,1120,861,1189,1121,943,893,709,525,292,102,1981,5774,1628,25.54,74.46,20.99
E02000465,Havering 002,9463,1610,1015,1290,1666,1277,1145,754,443,207,56,2625,6838,1460,27.74,72.26,15.43
E02000466,Havering 003,8997,1331,926,1384,1240,1018,1158,813,696,354,77,2257,6740,1940,25.09,74.91,21.56
E02000467,Havering 004,11360,1958,1447,1778,1798,1463,1262,853,500,231,70,3405,7955,1654,29.97,70.03,14.56
E02000468,Havering 005,8390,1125,857,1157,1163,1020,1108,815,664,379,102,1982,6408,1960,23.62,76.38,23.36
E02000469,Havering 006,7359,1089,850,1069,1073,935,886,659,481,246,71,1939,5420,1457,26.35,73.65,19.8
E02000470,Havering 007,9373,1131,673,1369,1566,1154,1166,938,819,422,135,1804,7569,2314,19.25,80.75,24.69
E02000471,Havering 008,7598,801,642,913,789,833,1132,1017,895,486,90,1443,6155,2488,18.99,81.01,32.75
E02000472,Havering 009,9337,1260,873,1153,1337,1196,1181,999,855,393,90,2133,7204,2337,22.84,77.16,25.03
E02000473,Havering 010,10288,1361,944,1476,1543,1287,1333,993,806,442,103,2305,7983,2344,22.4,77.6,22.78
E02000474,Havering 011,9262,1377,871,1331,1500,1121,1153,774,628,412,95,2248,7014,1909,24.27,75.73,20.61
E02000475,Havering 012,9890,1148,786,1430,1351,1240,1300,1057,883,525,170,1934,7956,2635,19.56,80.44,26.64
E02000476,Havering 013,10294,1486,732,1962,2088,1309,1007,733,550,335,92,2218,8076,1710,21.55,78.45,16.61
E02000477,Havering 014,9566,1098,874,1311,1280,1271,1287,1068,864,428,85,1972,7594,2445,20.61,79.39,25.56
E02000478,Havering 015,5810,488,493,777,504,657,874,781,744,427,65,981,4829,2017,16.88,83.12,34.72
E02000479,Havering 016,9620,1377,838,1624,1796,1257,1147,781,472,247,81,2215,7405,1581,23.02,76.98,16.43
E02000480,Havering 017,13161,2121,1247,2255,2385,1617,1506,910,604,415,101,3368,9793,2030,25.59,74.41,15.42
E02000481,Havering 018,8120,915,750,1025,959,959,1126,856,786,583,161,1665,6455,2386,20.5,79.5,29.38
E02000482,Havering 019,6514,644,679,676,596,959,903,789,653,456,159,1323,5191,2057,20.31,79.69,31.58
E02000483,Havering 020,7993,905,563,1151,1061,965,1129,900,705,479,135,1468,6525,2219,18.37,81.63,27.76
E02000484,Havering 021,8316,849,722,1297,945,1035,1352,975,713,351,77,1571,6745,2116,18.89,81.11,25.44
E02000485,Havering 022,8642,1067,762,1181,1282,1121,1188,849,676,410,106,1829,6813,2041,21.16,78.84,23.62
E02000486,Havering 023,7501,775,543,1049,963,870,1143,904,708,435,111,1318,6183,2158,17.57,82.43,28.77
E02000487,Havering 024,7759,712,746,876,597,1049,1209,1059,917,479,115,1458,6301,2570,18.79,81.21,33.12
E02000488,Havering 025,7325,812,548,929,887,835,1143,942,798,382,49,1360,5965,2171,18.57,81.43,29.64
E02000489,Havering 026,8711,1256,819,1173,1284,1067,1139,885,649,370,69,2075,6636,1973,23.82,76.18,22.65
E02000490,Havering 027,7985,1077,767,1102,1067,919,1077,738,693,441,104,1844,6141,1976,23.09,76.91,24.75
E02000491,Havering 028,9854,1461,1068,1431,1460,1258,1265,821,675,336,79,2529,7325,1911,25.66,74.34,19.39
E02000492,Havering 029,6493,726,571,897,731,718,969,747,671,407,56,1297,5196,1881,19.98,80.02,28.97
E02000493,Havering 030,6816,1111,703,1031,1059,851,873,554,340,244,50,1814,5002,1188,26.61,73.39,17.43
E02000494,Hillingdon 001,7680,880,638,696,835,1102,1098,1038,801,489,103,1518,6162,2431,19.77,80.23,31.65
E02000495,Hillingdon 002,10426,1423,827,1301,1581,1565,1315,895,874,529,116,2250,8176,2414,21.58,78.42,23.15
E02000496,Hillingdon 003,7696,934,731,904,1026,1001,1074,883,680,378,85,1665,6031,2026,21.63,78.37,26.33
E02000497,Hillingdon 004,9225,1223,857,1030,1328,1297,1305,912,703,455,115,2080,7145,2185,22.55,77.45,23.69
E02000498,Hillingdon 005,6151,765,517,689,784,790,879,780,619,271,57,1282,4869,1727,20.84,79.16,28.08
E02000499,Hillingdon 006,7604,913,648,853,878,1020,1151,856,717,483,85,1561,6043,2141,20.53,79.47,28.16
E02000500,Hillingdon 007,8237,887,676,1091,1011,1045,1197,987,764,443,136,1563,6674,2330,18.98,81.02,28.29
E02000501,Hillingdon 008,8370,1149,724,877,1204,1199,1240,830,685,377,85,1873,6497,1977,22.38,77.62,23.62
E02000502,Hillingdon 009,8776,1421,736,1102,1500,1246,1009,698,560,402,102,2157,6619,1762,24.58,75.42,20.08
E02000503,Hillingdon 010,9059,1230,815,1271,1498,1243,1292,838,526,287,59,2045,7014,1710,22.57,77.43,18.88
E02000504,Hillingdon 011,7449,968,697,753,852,1096,1092,782,718,375,116,1665,5784,1991,22.35,77.65,26.73
E02000506,Hillingdon 013,7822,792,744,940,803,1114,1170,1010,743,425,81,1536,6286,2259,19.64,80.36,28.88
E02000507,Hillingdon 014,8258,1241,924,1155,1213,1158,992,775,473,281,46,2165,6093,1575,26.22,73.78,19.07
E02000508,Hillingdon 015,12147,1409,881,4354,1818,1395,898,654,439,259,40,2290,9857,1392,18.85,81.15,11.46
E02000509,Hillingdon 016,12186,1184,764,5414,1702,1086,818,631,368,179,40,1948,10238,1218,15.99,84.01,10.0
E02000510,Hillingdon 017,9223,1163,935,1563,1243,1267,1145,815,640,380,72,2098,7125,1907,22.75,77.25,20.68
E02000511,Hillingdon 018,9995,1391,1160,1516,1376,1335,1412,784,580,381,60,2551,7444,1805,25.52,74.48,18.06
E02000512,Hillingdon 019,8758,1329,918,1500,1281,1218,1065,648,509,245,45,2247,6511,1447,25.66,74.34,16.52
E02000513,Hillingdon 020,10097,1875,1307,1459,1680,1419,1173,583,371,192,38,3182,6915,1184,31.51,68.49,11.73
E02000514,Hillingdon 021,10817,1696,1251,1425,1842,1640,1319,822,480,280,62,2947,7870,1644,27.24,72.76,15.2
E02000515,Hillingdon 022,12209,1955,958,2441,2233,1538,1357,887,536,261,43,2913,9296,1727,23.86,76.14,14.15
E02000516,Hillingdon 023,9039,1500,950,1210,1550,1430,1102,740,368,180,9,2450,6589,1297,27.1,72.9,14.35
E02000517,Hillingdon 024,10162,1736,1309,1455,1660,1425,1115,815,427,179,41,3045,7117,1462,29.96,70.04,14.39
E02000518,Hillingdon 025,8781,1147,1004,1427,1375,1218,1124,709,508,221,48,2151,6630,1486,24.5,75.5,16.92
E02000519,Hillingdon 026,9305,1360,1091,1438,1421,1284,1158,706,511,280,56,2451,6854,1553,26.34,73.66,16.69
E02000520,Hillingdon 027,14114,2343,1571,2101,2524,2020,1632,987,568,310,58,3914,10200,1923,27.73,72.27,13.62
E02000521,Hillingdon 028,13486,2450,1502,2052,2709,1907,1383,760,440,208,75,3952,9534,1483,29.3,70.7,11.0
E02000522,Hillingdon 029,9756,1623,1002,1458,1740,1345,1049,740,456,261,82,2625,7131,1539,26.91,73.09,15.77
E02000523,Hillingdon 030,11899,1928,1168,1880,2322,1758,1269,827,497,215,35,3096,8803,1574,26.02,73.98,13.23
E02000524,Hillingdon 031,8321,1210,572,1338,1678,1172,1011,666,391,210,73,1782,6539,1340,21.42,78.58,16.1
E02000525,Hillingdon 032,10541,1723,1104,1450,1982,1660,1195,761,426,215,25,2827,7714,1427,26.82,73.18,13.54
E02006796,Hillingdon 033,9281,1380,868,1260,1626,1308,1108,737,593,358,43,2248,7033,1731,24.22,75.78,18.65
E02000526,Hounslow 001,8484,971,776,1205,1329,1356,1208,797,530,253,59,1747,6737,1639,20.59,79.41,19.32
E02000528,Hounslow 003,12460,1816,1032,1914,2359,1875,1462,1061,630,252,59,2848,9612,2002,22.86,77.14,16.07
E02000529,Hounslow 004,8988,1511,899,1277,1501,1195,1013,838,474,241,39,2410,6578,1592,26.81,73.19,17.71
E02000530,Hounslow 005,7381,1374,909,1065,1045,1000,880,587,313,179,29,2283,5098,1108,30.93,69.07,15.01
E02000531,Hounslow 006,10631,1358,821,2073,1809,1540,1204,906,556,307,57,2179,8452,1826,20.5,79.5,17.18
E02000532,Hounslow 007,8964,1093,843,1284,1143,1309,1403,889,667,289,44,1936,7028,1889,21.6,78.4,21.07
E02000533,Hounslow 008,8396,1090,684,1201,1278,1372,1109,808,577,238,39,1774,6622,1662,21.13,78.87,19.8
E02000534,Hounslow 009,7950,1048,696,1212,1441,1202,919,665,495,252,20,1744,6206,1432,21.94,78.06,18.01
E02000535,Hounslow 010,9249,1174,831,1369,1550,1301,1163,956,574,258,73,2005,7244,1861,21.68,78.32,20.12
E02000536,Hounslow 011,9363,1259,899,1462,1569,1352,1075,898,523,276,50,2158,7205,1747,23.05,76.95,18.66
E02000537,Hounslow 012,9146,1105,781,1254,1920,1343,1003,834,575,281,50,1886,7260,1740,20.62,79.38,19.02
E02000538,Hounslow 013,9835,1434,930,1622,1664,1477,1106,855,497,224,26,2364,7471,1602,24.04,75.96,16.29
E02000539,Hounslow 014,10998,1718,1040,1505,2021,1869,1224,813,483,247,78,2758,8240,1621,25.08,74.92,14.74
E02000540,Hounslow 015,11246,1767,948,1490,2292,1703,1277,843,557,303,66,2715,8531,1769,24.14,75.86,15.73
E02000541,Hounslow 016,9735,1370,975,1404,1717,1464,1179,836,488,282,20,2345,7390,1626,24.09,75.91,16.7
E02000542,Hounslow 017,11852,1951,1078,1601,2484,1743,1172,869,567,315,72,3029,8823,1823,25.56,74.44,15.38
E02000543,Hounslow 018,13805,2345,1230,1813,3299,2129,1354,832,509,261,33,3575,10230,1635,25.9,74.1,11.84
E02000544,Hounslow 019,8145,948,752,1214,1252,1108,1093,878,549,297,54,1700,6445,1778,20.87,79.13,21.83
E02000545,Hounslow 020,8746,1371,902,1204,1305,1345,1037,799,498,238,47,2273,6473,1582,25.99,74.01,18.09
E02000546,Hounslow 021,9725,1484,979,1449,1685,1525,1054,886,414,219,30,2463,7262,1549,25.33,74.67,15.93
E02000547,Hounslow 022,9955,1401,980,1467,1529,1398,1312,913,603,296,56,2381,7574,1868,23.92,76.08,18.76
E02000548,Hounslow 023,9905,1642,1012,1598,1611,1239,1198,785,463,288,69,2654,7251,1605,26.79,73.21,16.2
E02000549,Hounslow 024,11486,1629,1094,1753,1710,1573,1580,1019,691,364,73,2723,8763,2147,23.71,76.29,18.69
E02000550,Hounslow 025,10883,1885,1193,1567,1971,1651,1255,711,439,174,37,3078,7805,1361,28.28,71.72,12.51
E02000551,Hounslow 026,9103,1499,1014,1423,1405,1274,1072,739,446,200,31,2513,6590,1416,27.61,72.39,15.56
E02000552,Hounslow 027,9042,1461,886,1622,1508,1368,1029,618,351,167,32,2347,6695,1168,25.96,74.04,12.92
E02000553,Hounslow 028,7109,1135,690,1001,1082,1006,884,620,435,223,33,1825,5284,1311,25.67,74.33,18.44
E02006792,Hounslow 029,8941,978,541,1566,1746,1469,1038,644,563,293,103,1519,7422,1603,16.99,83.01,17.93
E02000554,Islington 001,10035,1290,948,2115,1846,1285,1167,746,425,165,48,2238,7797,1384,22.3,77.7,13.79
E02000555,Islington 002,9901,1199,792,2328,1683,1289,1178,684,478,215,55,1991,7910,1432,20.11,79.89,14.46
E02000556,Islington 003,11373,1194,659,3185,2290,1445,1215,712,463,183,27,1853,9520,1385,16.29,83.71,12.18
E02000557,Islington 004,8860,929,627,1956,1765,1146,1036,658,456,238,49,1556,7304,1401,17.56,82.44,15.81
E02000558,Islington 005,10379,1419,1064,2577,1783,1184,1085,585,424,211,47,2483,7896,1267,23.92,76.08,12.21
E02000559,Islington 006,10616,1336,736,2500,2525,1312,1008,624,397,144,34,2072,8544,1199,19.52,80.48,11.29
E02000560,Islington 007,9225,832,465,3135,1992,1027,803,455,323,156,37,1297,7928,971,14.06,85.94,10.53
E02000561,Islington 008,8643,893,710,2048,1591,1142,949,669,461,150,30,1603,7040,1310,18.55,81.45,15.16
E02000562,Islington 009,8921,1039,758,1731,1938,1184,986,606,407,206,66,1797,7124,1285,20.14,79.86,14.4
E02000563,Islington 010,8675,982,669,2290,1653,1046,918,563,339,179,36,1651,7024,1117,19.03,80.97,12.88
E02000564,Islington 011,14517,1329,772,5034,3557,1529,1113,629,364,153,37,2101,12416,1183,14.47,85.53,8.15
E02000565,Islington 012,9063,1075,830,2242,1908,1044,974,502,284,177,27,1905,7158,990,21.02,78.98,10.92
E02000566,Islington 013,9551,967,725,2078,2214,1189,1056,678,455,160,29,1692,7859,1322,17.72,82.28,13.84
E02000567,Islington 014,11616,1310,752,2538,2886,1433,1258,736,440,218,45,2062,9554,1439,17.75,82.25,12.39
E02000568,Islington 015,13081,1171,911,4895,2412,1244,1051,674,428,249,46,2082,10999,1397,15.92,84.08,10.68
E02000569,Islington 016,11315,1258,847,2360,2478,1479,1160,806,547,318,62,2105,9210,1733,18.6,81.4,15.32
E02000570,Islington 017,9982,1009,587,2206,2432,1220,1136,722,442,205,23,1596,8386,1392,15.99,84.01,13.95
E02000571,Islington 018,9338,966,702,2147,2063,1139,1053,610,419,213,26,1668,7670,1268,17.86,82.14,13.58
E02000572,Islington 019,9219,1046,830,2860,1451,961,802,635,367,223,44,1876,7343,1269,20.35,79.65,13.77
E02000573,Islington 020,10648,944,558,2777,2568,1255,1101,696,512,206,31,1502,9146,1445,14.11,85.89,13.57
E02000574,Islington 021,9776,818,440,3209,1988,1193,1013,566,352,149,48,1258,8518,1115,12.87,87.13,11.41
E02000575,Islington 022,15574,1050,717,6596,2986,1608,1316,701,356,186,58,1767,13807,1301,11.35,88.65,8.35
E02000576,Islington 023,12159,1430,839,3835,2326,1347,1082,641,377,215,67,2269,9890,1300,18.66,81.34,10.69
E02000577,Kensington and Chelsea 001,6636,693,699,1005,985,976,927,645,419,242,45,1392,5244,1351,20.98,79.02,20.36
E02000578,Kensington and Chelsea 002,5728,677,675,706,757,758,876,565,385,245,84,1352,4376,1279,23.6,76.4,22.33
E02000579,Kensington and Chelsea 003,8055,1003,774,954,1344,1190,1155,841,552,213,29,1777,6278,1635,22.06,77.94,20.3
E02000580,Kensington and Chelsea 004,7812,765,586,1067,1513,1141,1159,805,541,197,38,1351,6461,1581,17.29,82.71,20.24
E02000581,Kensington and Chelsea 005,6279,728,631,799,808,860,873,673,590,273,44,1359,4920,1580,21.64,78.36,25.16
E02000582,Kensington and Chelsea 006,7285,754,488,1050,1389,1207,890,610,555,251,91,1242,6043,1507,17.05,82.95,20.69
E02000583,Kensington and Chelsea 007,6932,821,509,893,1104,1067,1012,720,558,208,40,1330,5602,1526,19.19,80.81,22.01
E02000584,Kensington and Chelsea 008,8178,1162,642,964,1232,1356,1052,773,633,283,81,1804,6374,1770,22.06,77.94,21.64
E02000585,Kensington and Chelsea 009,8000,930,647,1016,1169,1397,1050,792,642,265,92,1577,6423,1791,19.71,80.29,22.39
E02000586,Kensington and Chelsea 010,7747,835,582,1481,1230,1273,1002,677,449,167,51,1417,6330,1344,18.29,81.71,17.35
E02000587,Kensington and Chelsea 011,7582,936,627,1002,1181,1212,946,755,587,248,88,1563,6019,1678,20.61,79.39,22.13
E02000588,Kensington and Chelsea 012,7798,739,442,1183,1280,1170,1145,841,653,295,50,1181,6617,1839,15.14,84.86,23.58
E02000589,Kensington and Chelsea 013,8886,791,563,2303,1728,1293,884,624,436,230,34,1354,7532,1324,15.24,84.76,14.9
E02000590,Kensington and Chelsea 014,6917,596,420,1110,1018,914,1038,803,563,356,99,1016,5901,1821,14.69,85.31,26.33
E02000591,Kensington and Chelsea 015,6886,592,481,1384,1316,1045,836,612,445,136,39,1073,5813,1232,15.58,84.42,17.89
E02000592,Kensington and Chelsea 016,6996,875,421,1153,1248,1194,845,535,491,160,74,1296,5700,1260,18.52,81.48,18.01
E02000593,Kensington and Chelsea 017,8210,918,556,1623,1458,1319,989,607,524,184,32,1474,6736,1347,17.95,82.05,16.41
E02000594,Kensington and Chelsea 018,7750,703,497,789,1086,1095,1204,1004,811,436,125,1200,6550,2376,15.48,84.52,30.66
E02000595,Kensington and Chelsea 019,7616,814,547,1183,1065,1204,1029,758,645,305,66,1361,6255,1774,17.87,82.13,23.29
E02000596,Kensington and Chelsea 020,7717,798,618,1352,1353,1139,965,730,484,229,49,1416,6301,1492,18.35,81.65,19.33
E02000597,Kensington and Chelsea 021,7119,787,601,931,1103,1065,988,767,557,263,57,1388,5731,1644,19.5,80.5,23.09
E02000598,Kingston upon Thames 001,8278,1156,1063,710,924,1452,1250,818,553,280,72,2219,6059,1723,26.81,73.19,20.81
E02000599,Kingston upon Thames 002,8512,743,1097,1675,799,1045,1117,851,620,354,211,1840,6672,2036,21.62,78.38,23.92
E02000600,Kingston upon Thames 003,9716,1407,916,1857,1595,1464,968,652,536,254,67,2323,7393,1509,23.91,76.09,15.53
E02000601,Kingston upon Thames 004,13473,2152,1371,2041,2388,2287,1564,843,551,223,53,3523,9950,1670,26.15,73.85,12.4
E02000602,Kingston upon Thames 005,11888,1457,928,3489,2038,1482,1048,737,425,237,47,2385,9503,1446,20.06,79.94,12.16
E02000603,Kingston upon Thames 006,8990,1194,1116,1415,1326,1419,1115,677,459,221,48,2310,6680,1405,25.7,74.3,15.63
E02000604,Kingston upon Thames 007,9346,1327,887,992,1592,1556,1275,840,527,254,96,2214,7132,1717,23.69,76.31,18.37
E02000605,Kingston upon Thames 008,8344,1067,833,837,1153,1374,1186,842,605,336,111,1900,6444,1894,22.77,77.23,22.7
E02000606,Kingston upon Thames 009,11350,1262,593,2621,2501,1642,1052,787,554,263,75,1855,9495,1679,16.34,83.66,14.79
E02000607,Kingston upon Thames 010,8059,862,651,2584,1115,998,731,525,362,189,42,1513,6546,1118,18.77,81.23,13.87
E02000608,Kingston upon Thames 011,7559,832,464,1546,1970,1137,634,443,309,182,42,1296,6263,976,17.15,82.85,12.91
E02000609,Kingston upon Thames 012,7675,851,828,876,899,1106,1158,888,663,331,75,1679,5996,1957,21.88,78.12,25.5
E02000610,Kingston upon Thames 013,8180,933,418,1523,1794,1240,858,594,458,237,125,1351,6829,1414,16.52,83.48,17.29
E02000611,Kingston upon Thames 014,7458,991,785,686,816,1148,1013,897,720,330,72,1776,5682,2019,23.81,76.19,27.07
E02000612,Kingston upon Thames 015,8258,957,725,815,1080,1266,1123,966,847,377,102,1682,6576,2292,20.37,79.63,27.75
E02000613,Kingston upon Thames 016,8398,1345,713,875,1571,1323,1011,641,493,317,109,2058,6340,1560,24.51,75.49,18.58
E02000614,Kingston upon Thames 017,9329,1331,912,1246,1503,1447,1243,849,514,245,39,2243,7086,1647,24.04,75.96,17.65
E02000615,Kingston upon Thames 018,7800,1031,779,806,1213,1110,1138,733,613,322,55,1810,5990,1723,23.21,76.79,22.09
E02000616,Kingston upon Thames 019,6001,837,522,621,957,932,801,640,441,216,34,1359,4642,1331,22.65,77.35,22.18
E02000617,Kingston upon Thames 020,8893,1289,903,1051,1338,1258,1289,815,603,276,71,2192,6701,1765,24.65,75.35,19.85
E02000619,Lambeth 002,9118,918,829,1618,1753,1278,1232,795,456,191,48,1747,7371,1490,19.16,80.84,16.34
E02000620,Lambeth 003,10622,1033,785,2483,2399,1366,1234,687,367,213,55,1818,8804,1322,17.12,82.88,12.45
E02000621,Lambeth 004,12432,941,683,3326,3149,1667,1243,772,441,165,45,1624,10808,1423,13.06,86.94,11.45
E02000622,Lambeth 005,8878,788,628,2257,2110,1084,974,579,280,168,10,1416,7462,1037,15.95,84.05,11.68
E02000623,Lambeth 006,8099,855,705,1512,1622,1073,1117,634,357,183,41,1560,6539,1215,19.26,80.74,15.0
E02000624,Lambeth 007,8940,910,625,2213,2219,1026,975,506,246,162,58,1535,7405,972,17.17,82.83,10.87
E02000625,Lambeth 008,8482,968,853,1884,1794,1071,1005,482,261,133,31,1821,6661,907,21.47,78.53,10.69
E02000626,Lambeth 009,8322,1120,932,1533,1403,1132,1262,547,247,99,47,2052,6270,940,24.66,75.34,11.3
E02000627,Lambeth 010,9917,889,710,2997,2189,1100,970,487,320,232,23,1599,8318,1062,16.12,83.88,10.71
E02000628,Lambeth 011,9688,1020,901,2114,2019,1195,1198,626,380,193,42,1921,7767,1241,19.83,80.17,12.81
E02000629,Lambeth 012,9037,788,494,2796,2152,1031,868,501,269,101,37,1282,7755,908,14.19,85.81,10.05
E02000630,Lambeth 013,8036,753,457,2121,2015,1015,787,451,276,113,48,1210,6826,888,15.06,84.94,11.05
E02000631,Lambeth 014,9452,1095,787,1773,2136,1294,1156,614,379,174,44,1882,7570,1211,19.91,80.09,12.81
E02000632,Lambeth 015,9215,582,377,3470,2534,852,644,379,202,151,24,959,8256,756,10.41,89.59,8.2
E02000633,Lambeth 016,9087,930,729,2168,2229,1004,1013,592,267,126,29,1659,7428,1014,18.26,81.74,11.16
E02000634,Lambeth 017,6770,664,431,1930,1413,716,727,459,240,159,31,1095,5675,889,16.17,83.83,13.13
E02000635,Lambeth 018,9291,1002,683,2082,2322,1193,1030,549,285,125,20,1685,7606,979,18.14,81.86,10.54
E02000636,Lambeth 019,8145,1011,464,1961,1962,1065,788,451,308,116,19,1475,6670,894,18.11,81.89,10.98
E02000637,Lambeth 020,9087,822,512,2268,2554,1067,941,452,281,166,24,1334,7753,923,14.68,85.32,10.16
E02000638,Lambeth 021,10830,1142,749,2648,2676,1370,1129,561,314,185,56,1891,8939,1116,17.46,82.54,10.3
E02000639,Lambeth 022,8097,937,680,1642,1753,1116,1061,550,251,90,17,1617,6480,908,19.97,80.03,11.21
E02000640,Lambeth 023,9876,1355,626,2314,2279,1257,896,533,369,200,47,1981,7895,1149,20.06,79.94,11.63
E02000641,Lambeth 024,8686,1195,1036,1517,1710,1113,1047,603,255,162,48,2231,6455,1068,25.69,74.31,12.3
E02000642,Lambeth 025,9744,1369,955,1450,2044,1340,1191,692,436,205,62,2324,7420,1395,23.85,76.15,14.32
E02000643,Lambeth 026,9634,1147,728,1765,2556,1386,938,569,319,200,26,1875,7759,1114,19.46,80.54,11.56
E02000644,Lambeth 027,8976,1249,819,1370,2198,1264,1024,584,275,158,35,2068,6908,1052,23.04,76.96,11.72
E02000645,Lambeth 028,9842,1467,900,1425,2218,1507,1180,593,319,182,51,2367,7475,1145,24.05,75.95,11.63
E02000646,Lambeth 029,10368,1127,680,1913,2773,1473,1068,653,418,212,51,1807,8561,1334,17.43,82.57,12.87
E02000647,Lambeth 030,9283,1304,817,1194,1825,1388,1188,737,465,307,58,2121,7162,1567,22.85,77.15,16.88
E02000648,Lambeth 031,8348,1443,1023,1009,1525,1235,999,532,346,184,52,2466,5882,1114,29.54,70.46,13.34
E02000649,Lambeth 032,13586,1758,956,2517,3644,1933,1398,742,390,207,41,2714,10872,1380,19.98,80.02,10.16
E02000650,Lambeth 033,7798,1188,780,898,1665,1249,1036,547,267,123,45,1968,5830,982,25.24,74.76,12.59
E02000651,Lambeth 034,9156,1194,708,1344,2093,1234,1117,753,416,245,52,1902,7254,1466,20.77,79.23,16.01
E02000652,Lambeth 035,7860,1072,812,1061,1572,1062,962,658,377,210,74,1884,5976,1319,23.97,76.03,16.78
E02006801,Lambeth 036,11332,615,580,4924,1951,1011,924,712,380,191,44,1195,10137,1327,10.55,89.45,11.71
E02000653,Lewisham 001,11768,1357,911,3008,2972,1476,1101,506,286,143,8,2268,9500,943,19.27,80.73,8.01
E02000654,Lewisham 002,8810,1192,975,1777,1707,1158,1047,539,246,149,20,2167,6643,954,24.6,75.4,10.83
E02000655,Lewisham 003,9315,1148,799,2259,1918,1383,925,466,251,137,29,1947,7368,883,20.9,79.1,9.48
E02000657,Lewisham 005,9989,1068,668,2899,2129,1311,893,556,313,119,33,1736,8253,1021,17.38,82.62,10.22
E02000658,Lewisham 006,8792,977,625,2112,1705,1242,964,670,317,152,28,1602,7190,1167,18.22,81.78,13.27
E02000659,Lewisham 007,8297,1109,686,1415,1813,1143,1002,583,338,163,45,1795,6502,1129,21.63,78.37,13.61
E02000660,Lewisham 008,8637,1025,455,1911,2318,1244,834,444,235,128,43,1480,7157,850,17.14,82.86,9.84
E02000661,Lewisham 009,6886,812,456,1016,1440,1182,811,485,405,219,60,1268,5618,1169,18.41,81.59,16.98
E02000662,Lewisham 010,8712,1231,721,1516,2051,1230,1039,536,248,103,37,1952,6760,924,22.41,77.59,10.61
E02000663,Lewisham 011,7437,808,524,1549,1448,1170,914,538,331,119,36,1332,6105,1024,17.91,82.09,13.77
E02000664,Lewisham 012,14681,1842,913,3582,3625,1954,1275,783,406,241,60,2755,11926,1490,18.77,81.23,10.15
E02000665,Lewisham 013,8754,1200,698,1369,1754,1468,1039,591,389,198,48,1898,6856,1226,21.68,78.32,14.01
E02000666,Lewisham 014,7390,1005,533,1394,1346,1133,932,479,318,192,58,1538,5852,1047,20.81,79.19,14.17
E02000667,Lewisham 015,6934,1145,477,944,1414,1165,855,491,275,150,18,1622,5312,934,23.39,76.61,13.47
E02000668,Lewisham 016,7578,1115,671,847,1461,1286,942,629,385,205,37,1786,5792,1256,23.57,76.43,16.57
E02000669,Lewisham 017,8335,1125,651,1209,1981,1325,1074,477,307,166,20,1776,6559,970,21.31,78.69,11.64
E02000670,Lewisham 018,6646,960,689,892,1389,928,904,474,220,163,27,1649,4997,884,24.81,75.19,13.3
E02000671,Lewisham 019,8766,1278,605,1205,2026,1465,1010,627,351,166,33,1883,6883,1177,21.48,78.52,13.43
E02000672,Lewisham 020,10277,1766,745,1648,2031,1634,1273,603,297,239,41,2511,7766,1180,24.43,75.57,11.48
E02000673,Lewisham 021,8792,1409,723,1156,1941,1378,1001,622,373,157,32,2132,6660,1184,24.25,75.75,13.47
E02000674,Lewisham 022,8597,1189,850,1106,1433,1354,1261,738,376,252,38,2039,6558,1404,23.72,76.28,16.33
E02000675,Lewisham 023,8882,1185,804,1160,1597,1354,1168,810,502,237,65,1989,6893,1614,22.39,77.61,18.17
E02000676,Lewisham 024,8263,1211,647,1078,1787,1426,967,588,341,192,26,1858,6405,1147,22.49,77.51,13.88
E02000677,Lewisham 025,7570,1078,663,1129,1070,1176,1131,659,363,234,67,1741,5829,1323,23.0,77.0,17.48
E02000678,Lewisham 026,6879,1016,892,929,1120,979,985,467,281,159,51,1908,4971,958,27.74,72.26,13.93
E02000679,Lewisham 027,8400,1259,733,1155,1733,1288,1052,581,381,156,62,1992,6408,1180,23.71,76.29,14.05
E02000680,Lewisham 028,7629,1104,739,1158,1510,1251,877,502,291,167,30,1843,5786,990,24.16,75.84,12.98
E02000681,Lewisham 029,8747,1265,986,1042,1347,1326,1283,754,453,236,55,2251,6496,1498,25.73,74.27,17.13
E02000682,Lewisham 030,9079,1298,1206,1289,1314,1314,1210,728,412,247,61,2504,6575,1448,27.58,72.42,15.95
E02000683,Lewisham 031,6544,997,628,870,1115,939,841,560,348,203,43,1625,4919,1154,24.83,75.17,17.63
E02000685,Lewisham 033,8500,1190,866,1074,1583,1310,1124,639,430,224,60,2056,6444,1353,24.19,75.81,15.92
E02000686,Lewisham 034,7495,1311,844,954,1264,1140,1014,504,318,121,25,2155,5340,968,28.75,71.25,12.92
E02000687,Lewisham 035,8399,1154,623,1256,1600,1329,1047,678,392,281,39,1777,6622,1390,21.16,78.84,16.55
E02006783,Lewisham 037,7664,1166,986,950,1273,1188,1030,523,294,211,43,2152,5512,1071,28.08,71.92,13.97
E02006784,Lewisham 038,8084,1070,889,1037,1297,1147,1082,739,478,272,73,1959,6125,1562,24.23,75.77,19.32
E02006798,Lewisham 039,8314,909,706,1859,1809,1162,935,584,265,66,19,1615,6699,934,19.43,80.57,11.23
E02000689,Merton 001,8415,1502,712,1175,1610,1340,931,630,342,143,30,2214,6201,1145,26.31,73.69,13.61
E02000690,Merton 002,5570,564,584,491,468,805,891,705,603,343,116,1148,4422,1767,20.61,79.39,31.72
E02000691,Merton 003,7447,993,599,1206,1550,1149,868,522,333,169,58,1592,5855,1082,21.38,78.62,14.53
E02000692,Merton 004,7918,868,613,1089,1435,1213,939,728,588,326,119,1481,6437,1761,18.7,81.3,22.24
E02000693,Merton 005,9531,1142,407,1949,2653,1378,851,552,355,198,46,1549,7982,1151,16.25,83.75,12.08
E02000694,Merton 006,9110,1390,597,1449,2140,1523,863,587,385,156,20,1987,7123,1148,21.81,78.19,12.6
E02000695,Merton 007,8482,1098,657,1275,1574,1306,1057,708,482,285,40,1755,6727,1515,20.69,79.31,17.86
E02000696,Merton 008,8023,1013,634,1414,1757,1262,980,535,270,147,11,1647,6376,963,20.53,79.47,12.0
E02000697,Merton 009,9023,1221,548,1761,2152,1455,889,486,333,156,22,1769,7254,997,19.61,80.39,11.05
E02000698,Merton 010,8016,1138,873,681,986,1418,1100,767,658,307,88,2011,6005,1820,25.09,74.91,22.7
E02000699,Merton 011,8284,1358,691,999,1639,1437,899,567,416,229,49,2049,6235,1261,24.73,75.27,15.22
E02000700,Merton 012,8396,1213,776,1271,1678,1237,1013,694,366,130,18,1989,6407,1208,23.69,76.31,14.39
E02000701,Merton 013,8431,1187,863,1182,1466,1263,1116,660,423,229,42,2050,6381,1354,24.32,75.68,16.06
E02000702,Merton 014,8736,1468,942,1184,1575,1192,1082,718,352,183,40,2410,6326,1293,27.59,72.41,14.8
E02000703,Merton 015,7947,1026,775,998,1076,1241,984,807,624,365,51,1801,6146,1847,22.66,77.34,23.24
E02000704,Merton 016,8326,1146,545,1205,1799,1343,909,615,423,259,82,1691,6635,1379,20.31,79.69,16.56
E02000705,Merton 017,8525,1176,830,1187,1354,1187,1187,808,480,266,50,2006,6519,1604,23.53,76.47,18.82
E02000706,Merton 018,9373,1661,1022,1262,1702,1349,1127,684,355,172,39,2683,6690,1250,28.62,71.38,13.34
E02000707,Merton 019,7456,1017,955,1042,979,1007,1219,692,351,165,29,1972,5484,1237,26.45,73.55,16.59
E02000708,Merton 020,8347,1215,762,933,1303,1320,1125,799,557,286,47,1977,6370,1689,23.69,76.31,20.23
E02000709,Merton 021,7646,1005,680,834,997,1132,1115,840,640,325,78,1685,5961,1883,22.04,77.96,24.63
E02000710,Merton 022,8575,1208,804,1126,1321,1219,1073,767,567,407,83,2012,6563,1824,23.46,76.54,21.27
E02000711,Merton 023,8857,1297,810,1249,1679,1382,1139,628,400,226,47,2107,6750,1301,23.79,76.21,14.69
E02000712,Merton 024,8770,1220,935,1213,1257,1278,1280,716,492,325,54,2155,6615,1587,24.57,75.43,18.1
E02000713,Merton 025,7344,957,712,859,1002,1009,1119,742,579,307,58,1669,5675,1686,22.73,77.27,22.96
E02000714,Newham 001,8080,1163,773,1495,1691,1116,926,501,246,141,28,1936,6144,916,23.96,76.04,11.34
E02000715,Newham 002,7669,1384,950,1125,1372,1048,792,514,273,181,30,2334,5335,998,30.43,69.57,13.01
E02000716,Newham 003,7729,1215,815,1148,1668,1104,757,554,268,157,43,2030,5699,1022,26.26,73.74,13.22
E02000717,Newham 004,8422,1452,957,1360,1733,1140,812,542,267,132,27,2409,6013,968,28.6,71.4,11.49
E02000718,Newham 005,7439,1425,1064,1079,1262,1045,751,442,243,113,15,2489,4950,813,33.46,66.54,10.93
E02000719,Newham 006,8629,1171,628,1783,1891,1154,902,538,376,167,19,1799,6830,1100,20.85,79.15,12.75
E02000720,Newham 007,7776,1297,695,1215,1582,991,845,627,341,152,31,1992,5784,1151,25.62,74.38,14.8
E02000721,Newham 008,9691,1698,984,1800,1943,1244,923,562,320,207,10,2682,7009,1099,27.68,72.32,11.34
E02000722,Newham 009,8470,1076,588,1929,1951,1171,812,520,249,145,29,1664,6806,943,19.65,80.35,11.13
E02000723,Newham 010,11288,1775,1011,1931,2343,1427,1237,876,423,218,47,2786,8502,1564,24.68,75.32,13.86
E02000724,Newham 011,9984,1665,1153,1611,2028,1319,921,692,357,202,36,2818,7166,1287,28.23,71.77,12.89
E02000725,Newham 012,10153,1153,589,2691,2687,1066,947,583,289,115,33,1742,8411,1020,17.16,82.84,10.05
E02000726,Newham 013,26513,2495,1339,11406,6773,2135,1282,653,281,123,26,3834,22679,1083,14.46,85.54,4.08
E02000727,Newham 014,8662,1438,915,1255,1994,1178,896,560,264,130,32,2353,6309,986,27.16,72.84,11.38
E02000728,Newham 015,8196,1354,847,1189,1762,1138,862,587,311,126,20,2201,5995,1044,26.85,73.15,12.74
E02000729,Newham 016,7318,1156,631,1260,1543,978,773,556,263,132,26,1787,5531,977,24.42,75.58,13.35
E02000730,Newham 017,9082,1379,856,1335,2061,1239,828,726,405,217,36,2235,6847,1384,24.61,75.39,15.24
E02000731,Newham 018,10982,1812,1066,1859,2408,1493,1065,695,386,172,26,2878,8104,1279,26.21,73.79,11.65
E02000732,Newham 019,7955,1337,922,1291,1444,1058,888,550,282,156,27,2259,5696,1015,28.4,71.6,12.76
E02000733,Newham 020,10137,1237,916,2062,2120,1261,1187,739,401,190,24,2153,7984,1354,21.24,78.76,13.36
E02000734,Newham 021,7655,1096,692,1439,1543,995,947,509,258,161,15,1788,5867,943,23.36,76.64,12.32
E02000735,Newham 022,8677,1312,817,1524,1751,1124,898,559,365,216,111,2129,6548,1251,24.54,75.46,14.42
E02000736,Newham 023,9056,1603,1175,1357,1513,1331,1071,544,268,153,41,2778,6278,1006,30.68,69.32,11.11
E02000737,Newham 024,10139,1643,1262,1571,1731,1468,1186,636,428,176,38,2905,7234,1278,28.65,71.35,12.6
E02000738,Newham 025,9218,1591,1054,1390,1832,1301,978,574,293,181,24,2645,6573,1072,28.69,71.31,11.63
E02000739,Newham 026,7593,1081,790,1405,1493,1060,808,547,280,113,16,1871,5722,956,24.64,75.36,12.59
E02000740,Newham 027,7135,965,676,1392,1434,996,810,514,231,106,11,1641,5494,862,23.0,77.0,12.08
E02000741,Newham 028,8783,1383,925,1432,1677,1301,982,645,285,122,31,2308,6475,1083,26.28,73.72,12.33
E02000742,Newham 029,8785,1571,1120,1450,1471,1233,938,528,253,171,50,2691,6094,1002,30.63,69.37,11.41
E02000743,Newham 030,10180,1403,1038,1979,2028,1347,1108,708,352,179,38,2441,7739,1277,23.98,76.02,12.54
E02000744,Newham 031,9507,1564,955,1692,1896,1311,1050,516,301,202,20,2519,6988,1039,26.5,73.5,10.93
E02000745,Newham 032,8231,1245,834,1430,1490,1131,1082,625,260,87,47,2079,6152,1019,25.26,74.74,12.38
E02000746,Newham 033,8449,1163,734,1830,1831,1130,869,554,195,132,11,1897,6552,892,22.45,77.55,10.56
E02000747,Newham 034,14092,1635,910,3937,3872,1319,1122,659,420,163,55,2545,11547,1297,18.06,81.94,9.2
E02000748,Newham 035,6475,1054,670,995,1309,980,717,469,201,73,7,1724,4751,750,26.63,73.37,11.58
E02000749,Newham 036,8570,1344,917,1519,1570,1113,1060,577,329,115,26,2261,6309,1047,26.38,73.62,12.22
E02000750,Newham 037,16414,2377,1088,4396,4231,2028,1281,589,276,126,22,3465,12949,1013,21.11,78.89,6.17
E02000751,Redbridge 001,10616,1098,920,1310,1175,1481,1522,1240,1095,601,174,2018,8598,3110,19.01,80.99,29.3
E02000752,Redbridge 002,7832,1147,812,1128,1256,1090,1054,641,453,197,54,1959,5873,1345,25.01,74.99,17.17
E02000753,Redbridge 003,6589,885,660,995,1021,948,863,530,347,256,84,1545,5044,1217,23.45,76.55,18.47
E02000754,Redbridge 004,6645,857,623,930,1052,1004,908,628,423,185,35,1480,5165,1271,22.27,77.73,19.13
E02000755,Redbridge 005,5593,740,496,807,866,780,758,507,421,197,21,1236,4357,1146,22.1,77.9,20.49
E02000756,Redbridge 006,13860,1802,1338,2188,2194,1927,1801,1215,880,427,88,3140,10720,2610,22.66,77.34,18.83
E02000757,Redbridge 007,12738,1632,940,1876,2434,1997,1521,1075,730,436,97,2572,10166,2338,20.19,79.81,18.35
E02000758,Redbridge 008,6325,796,691,959,725,864,905,630,432,265,58,1487,4838,1385,23.51,76.49,21.9
E02000759,Redbridge 009,13317,1919,1372,1863,2212,2097,1714,1100,651,326,63,3291,10026,2140,24.71,75.29,16.07
E02000760,Redbridge 010,7223,986,785,1071,1087,1023,852,602,462,266,89,1771,5452,1419,24.52,75.48,19.65
E02000762,Redbridge 012,6656,773,626,1125,904,901,843,700,442,262,80,1399,5257,1484,21.02,78.98,22.3
E02000763,Redbridge 013,7629,1042,797,1262,1210,1022,945,665,405,213,68,1839,5790,1351,24.11,75.89,17.71
E02000764,Redbridge 014,12421,1362,838,1828,2222,1793,1548,1181,912,543,194,2200,10221,2830,17.71,82.29,22.78
E02000765,Redbridge 015,7024,1005,698,1057,1267,900,789,619,360,260,69,1703,5321,1308,24.25,75.75,18.62
E02000767,Redbridge 017,8425,1312,833,1235,1461,1225,891,683,478,246,61,2145,6280,1468,25.46,74.54,17.42
E02000768,Redbridge 018,5823,720,563,729,759,861,855,605,451,222,58,1283,4540,1336,22.03,77.97,22.94
E02000769,Redbridge 019,15815,2568,1915,2580,2413,2296,1835,1093,583,424,108,4483,11332,2208,28.35,71.65,13.96
E02000770,Redbridge 020,8119,1134,987,1423,1134,1181,945,653,388,227,47,2121,5998,1315,26.12,73.88,16.2
E02000772,Redbridge 022,9054,1456,1134,1460,1578,1359,911,639,283,176,58,2590,6464,1156,28.61,71.39,12.77
E02000773,Redbridge 023,10100,1540,1270,1765,1686,1412,1089,718,396,181,43,2810,7290,1338,27.82,72.18,13.25
E02000774,Redbridge 024,7559,1122,848,1254,1361,1009,754,631,364,183,33,1970,5589,1211,26.06,73.94,16.02
E02000776,Redbridge 026,6989,1242,769,985,1222,975,754,590,295,132,25,2011,4978,1042,28.77,71.23,14.91
E02000777,Redbridge 027,6024,789,501,740,863,897,845,716,424,196,53,1290,4734,1389,21.41,78.59,23.06
E02000779,Redbridge 029,9053,1645,930,1389,1875,1267,850,593,306,164,34,2575,6478,1097,28.44,71.56,12.12
E02000780,Redbridge 030,17806,3353,2047,2857,3554,2429,1547,1032,618,296,73,5400,12406,2019,30.33,69.67,11.34
E02000781,Redbridge 031,15140,2249,1771,2480,2369,2066,1655,1247,806,382,115,4020,11120,2550,26.55,73.45,16.84
E02000782,Redbridge 032,10744,1989,1180,1761,2230,1427,938,620,341,191,67,3169,7575,1219,29.5,70.5,11.35
E02000783,Redbridge 033,7813,1355,1133,1284,1305,1093,793,430,262,134,24,2488,5325,850,31.84,68.16,10.88
E02006800,Redbridge 034,14488,2369,1546,2490,2571,1888,1631,1144,567,220,62,3915,10573,1993,27.02,72.98,13.76
E02006924,Redbridge 035,13767,1693,1394,2449,2228,1887,1485,1250,805,445,131,3087,10680,2631,22.42,77.58,19.11
E02006925,Redbridge 036,14035,1518,1732,2342,1707,1904,1842,1442,960,504,84,3250,10785,2990,23.16,76.84,21.3
E02000784,Richmond upon Thames 001,10121,1148,1118,1124,1129,1579,1583,1094,858,377,111,2266,7855,2440,22.39,77.61,24.11
E02000785,Richmond upon Thames 002,10070,1257,866,1013,1521,1637,1470,981,826,391,108,2123,7947,2306,21.08,78.92,22.9
E02000786,Richmond upon Thames 003,11605,1864,926,1121,1930,1992,1529,1049,792,314,88,2790,8815,2243,24.04,75.96,19.33
E02000787,Richmond upon Thames 004,12251,1777,1152,1297,2225,2131,1578,969,730,318,74,2929,9322,2091,23.91,76.09,17.07
E02000788,Richmond upon Thames 005,9104,1491,841,771,1352,1657,1183,853,602,272,82,2332,6772,1809,25.62,74.38,19.87
E02000789,Richmond upon Thames 006,6624,856,534,643,1136,1133,942,576,500,225,79,1390,5234,1380,20.98,79.02,20.83
E02000790,Richmond upon Thames 007,6673,973,719,638,1076,1320,910,501,355,153,28,1692,4981,1037,25.36,74.64,15.54
E02000791,Richmond upon Thames 008,7333,859,475,1009,1300,1290,950,634,514,234,68,1334,5999,1450,18.19,81.81,19.77
E02000792,Richmond upon Thames 009,7350,863,736,694,984,1376,1095,677,560,266,99,1599,5751,1602,21.76,78.24,21.8
E02000793,Richmond upon Thames 010,8339,1106,790,1007,1239,1311,1047,850,619,270,100,1896,6443,1839,22.74,77.26,22.05
E02000794,Richmond upon Thames 011,7056,1008,665,773,1060,1323,927,589,426,229,56,1673,5383,1300,23.71,76.29,18.42
E02000795,Richmond upon Thames 012,7185,959,1022,624,617,1193,1027,692,652,294,105,1981,5204,1743,27.57,72.43,24.26
E02000796,Richmond upon Thames 013,10791,1519,1190,1265,1471,1599,1451,1032,779,402,83,2709,8082,2296,25.1,74.9,21.28
E02000797,Richmond upon Thames 014,7997,1129,660,1010,1566,1389,944,647,429,192,31,1789,6208,1299,22.37,77.63,16.24
E02000798,Richmond upon Thames 015,11088,1571,1279,1114,1473,2054,1577,944,663,329,84,2850,8238,2020,25.7,74.3,18.22
E02000799,Richmond upon Thames 016,6229,626,736,804,732,985,995,665,460,183,43,1362,4867,1351,21.87,78.13,21.69
E02000800,Richmond upon Thames 017,5489,753,645,510,641,900,844,552,392,194,58,1398,4091,1196,25.47,74.53,21.79
E02000801,Richmond upon Thames 018,7229,1050,693,739,977,1345,1036,663,495,196,35,1743,5486,1389,24.11,75.89,19.21
E02000802,Richmond upon Thames 019,6933,853,655,688,839,1217,1062,705,555,261,98,1508,5425,1619,21.75,78.25,23.35
E02000803,Richmond upon Thames 020,9470,1286,908,960,1210,1412,1349,1103,742,399,101,2194,7276,2345,23.17,76.83,24.76
E02000804,Richmond upon Thames 021,7335,887,624,876,1039,1192,1074,736,557,283,67,1511,5824,1643,20.6,79.4,22.4
E02000805,Richmond upon Thames 022,11431,1328,1223,1561,1361,1901,1657,1110,788,381,121,2551,8880,2400,22.32,77.68,21.0
E02000806,Richmond upon Thames 023,10316,1340,905,950,1226,1668,1516,1285,868,432,126,2245,8071,2711,21.76,78.24,26.28
E02000807,Southwark 001,9509,962,372,2076,2795,1302,901,650,324,109,18,1334,8175,1101,14.03,85.97,11.58
E02000808,Southwark 002,11454,689,506,4258,2577,1237,1093,630,285,138,41,1195,10259,1094,10.43,89.57,9.55
E02000809,Southwark 003,14314,1194,567,3715,4087,2189,1442,751,272,81,16,1761,12553,1120,12.3,87.7,7.82
E02000810,Southwark 004,13511,1668,1142,2701,3444,1849,1382,728,380,163,54,2810,10701,1325,20.8,79.2,9.81
E02000812,Southwark 006,10816,1110,811,2990,2104,1325,1188,643,382,190,73,1921,8895,1288,17.76,82.24,11.91
E02000813,Southwark 007,10865,1350,852,2440,2576,1322,1135,641,350,162,37,2202,8663,1190,20.27,79.73,10.95
E02000814,Southwark 008,10356,1216,479,2490,2871,1192,957,657,334,128,32,1695,8661,1151,16.37,83.63,11.11
E02000815,Southwark 009,7249,584,461,3186,1385,637,493,247,104,94,58,1045,6204,503,14.42,85.58,6.94
E02000816,Southwark 010,10593,1363,888,2089,2427,1433,1120,676,376,184,37,2251,8342,1273,21.25,78.75,12.02
E02000817,Southwark 011,7287,991,643,1355,1384,853,872,577,322,229,61,1634,5653,1189,22.42,77.58,16.32
E02000818,Southwark 012,8510,850,621,2228,1674,996,958,611,383,145,44,1471,7039,1183,17.29,82.71,13.9
E02000819,Southwark 013,8828,1060,827,1994,1462,1137,1267,598,302,151,30,1887,6941,1081,21.38,78.62,12.25
E02000820,Southwark 014,10515,1089,750,2651,2308,1401,1137,588,369,174,48,1839,8676,1179,17.49,82.51,11.21
E02000821,Southwark 015,7938,1272,992,1392,1211,1087,992,516,295,131,50,2264,5674,992,28.52,71.48,12.5
E02000822,Southwark 016,7219,1109,697,1250,1368,1032,917,479,221,123,23,1806,5413,846,25.02,74.98,11.72
E02000823,Southwark 017,8947,987,762,1776,1795,1130,1211,693,394,181,18,1749,7198,1286,19.55,80.45,14.37
E02000824,Southwark 018,9797,1430,1144,1787,1533,1263,1289,740,381,191,39,2574,7223,1351,26.27,73.73,13.79
E02000825,Southwark 019,9519,1526,1037,1594,1680,1311,1241,610,353,132,35,2563,6956,1130,26.93,73.07,11.87
E02000826,Southwark 020,9296,1191,833,1685,1894,1283,1159,679,356,185,31,2024,7272,1251,21.77,78.23,13.46
E02000827,Southwark 021,11125,1453,1088,1886,2197,1560,1493,815,415,163,55,2541,8584,1448,22.84,77.16,13.02
E02000828,Southwark 022,8608,1108,840,1625,1578,1182,1163,640,295,153,24,1948,6660,1112,22.63,77.37,12.92
E02000829,Southwark 023,11581,1353,824,2323,2583,1542,1466,791,436,213,50,2177,9404,1490,18.8,81.2,12.87
E02000830,Southwark 024,9271,1032,558,1995,2058,1199,1179,658,363,188,41,1590,7681,1250,17.15,82.85,13.48
E02000831,Southwark 025,9963,1306,669,1716,2469,1406,1115,664,406,173,39,1975,7988,1282,19.82,80.18,12.87
E02000832,Southwark 026,10755,1513,897,1761,2138,1422,1351,859,486,273,55,2410,8345,1673,22.41,77.59,15.56
E02000833,Southwark 027,8698,1265,761,1988,1656,1098,979,481,257,180,33,2026,6672,951,23.29,76.71,10.93
E02000834,Southwark 028,9868,1351,607,1551,2548,1453,1012,661,428,198,59,1958,7910,1346,19.84,80.16,13.64
E02000835,Southwark 029,7803,1262,720,954,1584,1228,992,587,280,166,30,1982,5821,1063,25.4,74.6,13.62
E02000836,Southwark 030,8559,1366,694,1068,1849,1311,1106,604,357,170,34,2060,6499,1165,24.07,75.93,13.61
E02000837,Southwark 031,9418,1431,1169,1013,1209,1559,1295,850,526,276,90,2600,6818,1742,27.61,72.39,18.5
E02000838,Southwark 032,9816,1593,817,1190,2071,1564,1145,758,421,192,65,2410,7406,1436,24.55,75.45,14.63
E02000839,Southwark 033,8501,1364,830,912,1394,1398,1135,701,499,210,58,2194,6307,1468,25.81,74.19,17.27
E02006802,Southwark 034,8341,826,580,2350,1531,1092,1036,527,247,126,26,1406,6935,926,16.86,83.14,11.1
E02000840,Sutton 001,8692,1425,1041,1183,1421,1270,1142,600,369,205,36,2466,6226,1210,28.37,71.63,13.92
E02000841,Sutton 002,9250,1276,1149,1269,1462,1413,1267,732,383,256,43,2425,6825,1414,26.22,73.78,15.29
E02000842,Sutton 003,7962,939,781,1022,1094,1153,1204,835,605,277,52,1720,6242,1769,21.6,78.4,22.22
E02000843,Sutton 004,8648,1369,722,1113,1870,1292,1051,620,389,193,29,2091,6557,1231,24.18,75.82,14.23
E02000844,Sutton 005,8470,1220,975,1114,1367,1272,1139,660,456,229,38,2195,6275,1383,25.91,74.09,16.33
E02000845,Sutton 006,9994,1586,960,1207,1685,1769,1212,759,514,258,44,2546,7448,1575,25.48,74.52,15.76
E02000846,Sutton 007,7614,970,835,813,1010,1185,1087,730,580,311,93,1805,5809,1714,23.71,76.29,22.51
E02000847,Sutton 008,9524,1191,793,1051,1337,1344,1275,1012,918,478,125,1984,7540,2533,20.83,79.17,26.6
E02000848,Sutton 009,8068,1016,940,1025,988,1269,1221,702,555,280,72,1956,6112,1609,24.24,75.76,19.94
E02000849,Sutton 010,8056,1040,774,957,1254,1227,1149,748,590,266,51,1814,6242,1655,22.52,77.48,20.54
E02000850,Sutton 011,10870,1367,1189,1263,1473,1705,1645,1065,730,347,86,2556,8314,2228,23.51,76.49,20.5
E02000851,Sutton 012,10345,1530,853,1481,2154,1586,1131,656,539,343,72,2383,7962,1610,23.04,76.96,15.56
E02000852,Sutton 013,8046,1111,776,956,1316,1332,1064,689,478,263,61,1887,6159,1491,23.45,76.55,18.53
E02000853,Sutton 014,8102,1222,792,947,1292,1328,1067,646,493,265,50,2014,6088,1454,24.86,75.14,17.95
E02000854,Sutton 015,7638,1046,641,835,1229,1213,1073,735,546,264,56,1687,5951,1601,22.09,77.91,20.96
E02000855,Sutton 016,8088,929,793,890,867,1252,1241,894,727,392,103,1722,6366,2116,21.29,78.71,26.16
E02000856,Sutton 017,9293,1294,836,1165,1433,1432,1250,837,688,299,59,2130,7163,1883,22.92,77.08,20.26
E02000857,Sutton 018,8781,1237,623,978,1821,1465,921,674,507,397,158,1860,6921,1736,21.18,78.82,19.77
E02000858,Sutton 019,8391,1277,1051,1238,1216,1191,1079,672,448,181,38,2328,6063,1339,27.74,72.26,15.96
E02000859,Sutton 020,8699,1162,842,929,1160,1239,1126,867,737,481,156,2004,6695,2241,23.04,76.96,25.76
E02000860,Sutton 021,8578,1248,606,1196,1692,1378,948,678,476,279,77,1854,6724,1510,21.61,78.39,17.6
E02000861,Sutton 022,7848,872,803,838,743,1120,1247,977,847,332,69,1675,6173,2225,21.34,78.66,28.35
E02000863,Sutton 024,6852,779,770,760,730,1019,1054,823,577,290,50,1549,5303,1740,22.61,77.39,25.39
E02006836,Sutton 025,8540,993,819,885,931,1230,1209,938,903,489,143,1812,6728,2473,21.22,78.78,28.96
E02000864,Tower Hamlets 001,10794,1656,956,1868,2480,1407,1090,716,359,224,38,2612,8182,1337,24.2,75.8,12.39
E02000865,Tower Hamlets 002,8384,1136,858,1890,1723,1100,737,490,283,125,42,1994,6390,940,23.78,76.22,11.21
E02000866,Tower Hamlets 003,10928,1390,917,2059,2586,1401,1116,832,435,180,12,2307,8621,1459,21.11,78.89,13.35
E02000867,Tower Hamlets 004,12800,1418,946,3186,3672,1615,935,598,284,115,31,2364,10436,1028,18.47,81.53,8.03
E02000868,Tower Hamlets 005,7468,781,682,1897,1903,962,563,356,178,99,47,1463,6005,680,19.59,80.41,9.11
E02000869,Tower Hamlets 006,6666,770,574,1363,1447,913,729,455,277,112,26,1344,5322,870,20.16,79.84,13.05
E02000870,Tower Hamlets 007,6940,936,652,1572,1429,891,652,427,226,115,40,1588,5352,808,22.88,77.12,11.64
E02000871,Tower Hamlets 008,11625,1888,1275,2372,2611,1495,949,547,280,172,36,3163,8462,1035,27.21,72.79,8.9
E02000872,Tower Hamlets 009,9097,1046,699,2404,2388,1098,727,400,175,131,29,1745,7352,735,19.18,80.82,8.08
E02000873,Tower Hamlets 010,11103,1394,1057,3965,1991,1230,641,385,245,157,38,2451,8652,825,22.08,77.92,7.43
E02000874,Tower Hamlets 011,8136,1136,853,2090,1665,970,680,431,210,91,10,1989,6147,742,24.45,75.55,9.12
E02000875,Tower Hamlets 012,13843,2161,1642,3072,3138,1685,1069,647,290,107,32,3803,10040,1076,27.47,72.53,7.77
E02000876,Tower Hamlets 013,8093,911,557,2396,2006,991,585,418,139,72,18,1468,6625,647,18.14,81.86,7.99
E02000877,Tower Hamlets 014,13324,2055,1381,3248,2960,1616,971,570,307,183,33,3436,9888,1093,25.79,74.21,8.2
E02000878,Tower Hamlets 015,11994,1058,755,3941,2934,1328,855,591,328,160,44,1813,10181,1123,15.12,84.88,9.36
E02000879,Tower Hamlets 016,9342,1214,953,2292,1735,1094,758,570,376,300,50,2167,7175,1296,23.2,76.8,13.87
E02000880,Tower Hamlets 017,6723,911,611,1693,1464,906,503,328,163,125,19,1522,5201,635,22.64,77.36,9.45
E02000881,Tower Hamlets 018,9515,1668,1190,1748,1901,1256,874,500,232,132,14,2858,6657,878,30.04,69.96,9.23
E02000882,Tower Hamlets 019,10702,1710,1233,1937,2274,1533,967,565,283,158,42,2943,7759,1048,27.5,72.5,9.79
E02000883,Tower Hamlets 020,8971,1554,1200,1475,1632,1195,884,524,309,162,36,2754,6217,1031,30.7,69.3,11.49
E02000884,Tower Hamlets 021,13833,1416,901,5015,3346,1522,752,453,244,166,18,2317,11516,881,16.75,83.25,6.37
E02000885,Tower Hamlets 022,7711,1137,845,1493,1438,1060,706,482,337,189,24,1982,5729,1032,25.7,74.3,13.38
E02000886,Tower Hamlets 023,9475,1381,690,1933,2310,1381,848,535,245,124,28,2071,7404,932,21.86,78.14,9.84
E02000887,Tower Hamlets 024,11421,1934,1254,2267,2564,1502,901,564,264,135,36,3188,8233,999,27.91,72.09,8.75
E02000888,Tower Hamlets 025,10347,1411,880,2194,2552,1570,881,491,217,141,10,2291,8056,859,22.14,77.86,8.3
E02000889,Tower Hamlets 026,8680,1168,669,1755,2182,1235,765,545,241,105,15,1837,6843,906,21.16,78.84,10.44
E02000890,Tower Hamlets 027,6829,632,294,1202,1680,1154,855,596,292,103,21,926,5903,1012,13.56,86.44,14.82
E02000891,Tower Hamlets 028,20373,2653,1543,5269,5935,2669,1233,603,295,163,10,4196,16177,1071,20.6,79.4,5.26
E02000893,Tower Hamlets 030,8132,1276,667,1441,1850,1120,807,539,291,111,30,1943,6189,971,23.89,76.11,11.94
E02000894,Tower Hamlets 031,12011,1646,767,2498,3164,1890,1017,607,302,96,24,2413,9598,1029,20.09,79.91,8.57
E02006853,Tower Hamlets 032,11106,1347,724,2608,3471,1403,831,393,218,96,15,2071,9035,722,18.65,81.35,6.5
E02006854,Tower Hamlets 033,8379,781,490,1877,2483,1464,757,356,139,25,7,1271,7108,527,15.17,84.83,6.29
E02000895,Waltham Forest 001,8180,1014,771,1029,900,1019,1127,844,831,509,136,1785,6395,2320,21.82,78.18,28.36
E02000896,Waltham Forest 002,9044,1065,731,1088,1131,1316,1326,1006,812,446,123,1796,7248,2387,19.86,80.14,26.39
E02000897,Waltham Forest 003,8558,1217,836,1066,1206,1107,1186,785,620,406,129,2053,6505,1940,23.99,76.01,22.67
E02000898,Waltham Forest 004,7899,1082,761,939,1012,1033,1138,886,592,363,93,1843,6056,1934,23.33,76.67,24.48
E02000899,Waltham Forest 005,8656,1118,764,1125,1307,1091,1273,836,590,425,127,1882,6774,1978,21.74,78.26,22.85
E02000900,Waltham Forest 006,8771,1288,1011,1267,1184,1149,1224,763,527,295,63,2299,6472,1648,26.21,73.79,18.79
E02000901,Waltham Forest 007,10204,1453,982,1325,1450,1498,1469,993,683,285,66,2435,7769,2027,23.86,76.14,19.86
E02000902,Waltham Forest 008,9801,1729,985,1315,1598,1497,1160,745,482,238,52,2714,7087,1517,27.69,72.31,15.48
E02000903,Waltham Forest 009,9910,1605,1200,1443,1742,1434,1183,694,407,169,33,2805,7105,1303,28.3,71.7,13.15
E02000904,Waltham Forest 010,8859,1415,860,1221,1745,1301,1113,660,354,154,36,2275,6584,1204,25.68,74.32,13.59
E02000905,Waltham Forest 011,10369,1705,1025,1367,2222,1648,1175,675,348,148,56,2730,7639,1227,26.33,73.67,11.83
E02000906,Waltham Forest 012,9540,1540,1012,1231,2050,1562,1064,533,338,163,47,2552,6988,1081,26.75,73.25,11.33
E02000907,Waltham Forest 013,10945,1897,1200,1721,2059,1577,1147,627,401,242,74,3097,7848,1344,28.3,71.7,12.28
E02000908,Waltham Forest 014,12797,1955,1094,2421,2909,1884,1200,722,386,185,41,3049,9748,1334,23.83,76.17,10.42
E02000909,Waltham Forest 015,9027,1467,734,1176,1849,1401,1083,681,379,214,43,2201,6826,1317,24.38,75.62,14.59
E02000910,Waltham Forest 016,10785,1586,738,1753,2528,1651,1143,723,383,230,50,2324,8461,1386,21.55,78.45,12.85
E02000911,Waltham Forest 017,11883,1735,1006,1883,2620,1900,1351,735,421,194,38,2741,9142,1388,23.07,76.93,11.68
E02000912,Waltham Forest 018,9389,1514,926,1364,1711,1433,981,659,443,260,98,2440,6949,1460,25.99,74.01,15.55
E02000913,Waltham Forest 019,9170,1281,863,1530,1747,1321,979,756,438,228,27,2144,7026,1449,23.38,76.62,15.8
E02000914,Waltham Forest 020,11239,1749,1113,1948,2101,1737,1182,738,368,246,57,2862,8377,1409,25.46,74.54,12.54
E02000915,Waltham Forest 021,9282,1203,703,1699,2129,1277,994,736,339,161,41,1906,7376,1277,20.53,79.47,13.76
E02000916,Waltham Forest 022,9912,1553,1008,1381,2211,1464,1150,603,364,146,32,2561,7351,1145,25.84,74.16,11.55
E02000917,Waltham Forest 023,10348,1643,952,1701,2622,1490,936,537,296,131,40,2595,7753,1004,25.08,74.92,9.7
E02000918,Waltham Forest 024,9809,1417,756,1607,2421,1378,969,691,374,164,32,2173,7636,1261,22.15,77.85,12.86
E02000919,Waltham Forest 025,10007,1304,720,1898,2646,1300,893,624,373,217,32,2024,7983,1246,20.23,79.77,12.45
E02000920,Waltham Forest 026,10329,1384,938,2052,2198,1432,1110,657,364,165,29,2322,8007,1215,22.48,77.52,11.76
E02000921,Waltham Forest 027,11282,1620,1048,2092,2449,1406,1282,786,413,163,23,2668,8614,1385,23.65,76.35,12.28
E02000922,Waltham Forest 028,10988,1544,937,2165,2299,1490,1252,699,391,178,33,2481,8507,1301,22.58,77.42,11.84
E02000923,Wandsworth 001,8197,841,421,1565,1730,1058,1005,672,537,294,74,1262,6935,1577,15.4,84.6,19.24
E02000924,Wandsworth 002,14770,1727,1004,3442,3688,1987,1420,841,409,216,36,2731,12039,1502,18.49,81.51,10.17
E02000925,Wandsworth 003,8068,1032,691,1575,1552,1135,993,560,326,172,32,1723,6345,1090,21.36,78.64,13.51
E02000926,Wandsworth 004,11349,1162,609,2543,2847,1586,1119,718,523,218,24,1771,9578,1483,15.6,84.4,13.07
E02000927,Wandsworth 005,7319,761,330,1721,1788,924,730,502,369,154,40,1091,6228,1065,14.91,85.09,14.55
E02000928,Wandsworth 006,8588,1091,680,1323,1743,1278,994,718,521,192,48,1771,6817,1479,20.62,79.38,17.22
E02000929,Wandsworth 007,7508,1012,743,1435,1628,880,770,515,313,165,47,1755,5753,1040,23.38,76.62,13.85
E02000930,Wandsworth 008,10975,984,496,3569,3111,1134,771,448,275,152,35,1480,9495,910,13.49,86.51,8.29
E02000931,Wandsworth 009,9693,1374,605,2009,2579,1438,851,388,278,136,35,1979,7714,837,20.42,79.58,8.64
E02000932,Wandsworth 010,11827,1331,583,2515,3185,1793,1091,710,435,149,35,1914,9913,1329,16.18,83.82,11.24
E02000933,Wandsworth 011,9006,992,641,1498,1817,1296,1043,812,558,290,59,1633,7373,1719,18.13,81.87,19.09
E02000934,Wandsworth 012,10019,838,375,2578,3084,1312,829,485,333,143,42,1213,8806,1003,12.11,87.89,10.01
E02000935,Wandsworth 013,7122,1078,797,1733,1050,811,695,417,317,159,65,1875,5247,958,26.33,73.67,13.45
E02000936,Wandsworth 014,9268,871,479,1768,2418,1421,852,601,539,253,66,1350,7918,1459,14.57,85.43,15.74
E02000937,Wandsworth 015,8548,1415,708,1319,1791,1412,938,525,265,137,38,2123,6425,965,24.84,75.16,11.29
E02000938,Wandsworth 016,11292,1575,965,1883,2210,1615,1153,793,618,381,99,2540,8752,1891,22.49,77.51,16.75
E02000939,Wandsworth 017,8374,1405,759,1240,1439,1336,930,591,385,197,92,2164,6210,1265,25.84,74.16,15.11
E02000940,Wandsworth 018,8583,1038,622,1558,2416,1279,707,485,302,152,24,1660,6923,963,19.34,80.66,11.22
E02000941,Wandsworth 019,10445,1600,761,1607,2486,1636,1061,638,423,204,29,2361,8084,1294,22.6,77.4,12.39
E02000942,Wandsworth 020,9619,1331,835,1446,1879,1422,1181,744,545,206,30,2166,7453,1525,22.52,77.48,15.85
E02000943,Wandsworth 021,8901,1054,469,2164,2295,1190,726,512,313,161,17,1523,7378,1003,17.11,82.89,11.27
E02000944,Wandsworth 022,7317,1013,681,1164,1582,1112,811,450,292,167,45,1694,5623,954,23.15,76.85,13.04
E02000945,Wandsworth 023,8335,1023,800,2113,1476,1006,806,571,330,163,47,1823,6512,1111,21.87,78.13,13.33
E02000946,Wandsworth 024,8574,969,550,1648,2362,1225,862,512,281,132,33,1519,7055,958,17.72,82.28,11.17
E02000947,Wandsworth 025,9087,1606,606,1114,2361,1411,907,511,376,169,26,2212,6875,1082,24.34,75.66,11.91
E02000948,Wandsworth 026,9891,1091,462,2656,2641,1199,778,450,367,218,29,1553,8338,1064,15.7,84.3,10.76
E02000949,Wandsworth 027,9902,1203,702,1960,2129,1394,1143,667,457,207,40,1905,7997,1371,19.24,80.76,13.85
E02000950,Wandsworth 028,7572,1056,589,1162,1621,1075,869,592,400,166,42,1645,5927,1200,21.72,78.28,15.85
E02000951,Wandsworth 029,6396,680,377,1482,1496,811,670,415,243,183,39,1057,5339,880,16.53,83.47,13.76
E02000952,Wandsworth 030,6090,676,490,1311,1314,749,691,423,264,146,26,1166,4924,859,19.15,80.85,14.11
E02000953,Wandsworth 031,7840,1116,434,1776,2124,1066,631,338,207,127,21,1550,6290,693,19.77,80.23,8.84
E02000954,Wandsworth 032,6200,827,400,1323,1349,822,545,423,323,163,25,1227,4973,934,19.79,80.21,15.06
E02000955,Wandsworth 033,6505,886,465,1413,1314,805,651,436,320,185,30,1351,5154,971,20.77,79.23,14.93
E02000956,Wandsworth 034,8293,930,603,2318,1962,954,678,403,261,159,25,1533,6760,848,18.49,81.51,10.23
E02000957,Wandsworth 035,11165,1456,681,2319,2911,1484,1030,627,391,233,33,2137,9028,1284,19.14,80.86,11.5
E02000958,Wandsworth 036,8665,1107,886,1429,1406,1226,1113,719,454,270,55,1993,6672,1498,23.0,77.0,17.29
E02000959,Wandsworth 037,8374,1280,732,1273,1903,1191,1016,463,317,158,41,2012,6362,979,24.03,75.97,11.69
E02000960,Westminster 001,8716,1183,738,1245,1532,1291,919,722,570,393,123,1921,6795,1808,22.04,77.96,20.74
E02000961,Westminster 002,11474,1661,1326,1544,2018,1703,1440,809,561,317,95,2987,8487,1782,26.03,73.97,15.53
E02000962,Westminster 003,10713,1382,793,1573,2099,1460,1149,931,761,462,103,2175,8538,2257,20.3,79.7,21.07
E02000963,Westminster 004,11110,1628,1288,1634,1773,1530,1419,914,571,311,42,2916,8194,1838,26.25,73.75,16.54
E02000964,Westminster 005,13660,1754,1334,2218,2724,1987,1617,1091,584,315,36,3088,10572,2026,22.61,77.39,14.83
E02000965,Westminster 006,9423,1268,651,1638,2248,1588,927,622,300,137,44,1919,7504,1103,20.37,79.63,11.71
E02000966,Westminster 007,11363,1497,885,1444,2297,1946,1415,917,593,295,74,2382,8981,1879,20.96,79.04,16.54
E02000967,Westminster 008,10506,1055,628,2815,2173,1324,961,739,477,265,69,1683,8823,1550,16.02,83.98,14.75
E02000968,Westminster 009,16000,2044,1947,2722,2371,2142,1852,1424,826,563,109,3991,12009,2922,24.94,75.06,18.26
E02000969,Westminster 010,10934,1507,1351,1720,1825,1555,1353,764,449,308,102,2858,8076,1623,26.14,73.86,14.84
E02000970,Westminster 011,11341,1031,637,2259,2357,1751,1309,993,644,306,54,1668,9673,1997,14.71,85.29,17.61
E02000971,Westminster 012,9992,873,608,2346,1999,1527,999,771,533,273,63,1481,8511,1640,14.82,85.18,16.41
E02000972,Westminster 013,11307,791,578,3009,2444,1716,1267,743,480,240,39,1369,9938,1502,12.11,87.89,13.28
E02000973,Westminster 014,11622,1378,718,1770,2709,1950,1292,873,637,240,55,2096,9526,1805,18.03,81.97,15.53
E02000974,Westminster 015,10539,1111,726,2406,2076,1350,1053,871,582,277,87,1837,8702,1817,17.43,82.57,17.24
E02000975,Westminster 016,10679,1012,486,2689,2734,1443,1049,580,471,171,44,1498,9181,1266,14.03,85.97,11.86
E02000976,Westminster 017,11529,1164,607,2628,2894,1592,1100,708,572,226,38,1771,9758,1544,15.36,84.64,13.39
E02000977,Westminster 018,7528,510,256,987,1485,1283,1275,864,555,250,63,766,6762,1732,10.18,89.82,23.01
E02000978,Westminster 019,11746,1001,724,3231,1592,1527,1485,1072,648,368,98,1725,10021,2186,14.69,85.31,18.61
E02000979,Westminster 020,10627,889,744,1872,1968,1539,1549,1057,644,278,87,1633,8994,2066,15.37,84.63,19.44
E02000980,Westminster 021,10898,1107,789,1873,2013,1512,1459,1021,670,360,94,1896,9002,2145,17.4,82.6,19.68
E02000981,Westminster 022,10426,924,575,2377,2183,1372,1282,875,553,233,52,1499,8927,1713,14.38,85.62,16.43
E02000982,Westminster 023,9246,1075,875,1381,1620,1337,1181,830,583,300,64,1950,7296,1777,21.09,78.91,19.22
E02000983,Westminster 024,9938,942,740,1844,1868,1367,1214,853,629,376,105,1682,8256,1963,16.92,83.08,19.75
W02000001,Isle of Anglesey 001,8684,921,755,991,847,880,1350,1305,1103,450,82,1676,7008,2940,19.3,80.7,33.86
W02000002,Isle of Anglesey 002,6419,564,406,624,541,577,975,1097,1133,417,85,970,5449,2732,15.11,84.89,42.56
W02000003,Isle of Anglesey 003,10719,1396,1101,1547,1411,1281,1377,1178,960,374,94,2497,8222,2606,23.3,76.7,24.31
W02000004,Isle of Anglesey 004,7321,607,619,735,598,864,1049,1192,1070,460,127,1226,6095,2849,16.75,83.25,38.92
W02000005,Isle of Anglesey 005,8450,716,646,791,712,901,1199,1367,1311,648,159,1362,7088,3485,16.12,83.88,41.24
W02000006,Isle of Anglesey 006,7076,945,658,863,768,881,919,903,700,372,67,1603,5473,2042,22.65,77.35,28.86
W02000007,Isle of Anglesey 007,7197,961,548,877,880,872,1087,865,702,333,72,1509,5688,1972,20.97,79.03,27.4
W02000008,Isle of Anglesey 008,6230,577,512,758,725,683,881,854,717,389,134,1089,5141,2094,17.48,82.52,33.61
W02000009,Isle of Anglesey 009,7947,802,672,882,767,934,1238,1161,928,456,107,1474,6473,2652,18.55,81.45,33.37
W02000010,Gwynedd 001,9594,600,364,5811,756,552,484,419,367,193,48,964,8630,1027,10.05,89.95,10.7
W02000011,Gwynedd 002,8331,1015,903,1798,996,905,1006,719,594,314,81,1918,6413,1708,23.02,76.98,20.5
W02000012,Gwynedd 003,8586,1026,849,1216,1105,1083,1206,976,727,344,54,1875,6711,2101,21.84,78.16,24.47
W02000013,Gwynedd 004,6857,745,635,1039,881,880,851,781,618,321,106,1380,5477,1826,20.13,79.87,26.63
W02000014,Gwynedd 005,7259,756,672,1184,843,895,1149,796,657,266,41,1428,5831,1760,19.67,80.33,24.25
W02000015,Gwynedd 006,8530,1057,853,1396,1043,943,1043,916,795,392,92,1910,6620,2195,22.39,77.61,25.73
W02000016,Gwynedd 007,6692,750,633,952,810,746,931,800,621,340,109,1383,5309,1870,20.67,79.33,27.94
W02000017,Gwynedd 008,7957,908,756,1105,838,937,1112,1000,873,348,80,1664,6293,2301,20.91,79.09,28.92
W02000018,Gwynedd 009,6491,723,590,994,652,686,966,851,645,329,55,1313,5178,1880,20.23,79.77,28.96
W02000019,Gwynedd 010,7021,681,531,872,651,687,1003,943,993,554,106,1212,5809,2596,17.26,82.74,36.97
W02000020,Gwynedd 011,6933,636,629,969,640,728,981,952,863,429,106,1265,5668,2350,18.25,81.75,33.9
W02000021,Gwynedd 012,8420,814,811,1151,871,990,1148,1069,945,505,116,1625,6795,2635,19.3,80.7,31.29
W02000022,Gwynedd 013,5944,527,427,750,506,553,816,974,901,419,71,954,4990,2365,16.05,83.95,39.79
W02000023,Gwynedd 014,5876,571,478,717,496,596,858,880,814,367,99,1049,4827,2160,17.85,82.15,36.76
W02000024,Gwynedd 015,6004,620,534,819,648,663,924,844,620,275,57,1154,4850,1796,19.22,80.78,29.91
W02000025,Gwynedd 016,6618,595,551,805,661,683,987,1015,810,408,103,1146,5472,2336,17.32,82.68,35.3
W02000026,Gwynedd 017,7447,572,502,784,595,640,1114,1241,1222,609,168,1074,6373,3240,14.42,85.58,43.51
W02000027,Conwy 001,8859,711,539,1130,959,929,1351,1307,1062,640,231,1250,7609,3240,14.11,85.89,36.57
W02000028,Conwy 002,7005,695,625,749,668,770,1030,899,920,490,159,1320,5685,2468,18.84,81.16,35.23
W02000029,Conwy 003,6217,494,492,591,546,659,897,915,968,522,133,986,5231,2538,15.86,84.14,40.82
W02000030,Conwy 004,6010,461,423,529,541,583,810,871,903,680,209,884,5126,2663,14.71,85.29,44.31
W02000031,Conwy 005,8351,835,735,861,758,911,1245,1258,1194,461,93,1570,6781,3006,18.8,81.2,36.0
W02000032,Conwy 006,9617,953,741,946,999,1021,1362,1384,1318,716,177,1694,7923,3595,17.61,82.39,37.38
W02000033,Conwy 007,6203,684,590,758,680,730,864,749,626,403,119,1274,4929,1897,20.54,79.46,30.58
W02000034,Conwy 008,7587,765,746,862,783,825,1130,1007,893,452,124,1511,6076,2476,19.92,80.08,32.63
W02000035,Conwy 009,8655,1079,930,1037,969,1028,1233,1141,795,370,73,2009,6646,2379,23.21,76.79,27.49
W02000036,Conwy 010,10867,969,772,1085,964,962,1489,1641,1833,923,229,1741,9126,4626,16.02,83.98,42.57
W02000037,Conwy 011,7339,934,609,945,879,816,1026,931,799,330,70,1543,5796,2130,21.02,78.98,29.02
W02000038,Conwy 012,7137,730,636,721,709,822,1175,995,900,381,68,1366,5771,2344,19.14,80.86,32.84
W02000039,Conwy 013,7804,765,621,933,869,905,1274,1064,840,420,113,1386,6418,2437,17.76,82.24,31.23
W02000040,Conwy 014,6954,640,575,793,580,848,1194,1121,758,342,103,1215,5739,2324,17.47,82.53,33.42
W02000041,Conwy 015,8598,880,649,982,827,990,1474,1181,1027,477,111,1529,7069,2796,17.78,82.22,32.52
W02000042,Denbighshire 001,5806,620,465,650,548,584,782,811,862,443,41,1085,4721,2157,18.69,81.31,37.15
W02000043,Denbighshire 002,5230,584,495,638,514,602,780,658,644,256,59,1079,4151,1617,20.63,79.37,30.92
W02000044,Denbighshire 003,5203,469,414,594,465,546,771,773,780,338,53,883,4320,1944,16.97,83.03,37.36
W02000045,Denbighshire 004,9533,1222,845,1426,1024,987,1298,1129,945,527,130,2067,7466,2731,21.68,78.32,28.65
W02000047,Denbighshire 006,5505,927,760,849,669,632,680,482,356,134,16,1687,3818,988,30.64,69.36,17.95
W02000049,Denbighshire 008,6494,748,612,744,632,768,1021,860,779,288,42,1360,5134,1969,20.94,79.06,30.32
W02000050,Denbighshire 009,6407,679,553,775,693,794,938,823,768,334,50,1232,5175,1975,19.23,80.77,30.83
W02000051,Denbighshire 010,5360,484,429,613,482,667,845,759,709,304,68,913,4447,1840,17.03,82.97,34.33
W02000052,Denbighshire 011,5230,603,513,816,582,658,751,627,435,215,30,1116,4114,1307,21.34,78.66,24.99
W02000053,Denbighshire 012,6587,671,668,741,704,785,1018,874,737,332,57,1339,5248,2000,20.33,79.67,30.36
W02000054,Denbighshire 013,6119,541,551,683,462,676,1119,972,741,316,58,1092,5027,2087,17.85,82.15,34.11
W02000055,Denbighshire 014,5628,638,600,657,569,690,778,652,646,316,82,1238,4390,1696,22.0,78.0,30.14
W02000056,Denbighshire 015,5285,572,504,574,506,614,883,766,625,207,34,1076,4209,1632,20.36,79.64,30.88
W02000057,Denbighshire 016,6405,624,453,630,585,746,1076,969,852,389,81,1077,5328,2291,16.81,83.19,35.77
W02000419,Denbighshire 017,10904,1269,937,1365,1213,1206,1574,1472,1234,562,72,2206,8698,3340,20.23,79.77,30.63
W02000058,Flintshire 001,4989,424,433,529,411,575,864,758,659,290,46,857,4132,1753,17.18,82.82,35.14
W02000059,Flintshire 002,6657,789,666,808,631,803,1006,909,685,307,53,1455,5202,1954,21.86,78.14,29.35
W02000060,Flintshire 003,10924,1381,1058,1555,1348,1322,1614,1221,958,393,74,2439,8485,2646,22.33,77.67,24.22
W02000061,Flintshire 004,6943,922,729,1029,989,756,891,789,516,250,72,1651,5292,1627,23.78,76.22,23.43
W02000062,Flintshire 005,6211,641,595,844,729,803,917,769,626,217,70,1236,4975,1682,19.9,80.1,27.08
W02000063,Flintshire 006,8112,619,677,862,690,942,1393,1335,1082,448,64,1296,6816,2929,15.98,84.02,36.11
W02000064,Flintshire 007,6108,779,651,929,836,757,788,630,490,203,45,1430,4678,1368,23.41,76.59,22.4
W02000065,Flintshire 008,7344,849,686,1057,1077,930,984,820,636,257,48,1535,5809,1761,20.9,79.1,23.98
W02000066,Flintshire 009,10125,1266,1043,1617,1583,1214,1297,1025,611,382,87,2309,7816,2105,22.8,77.2,20.79
W02000067,Flintshire 010,6646,739,639,768,773,902,1020,790,706,278,31,1378,5268,1805,20.73,79.27,27.16
W02000068,Flintshire 011,5564,612,449,809,802,747,751,617,532,212,33,1061,4503,1394,19.07,80.93,25.05
W02000069,Flintshire 012,6426,715,573,738,666,838,992,756,772,319,57,1288,5138,1904,20.04,79.96,29.63
W02000070,Flintshire 013,10868,1182,1137,1193,1217,1516,1609,1346,1101,494,73,2319,8549,3014,21.34,78.66,27.73
W02000071,Flintshire 014,7204,686,611,772,720,988,987,970,1006,400,64,1297,5907,2440,18.0,82.0,33.87
W02000072,Flintshire 015,12003,1548,1075,1818,1872,1438,1619,1189,970,389,85,2623,9380,2633,21.85,78.15,21.94
W02000073,Flintshire 016,10123,1136,1009,1223,1035,1224,1455,1250,1048,597,146,2145,7978,3041,21.19,78.81,30.04
W02000074,Flintshire 017,10090,1241,869,1368,1396,1250,1423,972,1033,427,111,2110,7980,2543,20.91,79.09,25.2
W02000075,Flintshire 018,6139,724,598,662,768,858,909,705,659,208,48,1322,4817,1620,21.53,78.47,26.39
W02000076,Flintshire 019,7434,721,615,853,684,867,1272,1018,1007,334,63,1336,6098,2422,17.97,82.03,32.58
W02000077,Flintshire 020,6190,612,616,696,644,816,948,739,699,355,65,1228,4962,1858,19.84,80.16,30.02
W02000080,Wrexham 003,8025,1030,906,970,1112,1016,1072,859,786,241,33,1936,6089,1919,24.12,75.88,23.91
W02000081,Wrexham 004,5925,784,587,755,722,726,852,716,557,183,43,1371,4554,1499,23.14,76.86,25.3
W02000082,Wrexham 005,7759,1058,803,1105,1092,980,1056,760,603,256,46,1861,5898,1665,23.99,76.01,21.46
W02000083,Wrexham 006,9125,1300,802,1326,1329,1158,1132,1008,662,326,82,2102,7023,2078,23.04,76.96,22.77
W02000084,Wrexham 007,4841,404,364,464,449,549,706,752,722,380,51,768,4073,1905,15.86,84.14,39.35
W02000085,Wrexham 008,8882,787,758,1135,1025,1020,1254,1141,1071,565,126,1545,7337,2903,17.39,82.61,32.68
W02000086,Wrexham 009,5056,684,464,713,642,585,688,527,453,248,52,1148,3908,1280,22.71,77.29,25.32
W02000087,Wrexham 010,7141,1261,877,1076,971,826,864,602,401,229,34,2138,5003,1266,29.94,70.06,17.73
W02000088,Wrexham 011,8334,950,657,1258,1488,1143,1055,818,592,302,71,1607,6727,1783,19.28,80.72,21.39
W02000089,Wrexham 012,8754,1195,781,1392,1448,1153,1088,849,569,243,36,1976,6778,1697,22.57,77.43,19.39
W02000090,Wrexham 013,5727,684,582,637,699,714,869,753,531,201,57,1266,4461,1542,22.11,77.89,26.93
W02000091,Wrexham 014,6133,719,555,696,864,743,898,735,556,311,56,1274,4859,1658,20.77,79.23,27.03
W02000092,Wrexham 015,7029,901,705,991,923,915,935,771,597,215,76,1606,5423,1659,22.85,77.15,23.6
W02000093,Wrexham 016,6627,768,634,853,728,897,1006,787,647,258,49,1402,5225,1741,21.16,78.84,26.27
W02000094,Wrexham 017,9178,1159,974,1266,1113,1135,1253,969,860,373,76,2133,7045,2278,23.24,76.76,24.82
W02000095,Wrexham 018,6647,640,635,690,603,809,1066,969,825,347,63,1275,5372,2204,19.18,80.82,33.16
W02000096,Wrexham 019,6482,724,573,713,717,774,977,888,737,296,83,1297,5185,2004,20.01,79.99,30.92
W02000420,Wrexham 020,14292,1154,1206,1623,1587,1992,2292,1836,1649,764,189,2360,11932,4438,16.51,83.49,31.05
W02000116,Ceredigion 001,7440,765,661,974,642,801,1222,990,886,403,96,1426,6014,2375,19.17,80.83,31.92
W02000117,Ceredigion 002,8835,372,325,5440,482,514,559,503,329,231,80,697,8138,1143,7.89,92.11,12.94
W02000118,Ceredigion 003,6693,703,609,1899,610,650,737,646,522,266,51,1312,5381,1485,19.6,80.4,22.19
W02000120,Ceredigion 005,7097,587,540,837,545,715,1019,1216,1054,453,131,1127,5970,2854,15.88,84.12,40.21
W02000122,Ceredigion 007,6573,563,513,744,438,594,1130,1141,972,409,69,1076,5497,2591,16.37,83.63,39.42
W02000123,Ceredigion 008,8243,912,695,1240,633,890,1165,1179,981,452,96,1607,6636,2708,19.5,80.5,32.85
W02000124,Ceredigion 009,8878,922,683,1096,741,871,1248,1296,1263,612,146,1605,7273,3317,18.08,81.92,37.36
W02000125,Ceredigion 010,7390,688,557,872,480,709,1139,1347,1085,412,101,1245,6145,2945,16.85,83.15,39.85
W02000421,Ceredigion 011,11546,1101,1043,1355,813,1287,1809,1771,1437,733,197,2144,9402,4138,18.57,81.43,35.84
W02000126,Pembrokeshire 001,8493,775,718,889,771,926,1315,1378,1202,440,79,1493,7000,3099,17.58,82.42,36.49
W02000127,Pembrokeshire 002,9902,980,799,1114,864,1042,1364,1605,1326,649,159,1779,8123,3739,17.97,82.03,37.76
W02000128,Pembrokeshire 003,7602,623,581,1023,725,797,1150,1240,969,409,85,1204,6398,2703,15.84,84.16,35.56
W02000129,Pembrokeshire 004,7205,719,589,766,672,811,1157,1028,893,452,118,1308,5897,2491,18.15,81.85,34.57
W02000130,Pembrokeshire 005,7110,982,730,1233,936,813,959,698,473,236,50,1712,5398,1457,24.08,75.92,20.49
W02000131,Pembrokeshire 006,7151,823,680,866,841,825,1041,858,715,382,120,1503,5648,2075,21.02,78.98,29.02
W02000132,Pembrokeshire 007,6872,622,574,742,642,773,1086,1050,870,399,114,1196,5676,2433,17.4,82.6,35.4
W02000133,Pembrokeshire 008,8359,794,694,845,808,886,1300,1304,1101,531,96,1488,6871,3032,17.8,82.2,36.27
W02000134,Pembrokeshire 009,8690,850,828,914,788,1039,1435,1227,1054,484,71,1678,7012,2836,19.31,80.69,32.64
W02000135,Pembrokeshire 010,7468,885,664,1054,866,808,1054,851,804,416,66,1549,5919,2137,20.74,79.26,28.62
W02000136,Pembrokeshire 011,8494,694,650,904,692,828,1308,1378,1284,624,132,1344,7150,3418,15.82,84.18,40.24
W02000137,Pembrokeshire 012,7640,997,723,1136,999,739,1008,915,640,407,76,1720,5920,2038,22.51,77.49,26.68
W02000138,Pembrokeshire 013,9665,1127,980,1422,1119,1066,1344,1183,937,403,84,2107,7558,2607,21.8,78.2,26.97
W02000139,Pembrokeshire 014,7698,634,638,719,648,811,1155,1285,1184,488,136,1272,6426,3093,16.52,83.48,40.18
W02000140,Pembrokeshire 015,7394,868,750,959,823,866,1056,913,775,294,90,1618,5776,2072,21.88,78.12,28.02
W02000141,Pembrokeshire 016,6075,503,473,680,536,612,893,904,839,496,139,976,5099,2378,16.07,83.93,39.14
W02000142,Carmarthenshire 001,5680,625,520,589,588,636,857,786,692,328,59,1145,4535,1865,20.16,79.84,32.83
W02000143,Carmarthenshire 002,5556,505,392,557,524,539,881,1001,769,326,62,897,4659,2158,16.14,83.86,38.84
W02000144,Carmarthenshire 003,7635,626,666,765,656,759,1306,1224,1098,436,99,1292,6343,2857,16.92,83.08,37.42
W02000145,Carmarthenshire 004,7199,597,629,704,652,793,1257,1127,880,453,107,1226,5973,2567,17.03,82.97,35.66
W02000146,Carmarthenshire 005,6659,542,618,648,573,727,1179,1056,887,382,47,1160,5499,2372,17.42,82.58,35.62
W02000147,Carmarthenshire 006,8619,1093,855,1372,1030,1074,1086,983,716,334,76,1948,6671,2109,22.6,77.4,24.47
W02000148,Carmarthenshire 007,5147,642,499,665,707,625,679,627,453,198,52,1141,4006,1330,22.17,77.83,25.84
W02000149,Carmarthenshire 008,6449,680,428,824,742,685,804,816,854,484,132,1108,5341,2286,17.18,82.82,35.45
W02000151,Carmarthenshire 010,7367,854,688,905,833,841,1105,1020,735,307,79,1542,5825,2141,20.93,79.07,29.06
W02000152,Carmarthenshire 011,8554,901,802,940,935,976,1136,1207,1031,507,119,1703,6851,2864,19.91,80.09,33.48
W02000153,Carmarthenshire 012,8288,729,698,826,784,898,1351,1364,1103,433,102,1427,6861,3002,17.22,82.78,36.22
W02000154,Carmarthenshire 013,7925,890,720,1051,855,924,1106,984,878,424,93,1610,6315,2379,20.32,79.68,30.02
W02000156,Carmarthenshire 015,8417,900,755,1107,1045,1013,1225,1010,919,359,84,1655,6762,2372,19.66,80.34,28.18
W02000157,Carmarthenshire 016,9680,1068,832,1169,1069,1158,1464,1329,1045,459,87,1900,7780,2920,19.63,80.37,30.17
W02000158,Carmarthenshire 017,6057,667,531,769,757,722,889,780,653,241,48,1198,4859,1722,19.78,80.22,28.43
W02000159,Carmarthenshire 018,6177,712,595,722,615,623,972,853,754,281,50,1307,4870,1938,21.16,78.84,31.37
W02000160,Carmarthenshire 019,7653,776,683,854,824,895,1159,935,1008,449,70,1459,6194,2462,19.06,80.94,32.17
W02000161,Carmarthenshire 020,5588,676,631,800,597,625,769,617,490,284,99,1307,4281,1490,23.39,76.61,26.66
W02000162,Carmarthenshire 021,8313,651,788,891,693,952,1295,1233,1203,508,99,1439,6874,3043,17.31,82.69,36.61
W02000163,Carmarthenshire 022,5460,657,561,691,715,669,687,659,465,289,67,1218,4242,1480,22.31,77.69,27.11
W02000164,Carmarthenshire 023,7377,757,629,983,812,804,1111,1035,748,406,92,1386,5991,2281,18.79,81.21,30.92
W02000165,Carmarthenshire 024,6737,842,611,1029,847,799,928,747,541,307,86,1453,5284,1681,21.57,78.43,24.95
W02000166,Carmarthenshire 025,9039,1280,911,1345,1242,1066,1201,924,675,310,85,2191,6848,1994,24.24,75.76,22.06
W02000167,Carmarthenshire 026,10712,1406,1013,1622,1452,1355,1512,1175,753,354,70,2419,8293,2352,22.58,77.42,21.96
W02000418,Carmarthenshire 027,12483,1278,985,1327,1263,1394,1941,1945,1523,712,115,2263,10220,4295,18.13,81.87,34.41
W02000168,Swansea 001,6686,836,678,981,867,827,873,723,567,264,70,1514,5172,1624,22.64,77.36,24.29
W02000169,Swansea 002,9529,1130,901,1265,1133,1151,1314,1166,978,420,71,2031,7498,2635,21.31,78.69,27.65
W02000170,Swansea 003,8864,878,812,1240,1002,1087,1217,1160,960,452,56,1690,7174,2628,19.07,80.93,29.65
W02000171,Swansea 004,8407,1002,792,1222,1072,1182,1214,894,702,280,47,1794,6613,1923,21.34,78.66,22.87
W02000172,Swansea 005,10639,1229,1079,1537,1431,1325,1434,1176,888,428,112,2308,8331,2604,21.69,78.31,24.48
W02000173,Swansea 006,8065,1095,825,1216,1214,1088,1024,832,521,197,53,1920,6145,1603,23.81,76.19,19.88
W02000174,Swansea 007,9548,1118,782,1287,1130,1156,1301,1205,1030,475,64,1900,7648,2774,19.9,80.1,29.05
W02000175,Swansea 008,7599,878,580,1261,1206,908,1062,739,573,329,63,1458,6141,1704,19.19,80.81,22.42
W02000176,Swansea 009,9091,923,770,1319,1039,1017,1240,1080,1141,467,95,1693,7398,2783,18.62,81.38,30.61
W02000177,Swansea 010,7027,852,661,1183,969,861,939,720,567,251,24,1513,5514,1562,21.53,78.47,22.23
W02000178,Swansea 011,9643,1603,1180,1791,1448,1121,1053,739,481,189,38,2783,6860,1447,28.86,71.14,15.01
W02000179,Swansea 012,6715,592,658,882,678,862,982,883,720,382,76,1250,5465,2061,18.62,81.38,30.69
W02000180,Swansea 013,8427,1130,878,1492,1108,985,1030,836,649,262,57,2008,6419,1804,23.83,76.17,21.41
W02000181,Swansea 014,7527,803,678,1403,1052,804,939,726,615,364,143,1481,6046,1848,19.68,80.32,24.55
W02000182,Swansea 015,7821,848,717,1329,1118,893,1104,855,565,333,59,1565,6256,1812,20.01,79.99,23.17
W02000183,Swansea 016,10291,1180,807,2249,1654,1220,1239,970,621,281,70,1987,8304,1942,19.31,80.69,18.87
W02000184,Swansea 017,7246,835,632,1025,942,910,1005,838,629,351,79,1467,5779,1897,20.25,79.75,26.18
W02000185,Swansea 018,5077,443,429,612,457,598,743,765,682,287,61,872,4205,1795,17.18,82.82,35.36
W02000186,Swansea 019,9098,1657,1036,1623,1310,1025,1035,701,461,221,29,2693,6405,1412,29.6,70.4,15.52
W02000187,Swansea 020,5618,563,496,711,592,684,819,654,728,332,39,1059,4559,1753,18.85,81.15,31.2
W02000188,Swansea 021,8270,885,606,1979,1241,874,1024,826,566,236,33,1491,6779,1661,18.03,81.97,20.08
W02000189,Swansea 022,8189,783,683,1026,883,967,1244,1019,871,562,151,1466,6723,2603,17.9,82.1,31.79
W02000190,Swansea 023,5014,381,370,1019,429,542,667,573,636,345,52,751,4263,1606,14.98,85.02,32.03
W02000191,Swansea 024,9704,625,658,3665,1034,936,936,828,589,328,105,1283,8421,1850,13.22,86.78,19.06
W02000192,Swansea 025,10285,524,347,3981,1672,958,1071,902,539,249,42,871,9414,1732,8.47,91.53,16.84
W02000193,Swansea 026,10185,383,384,5878,888,645,593,584,469,291,70,767,9418,1414,7.53,92.47,13.88
W02000194,Swansea 027,6356,478,447,1734,481,601,697,691,693,427,107,925,5431,1918,14.55,85.45,30.18
W02000195,Swansea 028,5813,484,535,479,405,722,803,892,887,509,97,1019,4794,2385,17.53,82.47,41.03
W02000196,Swansea 029,6507,630,538,688,669,762,847,893,868,488,124,1168,5339,2373,17.95,82.05,36.47
W02000197,Swansea 030,6343,503,570,525,491,712,936,1029,980,494,103,1073,5270,2606,16.92,83.08,41.08
W02000198,Swansea 031,7409,604,584,692,577,886,1138,1071,1044,604,209,1188,6221,2928,16.03,83.97,39.52
W02000200,Neath Port Talbot 002,5230,595,462,634,623,606,720,780,555,222,33,1057,4173,1590,20.21,79.79,30.4
W02000201,Neath Port Talbot 003,5264,514,426,688,638,623,807,638,601,280,49,940,4324,1568,17.86,82.14,29.79
W02000202,Neath Port Talbot 004,12290,1324,1124,1617,1422,1590,1727,1615,1240,539,92,2448,9842,3486,19.92,80.08,28.36
W02000203,Neath Port Talbot 005,6838,741,679,945,879,832,949,850,607,298,58,1420,5418,1813,20.77,79.23,26.51
W02000204,Neath Port Talbot 006,6786,583,555,856,689,843,1040,927,884,346,63,1138,5648,2220,16.77,83.23,32.71
W02000205,Neath Port Talbot 007,5850,537,490,722,589,746,868,783,721,308,86,1027,4823,1898,17.56,82.44,32.44
W02000206,Neath Port Talbot 008,6801,699,514,896,870,749,983,925,697,389,79,1213,5588,2090,17.84,82.16,30.73
W02000207,Neath Port Talbot 009,5108,431,403,583,536,588,821,810,656,234,46,834,4274,1746,16.33,83.67,34.18
W02000208,Neath Port Talbot 010,10920,1282,795,2103,1667,1374,1303,1103,819,390,84,2077,8843,2396,19.02,80.98,21.94
W02000209,Neath Port Talbot 011,5110,604,453,766,563,606,729,649,521,177,42,1057,4053,1389,20.68,79.32,27.18
W02000210,Neath Port Talbot 012,6593,820,684,1023,780,842,978,678,518,240,30,1504,5089,1466,22.81,77.19,22.24
W02000211,Neath Port Talbot 013,7979,979,717,1215,1061,950,1112,945,602,346,52,1696,6283,1945,21.26,78.74,24.38
W02000212,Neath Port Talbot 014,7843,774,712,1018,945,1011,1200,976,827,336,44,1486,6357,2183,18.95,81.05,27.83
W02000213,Neath Port Talbot 015,6725,615,575,799,843,819,932,873,772,416,81,1190,5535,2142,17.7,82.3,31.85
W02000214,Neath Port Talbot 016,9868,1144,983,1287,1328,1075,1309,1328,792,487,135,2127,7741,2742,21.55,78.45,27.79
W02000215,Neath Port Talbot 017,9770,1176,813,1439,1436,1176,1377,1130,742,416,65,1989,7781,2353,20.36,79.64,24.08
W02000216,Neath Port Talbot 018,7216,763,564,1037,963,877,1125,881,626,312,68,1327,5889,1887,18.39,81.61,26.15
W02000217,Neath Port Talbot 019,6666,748,672,881,797,977,938,728,609,283,33,1420,5246,1653,21.3,78.7,24.8
W02000417,Neath Port Talbot 020,10458,1208,903,1367,1389,1307,1516,1387,963,346,72,2111,8347,2768,20.19,79.81,26.47
W02000218,Bridgend 001,7079,967,710,1079,871,854,931,784,601,252,30,1677,5402,1667,23.69,76.31,23.55
W02000219,Bridgend 002,7396,737,665,1053,863,974,1144,961,663,297,39,1402,5994,1960,18.96,81.04,26.5
W02000220,Bridgend 003,8135,997,721,1212,990,1044,1166,926,743,305,31,1718,6417,2005,21.12,78.88,24.65
W02000221,Bridgend 004,7821,1039,761,1174,1003,961,1147,856,606,240,34,1800,6021,1736,23.01,76.99,22.2
W02000222,Bridgend 005,6168,589,547,793,645,739,884,823,751,352,45,1136,5032,1971,18.42,81.58,31.96
W02000223,Bridgend 006,6303,734,517,911,855,837,1017,716,487,196,33,1251,5052,1432,19.85,80.15,22.72
W02000224,Bridgend 007,6719,824,588,1066,922,822,967,704,571,234,21,1412,5307,1530,21.02,78.98,22.77
W02000225,Bridgend 008,9290,1101,861,1252,1340,1058,1393,1008,853,370,54,1962,7328,2285,21.12,78.88,24.6
W02000226,Bridgend 009,10353,1088,942,1264,1239,1394,1493,1283,1150,440,60,2030,8323,2933,19.61,80.39,28.33
W02000227,Bridgend 010,7595,957,717,1132,1055,918,970,806,694,291,55,1674,5921,1846,22.04,77.96,24.31
W02000228,Bridgend 011,10421,1293,661,2067,1905,1374,1094,848,742,367,70,1954,8467,2027,18.75,81.25,19.45
W02000229,Bridgend 012,6292,726,561,830,781,693,949,791,599,306,56,1287,5005,1752,20.45,79.55,27.84
W02000230,Bridgend 013,5505,481,457,594,564,674,871,758,715,336,55,938,4567,1864,17.04,82.96,33.86
W02000231,Bridgend 014,8527,930,661,1355,1246,1096,1170,910,713,378,68,1591,6936,2069,18.66,81.34,24.26
W02000232,Bridgend 015,5866,662,470,816,763,773,955,676,517,200,34,1132,4734,1427,19.3,80.7,24.33
W02000233,Bridgend 016,6392,804,603,938,959,803,891,654,482,223,35,1407,4985,1394,22.01,77.99,21.81
W02000234,Bridgend 017,11098,1314,1230,1368,1481,1719,1594,1119,803,384,86,2544,8554,2392,22.92,77.08,21.55
W02000235,Bridgend 018,8999,646,651,881,667,958,1326,1389,1405,854,222,1297,7702,3870,14.41,85.59,43.0
W02000236,Bridgend 019,7090,610,547,804,613,847,1115,1080,943,440,91,1157,5933,2554,16.32,83.68,36.02
W02000237,The Vale of Glamorgan 001,6041,656,560,514,525,795,992,949,740,270,40,1216,4825,1999,20.13,79.87,33.09
W02000238,The Vale of Glamorgan 002,6441,625,564,479,505,819,917,941,1004,454,133,1189,5252,2532,18.46,81.54,39.31
W02000239,The Vale of Glamorgan 003,7627,724,788,683,755,998,1282,1071,941,336,49,1512,6115,2397,19.82,80.18,31.43
W02000240,The Vale of Glamorgan 004,8884,1044,927,980,1103,1237,1274,984,855,388,92,1971,6913,2319,22.19,77.81,26.1
W02000241,The Vale of Glamorgan 005,10641,1013,945,1308,1333,1499,1509,1258,997,592,187,1958,8683,3034,18.4,81.6,28.51
W02000242,The Vale of Glamorgan 006,8051,786,625,840,818,992,1157,1096,1120,512,105,1411,6640,2833,17.53,82.47,35.19
W02000243,The Vale of Glamorgan 007,10031,1605,1031,1533,1409,1139,1261,923,740,328,62,2636,7395,2053,26.28,73.72,20.47
W02000244,The Vale of Glamorgan 008,10494,1098,1045,1012,1040,1409,1525,1385,1198,650,132,2143,8351,3365,20.42,79.58,32.07
W02000245,The Vale of Glamorgan 009,8785,1066,871,1357,1131,1272,1242,1009,586,210,41,1937,6848,1846,22.05,77.95,21.01
W02000246,The Vale of Glamorgan 010,5488,437,415,561,519,610,860,975,747,306,58,852,4636,2086,15.52,84.48,38.01
W02000247,The Vale of Glamorgan 011,8959,828,894,1128,903,1042,1319,1183,1083,507,72,1722,7237,2845,19.22,80.78,31.76
W02000248,The Vale of Glamorgan 012,11249,1579,1081,1867,1831,1430,1383,1109,620,304,45,2660,8589,2078,23.65,76.35,18.47
W02000249,The Vale of Glamorgan 013,9235,1273,783,1248,1388,1177,1189,957,708,384,128,2056,7179,2177,22.26,77.74,23.57
W02000250,The Vale of Glamorgan 014,11915,1366,1108,2071,1476,1504,1586,1394,959,395,56,2474,9441,2804,20.76,79.24,23.53
W02000251,The Vale of Glamorgan 015,9746,1090,825,1375,1343,1215,1349,1157,898,410,84,1915,7831,2549,19.65,80.35,26.15
W02000367,Cardiff 001,5808,611,524,616,472,651,920,858,684,368,104,1135,4673,2014,19.54,80.46,34.68
W02000368,Cardiff 002,5797,656,512,882,702,721,955,698,449,206,16,1168,4629,1369,20.15,79.85,23.62
W02000369,Cardiff 003,8737,1333,844,1499,1385,1221,1140,744,432,110,29,2177,6560,1315,24.92,75.08,15.05
W02000370,Cardiff 004,6584,664,542,611,663,737,964,890,799,567,147,1206,5378,2403,18.32,81.68,36.5
W02000371,Cardiff 005,9612,1292,874,1325,1428,1165,1168,972,788,449,151,2166,7446,2360,22.53,77.47,24.55
W02000372,Cardiff 006,8134,1082,833,899,971,1179,1204,836,752,328,50,1915,6219,1966,23.54,76.46,24.17
W02000373,Cardiff 007,6916,1032,780,1114,914,697,919,814,396,202,48,1812,5104,1460,26.2,73.8,21.11
W02000374,Cardiff 008,5930,722,621,640,519,803,810,756,679,315,65,1343,4587,1815,22.65,77.35,30.61
W02000375,Cardiff 009,7339,1161,883,1230,1128,951,730,606,406,184,60,2044,5295,1256,27.85,72.15,17.11
W02000376,Cardiff 010,7040,859,661,841,904,916,1056,837,578,322,66,1520,5520,1803,21.59,78.41,25.61
W02000377,Cardiff 011,7431,1047,742,1309,1091,867,971,718,408,210,68,1789,5642,1404,24.07,75.93,18.89
W02000378,Cardiff 012,7460,928,721,855,911,934,966,869,722,460,94,1649,5811,2145,22.1,77.9,28.75
W02000379,Cardiff 013,6498,1152,878,1121,964,739,698,543,287,100,16,2030,4468,946,31.24,68.76,14.56
W02000380,Cardiff 014,7213,773,717,806,775,884,1043,1069,836,271,39,1490,5723,2215,20.66,79.34,30.71
W02000381,Cardiff 015,6588,925,659,1030,903,745,810,738,409,290,79,1584,5004,1516,24.04,75.96,23.01
W02000382,Cardiff 016,6210,964,635,1034,890,591,778,589,387,274,68,1599,4611,1318,25.75,74.25,21.22
W02000383,Cardiff 017,7263,973,777,1192,939,960,830,729,615,228,20,1750,5513,1592,24.09,75.91,21.92
W02000384,Cardiff 018,5733,673,485,708,658,788,830,739,512,282,58,1158,4575,1591,20.2,79.8,27.75
W02000385,Cardiff 019,7647,826,725,1963,641,807,827,748,572,426,112,1551,6096,1858,20.28,79.72,24.3
W02000386,Cardiff 020,7941,912,630,836,847,1010,1200,1060,792,504,150,1542,6399,2506,19.42,80.58,31.56
W02000387,Cardiff 021,6136,711,451,1024,817,690,843,724,524,289,63,1162,4974,1600,18.94,81.06,26.08
W02000388,Cardiff 022,5888,642,561,747,724,647,883,795,553,278,58,1203,4685,1684,20.43,79.57,28.6
W02000389,Cardiff 023,8688,1142,900,1265,1312,1065,1161,916,603,277,47,2042,6646,1843,23.5,76.5,21.21
W02000390,Cardiff 024,6470,660,553,1321,510,708,763,739,643,443,130,1213,5257,1955,18.75,81.25,30.22
W02000391,Cardiff 025,9828,685,462,5706,886,724,569,396,193,179,28,1147,8681,796,11.67,88.33,8.1
W02000392,Cardiff 026,8875,830,736,1347,896,1130,1244,1207,931,425,129,1566,7309,2692,17.65,82.35,30.33
W02000393,Cardiff 027,6636,983,610,1073,986,704,912,629,435,257,47,1593,5043,1368,24.01,75.99,20.61
W02000394,Cardiff 028,9430,392,271,6872,721,426,269,206,146,98,29,663,8767,479,7.03,92.97,5.08
W02000395,Cardiff 029,7062,896,541,1425,1261,919,701,655,399,216,49,1437,5625,1319,20.35,79.65,18.68
W02000396,Cardiff 030,7730,713,504,3421,1241,665,490,323,250,111,12,1217,6513,696,15.74,84.26,9.0
W02000397,Cardiff 031,6438,745,619,897,838,755,992,698,563,278,53,1364,5074,1592,21.19,78.81,24.73
W02000398,Cardiff 032,12665,359,189,10243,877,406,199,149,108,83,52,548,12117,392,4.33,95.67,3.1
W02000399,Cardiff 033,10310,663,403,5043,1546,932,672,511,303,174,63,1066,9244,1051,10.34,89.66,10.19
W02000400,Cardiff 034,6665,547,410,1524,1209,902,911,563,358,184,57,957,5708,1162,14.36,85.64,17.43
W02000401,Cardiff 035,6026,766,519,822,901,859,885,611,429,187,47,1285,4741,1274,21.32,78.68,21.14
W02000402,Cardiff 036,12073,1206,1127,4584,2069,1193,903,547,273,147,24,2333,9740,991,19.32,80.68,8.21
W02000403,Cardiff 037,7492,1223,780,1404,1336,903,807,568,308,124,39,2003,5489,1039,26.74,73.26,13.87
W02000404,Cardiff 038,6165,747,438,1285,1124,736,807,547,297,168,16,1185,4980,1028,19.22,80.78,16.67
W02000405,Cardiff 039,7770,1615,1039,1314,1151,758,798,547,383,140,25,2654,5116,1095,34.16,65.84,14.09
W02000406,Cardiff 040,9204,1136,785,1649,1697,1246,1079,783,434,322,73,1921,7283,1612,20.87,79.13,17.51
W02000407,Cardiff 041,6876,1022,875,1114,869,818,843,613,485,199,38,1897,4979,1335,27.59,72.41,19.42
W02000408,Cardiff 042,7432,1058,730,1729,1379,937,719,460,226,164,30,1788,5644,880,24.06,75.94,11.84
W02000409,Cardiff 043,6154,915,602,893,779,655,890,622,481,280,37,1517,4637,1420,24.65,75.35,23.07
W02000410,Cardiff 044,8964,1378,1141,2075,1487,1052,877,487,284,153,30,2519,6445,954,28.1,71.9,10.64
W02000411,Cardiff 045,6751,968,732,1144,961,783,877,662,373,203,48,1700,5051,1286,25.18,74.82,19.05
W02000412,Cardiff 046,6908,947,722,1386,990,845,846,595,357,195,25,1669,5239,1172,24.16,75.84,16.97
W02000422,Cardiff 048,9579,717,187,3847,2436,1080,621,432,211,34,14,904,8675,691,9.44,90.56,7.21
W02000423,Cardiff 049,10807,1055,654,3431,2412,1126,845,580,352,271,81,1709,9098,1284,15.81,84.19,11.88
W02000252,Rhondda Cynon Taf 001,9285,1089,966,1392,1151,1016,1243,1172,871,335,50,2055,7230,2428,22.13,77.87,26.15
W02000253,Rhondda Cynon Taf 002,6853,805,552,1024,877,815,962,787,665,286,80,1357,5496,1818,19.8,80.2,26.53
W02000254,Rhondda Cynon Taf 003,7777,797,677,1145,902,1006,1154,891,805,321,79,1474,6303,2096,18.95,81.05,26.95
W02000255,Rhondda Cynon Taf 004,6925,822,647,938,897,798,972,808,675,319,49,1469,5456,1851,21.21,78.79,26.73
W02000256,Rhondda Cynon Taf 005,10152,1361,832,1715,1279,1155,1317,1082,924,434,53,2193,7959,2493,21.6,78.4,24.56
W02000257,Rhondda Cynon Taf 006,7410,787,673,1113,864,865,1054,852,719,407,76,1460,5950,2054,19.7,80.3,27.72
W02000258,Rhondda Cynon Taf 007,5862,674,530,898,728,619,824,699,546,281,63,1204,4658,1589,20.54,79.46,27.11
W02000259,Rhondda Cynon Taf 008,5950,744,604,918,833,662,784,643,490,236,36,1348,4602,1405,22.66,77.34,23.61
W02000260,Rhondda Cynon Taf 009,5734,657,508,792,665,661,814,727,606,252,52,1165,4569,1637,20.32,79.68,28.55
W02000261,Rhondda Cynon Taf 010,7691,786,735,1032,883,888,1132,907,874,381,73,1521,6170,2235,19.78,80.22,29.06
W02000262,Rhondda Cynon Taf 011,5293,635,453,768,657,656,693,639,511,229,52,1088,4205,1431,20.56,79.44,27.04
W02000263,Rhondda Cynon Taf 012,6492,798,634,1060,891,721,872,710,554,219,33,1432,5060,1516,22.06,77.94,23.35
W02000264,Rhondda Cynon Taf 013,5922,766,600,1001,806,614,813,624,463,213,22,1366,4556,1322,23.07,76.93,22.32
W02000265,Rhondda Cynon Taf 014,9241,998,827,1528,1126,1025,1269,1090,872,393,113,1825,7416,2468,19.75,80.25,26.71
W02000266,Rhondda Cynon Taf 015,7595,901,698,1178,993,830,1169,827,681,268,50,1599,5996,1826,21.05,78.95,24.04
W02000267,Rhondda Cynon Taf 016,6531,751,641,1069,912,703,838,672,591,301,53,1392,5139,1617,21.31,78.69,24.76
W02000268,Rhondda Cynon Taf 017,9151,988,751,1357,1309,1045,1239,1091,817,463,91,1739,7412,2462,19.0,81.0,26.9
W02000269,Rhondda Cynon Taf 018,8543,1021,784,1438,1079,960,1115,980,770,338,58,1805,6738,2146,21.13,78.87,25.12
W02000270,Rhondda Cynon Taf 019,6671,827,550,938,973,790,923,765,585,260,60,1377,5294,1670,20.64,79.36,25.03
W02000271,Rhondda Cynon Taf 020,5771,704,502,931,720,659,802,635,527,230,61,1206,4565,1453,20.9,79.1,25.18
W02000272,Rhondda Cynon Taf 021,9957,1037,874,1637,1279,1235,1341,1067,926,443,118,1911,8046,2554,19.19,80.81,25.65
W02000273,Rhondda Cynon Taf 022,10136,982,787,3402,1326,1013,967,766,628,218,47,1769,8367,1659,17.45,82.55,16.37
W02000274,Rhondda Cynon Taf 023,10278,1195,1037,1563,1345,1315,1460,1060,870,371,62,2232,8046,2363,21.72,78.28,22.99
W02000275,Rhondda Cynon Taf 024,5998,706,532,888,697,735,847,674,611,270,38,1238,4760,1593,20.64,79.36,26.56
W02000276,Rhondda Cynon Taf 025,6362,753,522,792,800,722,725,787,878,322,61,1275,5087,2048,20.04,79.96,32.19
W02000277,Rhondda Cynon Taf 026,7266,763,570,974,1004,942,1052,900,661,317,83,1333,5933,1961,18.35,81.65,26.99
W02000278,Rhondda Cynon Taf 027,9255,1016,979,1172,1152,1385,1369,1043,775,310,54,1995,7260,2182,21.56,78.44,23.58
W02000279,Rhondda Cynon Taf 028,8092,1005,735,1221,1227,907,1180,880,666,229,42,1740,6352,1817,21.5,78.5,22.45
W02000280,Rhondda Cynon Taf 029,9356,1357,835,1274,1491,1215,1226,1004,672,252,30,2192,7164,1958,23.43,76.57,20.93
W02000281,Rhondda Cynon Taf 030,7743,816,751,938,928,1105,1054,910,813,367,61,1567,6176,2151,20.24,79.76,27.78
W02000282,Rhondda Cynon Taf 031,11972,1527,1250,1404,1570,1771,1672,1259,1020,426,73,2777,9195,2778,23.2,76.8,23.2
W02000290,Caerphilly 001,8880,1006,775,1314,1178,978,1391,1028,821,342,47,1781,7099,2238,20.06,79.94,25.2
W02000291,Caerphilly 002,7322,807,703,1081,955,888,1040,793,713,290,52,1510,5812,1848,20.62,79.38,25.24
W02000292,Caerphilly 003,6072,761,572,875,761,766,842,671,512,267,45,1333,4739,1495,21.95,78.05,24.62
W02000293,Caerphilly 004,6175,785,495,1011,787,694,912,664,523,269,35,1280,4895,1491,20.73,79.27,24.15
W02000294,Caerphilly 005,5673,544,514,750,645,681,855,754,637,241,52,1058,4615,1684,18.65,81.35,29.68
W02000295,Caerphilly 006,9702,1112,962,1287,1234,1242,1406,1110,870,413,66,2074,7628,2459,21.38,78.62,25.35
W02000296,Caerphilly 007,7747,880,742,1080,928,962,1036,946,781,340,52,1622,6125,2119,20.94,79.06,27.35
W02000297,Caerphilly 008,7605,831,701,1100,992,910,1116,896,750,287,22,1532,6073,1955,20.14,79.86,25.71
W02000298,Caerphilly 009,7350,809,809,1022,835,1027,973,826,692,294,63,1618,5732,1875,22.01,77.99,25.51
W02000299,Caerphilly 010,6690,725,638,966,858,791,923,783,650,286,70,1363,5327,1789,20.37,79.63,26.74
W02000300,Caerphilly 011,8602,897,862,1159,1104,1083,1130,1072,835,372,88,1759,6843,2367,20.45,79.55,27.52
W02000301,Caerphilly 012,8102,1035,813,1143,1127,988,1134,968,597,250,47,1848,6254,1862,22.81,77.19,22.98
W02000302,Caerphilly 013,10278,1213,940,1354,1350,1283,1414,1176,980,492,76,2153,8125,2724,20.95,79.05,26.5
W02000303,Caerphilly 014,7274,832,630,1150,1007,935,1012,796,577,288,47,1462,5812,1708,20.1,79.9,23.48
W02000304,Caerphilly 015,5828,701,483,795,799,723,833,663,539,217,75,1184,4644,1494,20.32,79.68,25.63
W02000305,Caerphilly 016,6282,689,540,949,852,741,948,691,591,252,29,1229,5053,1563,19.56,80.44,24.88
W02000306,Caerphilly 017,5185,496,408,713,595,668,810,646,546,250,53,904,4281,1495,17.43,82.57,28.83
W02000307,Caerphilly 018,6804,962,692,1044,990,849,865,706,473,199,24,1654,5150,1402,24.31,75.69,20.61
W02000308,Caerphilly 019,9146,1106,892,1299,1205,1067,1323,1083,802,329,40,1998,7148,2254,21.85,78.15,24.64
W02000309,Caerphilly 020,6833,719,619,928,864,807,992,822,713,306,63,1338,5495,1904,19.58,80.42,27.86
W02000310,Caerphilly 021,5470,679,557,703,611,718,886,626,477,196,17,1236,4234,1316,22.6,77.4,24.06
W02000311,Caerphilly 022,9845,1209,971,1263,1350,1200,1257,1173,1007,380,35,2180,7665,2595,22.14,77.86,26.36
W02000312,Caerphilly 023,7520,784,771,920,941,948,1018,993,766,317,62,1555,5965,2138,20.68,79.32,28.43
W02000313,Caerphilly 024,10690,1246,1033,1448,1459,1545,1459,1114,834,468,84,2279,8411,2500,21.32,78.68,23.39
W02000314,Blaenau Gwent 001,7044,767,600,936,799,878,1014,862,766,357,65,1367,5677,2050,19.41,80.59,29.1
W02000315,Blaenau Gwent 002,5550,579,478,809,675,620,808,681,561,277,62,1057,4493,1581,19.05,80.95,28.49
W02000316,Blaenau Gwent 003,7076,777,565,924,892,849,1054,898,753,316,48,1342,5734,2015,18.97,81.03,28.48
W02000317,Blaenau Gwent 004,7838,898,637,1174,985,983,1161,858,800,293,49,1535,6303,2000,19.58,80.42,25.52
W02000318,Blaenau Gwent 005,9488,1117,874,1345,1191,1090,1499,1036,897,379,60,1991,7497,2372,20.98,79.02,25.0
W02000319,Blaenau Gwent 006,8353,891,685,1255,1124,982,1232,974,797,340,73,1576,6777,2184,18.87,81.13,26.15
W02000320,Blaenau Gwent 007,8484,856,764,1320,1102,1114,1309,878,786,301,54,1620,6864,2019,19.09,80.91,23.8
W02000321,Blaenau Gwent 008,9003,1041,757,1350,1147,1061,1325,1073,786,376,87,1798,7205,2322,19.97,80.03,25.79
W02000322,Blaenau Gwent 009,7026,745,546,1044,962,845,1033,858,655,296,42,1291,5735,1851,18.37,81.63,26.35
W02000323,Torfaen 001,6452,798,619,999,827,764,883,673,577,262,50,1417,5035,1562,21.96,78.04,24.21
W02000324,Torfaen 002,7403,975,762,1074,936,809,1079,767,627,323,51,1737,5666,1768,23.46,76.54,23.88
W02000325,Torfaen 003,7631,1055,768,1199,1008,871,1019,829,571,272,39,1823,5808,1711,23.89,76.11,22.42
W02000326,Torfaen 004,9094,1052,742,1334,1089,1165,1345,1033,916,351,67,1794,7300,2367,19.73,80.27,26.03
W02000327,Torfaen 005,5912,563,419,659,618,685,907,823,838,324,76,982,4930,2061,16.61,83.39,34.86
W02000328,Torfaen 006,7630,828,695,1091,959,926,1091,868,716,381,75,1523,6107,2040,19.96,80.04,26.74
W02000329,Torfaen 007,7641,843,632,1204,1027,860,1140,911,590,379,55,1475,6166,1935,19.3,80.7,25.32
W02000330,Torfaen 008,7268,731,630,963,767,777,1059,860,836,528,117,1361,5907,2341,18.73,81.27,32.21
W02000331,Torfaen 009,6729,936,789,1043,1027,743,794,710,443,220,24,1725,5004,1397,25.64,74.36,20.76
W02000332,Torfaen 010,7501,979,643,1115,1064,831,947,820,671,324,107,1622,5879,1922,21.62,78.38,25.62
W02000333,Torfaen 011,6470,744,614,881,816,758,951,797,594,266,49,1358,5112,1706,20.99,79.01,26.37
W02000334,Torfaen 012,6765,667,631,910,758,865,1034,967,675,224,34,1298,5467,1900,19.19,80.81,28.09
W02000335,Torfaen 013,7465,773,563,1002,913,784,1152,1005,737,417,119,1336,6129,2278,17.9,82.1,30.52
W02000336,Monmouthshire 001,8347,723,573,868,732,898,1395,1313,1136,560,149,1296,7051,3158,15.53,84.47,37.83
W02000337,Monmouthshire 002,7666,889,712,946,844,930,1088,933,848,372,104,1601,6065,2257,20.88,79.12,29.44
W02000338,Monmouthshire 003,8566,833,670,825,820,952,1426,1238,1060,612,130,1503,7063,3040,17.55,82.45,35.49
W02000339,Monmouthshire 004,11276,1054,1357,1359,994,1278,1699,1341,1281,713,200,2411,8865,3535,21.38,78.62,31.35
W02000340,Monmouthshire 005,7315,593,610,651,592,812,1324,1211,996,419,107,1203,6112,2733,16.45,83.55,37.36
W02000341,Monmouthshire 006,8579,641,645,938,730,1035,1567,1346,1079,505,93,1286,7293,3023,14.99,85.01,35.24
W02000342,Monmouthshire 007,9693,867,889,913,783,1245,1726,1430,1250,462,128,1756,7937,3270,18.12,81.88,33.74
W02000343,Monmouthshire 008,8608,930,776,1234,1178,1086,1322,886,718,375,103,1706,6902,2082,19.82,80.18,24.19
W02000344,Monmouthshire 009,8498,779,746,840,808,1070,1492,1252,1046,383,82,1525,6973,2763,17.95,82.05,32.51
W02000345,Monmouthshire 010,8197,867,680,1053,1027,875,1148,1037,903,505,102,1547,6650,2547,18.87,81.13,31.07
W02000346,Monmouthshire 011,7845,750,776,1055,853,1098,1337,921,722,275,58,1526,6319,1976,19.45,80.55,25.19
W02000347,Newport 001,7781,834,601,741,754,978,1288,1079,942,437,127,1435,6346,2585,18.44,81.56,33.22
W02000348,Newport 002,7839,856,723,985,907,929,1119,928,896,427,69,1579,6260,2320,20.14,79.86,29.6
W02000349,Newport 003,8044,1120,697,1328,1129,905,1185,594,789,258,39,1817,6227,1680,22.59,77.41,20.89
W02000350,Newport 004,8850,1084,699,1107,1119,1087,1428,1095,830,348,53,1783,7067,2326,20.15,79.85,26.28
W02000351,Newport 005,6093,817,528,766,783,751,866,742,526,241,73,1345,4748,1582,22.07,77.93,25.96
W02000352,Newport 006,6775,948,622,1058,974,823,929,694,442,232,53,1570,5205,1421,23.17,76.83,20.97
W02000353,Newport 007,7093,876,720,1182,1055,876,881,741,493,227,42,1596,5497,1503,22.5,77.5,21.19
W02000354,Newport 008,5795,642,489,733,656,640,870,715,578,411,61,1131,4664,1765,19.52,80.48,30.46
W02000355,Newport 009,9228,1174,933,964,1174,1203,1313,1059,924,408,76,2107,7121,2467,22.83,77.17,26.73
W02000356,Newport 010,5363,824,600,806,726,480,751,467,368,293,48,1424,3939,1176,26.55,73.45,21.93
W02000357,Newport 011,7989,1146,762,1357,1175,1046,1035,746,445,232,45,1908,6081,1468,23.88,76.12,18.38
W02000358,Newport 012,6359,724,499,737,747,832,949,722,707,370,72,1223,5136,1871,19.23,80.77,29.42
W02000359,Newport 013,11855,1967,1210,2229,2329,1440,1267,789,404,185,35,3177,8678,1413,26.8,73.2,11.92
W02000360,Newport 014,6559,699,519,1204,1174,935,775,552,420,224,57,1218,5341,1253,18.57,81.43,19.1
W02000361,Newport 015,11568,1749,1292,2081,1537,1255,1433,986,777,396,62,3041,8527,2221,26.29,73.71,19.2
W02000362,Newport 016,6313,729,613,730,779,874,931,675,668,274,40,1342,4971,1657,21.26,78.74,26.25
W02000363,Newport 017,5772,653,482,703,695,691,861,671,630,294,92,1135,4637,1687,19.66,80.34,29.23
W02000364,Newport 018,8843,1335,1058,1895,1473,1053,862,573,350,187,57,2393,6450,1167,27.06,72.94,13.2
W02000365,Newport 019,8190,1317,951,1239,1280,997,937,675,490,273,31,2268,5922,1469,27.69,72.31,17.94
W02000366,Newport 020,8367,994,859,982,1075,1256,1313,918,642,260,68,1853,6514,1888,22.15,77.85,22.56
W02000097,Powys 001,9144,840,746,968,802,1028,1453,1400,1242,537,128,1586,7558,3307,17.34,82.66,36.17
W02000098,Powys 002,6145,559,563,663,496,720,1021,881,756,392,94,1122,5023,2123,18.26,81.74,34.55
W02000099,Powys 003,6725,681,561,958,730,809,980,846,640,409,111,1242,5483,2006,18.47,81.53,29.83
W02000100,Powys 004,6291,542,498,698,578,715,1110,1008,723,332,87,1040,5251,2150,16.53,83.47,34.18
W02000101,Powys 005,5452,493,447,671,451,598,861,783,740,346,62,940,4512,1931,17.24,82.76,35.42
W02000102,Powys 006,6149,557,546,709,543,645,1030,942,827,288,62,1103,5046,2119,17.94,82.06,34.46
W02000103,Powys 007,5634,473,500,549,464,591,975,889,775,330,88,973,4661,2082,17.27,82.73,36.95
W02000104,Powys 008,6202,605,533,891,661,728,831,840,684,352,77,1138,5064,1953,18.35,81.65,31.49
W02000105,Powys 009,5020,770,603,817,636,564,676,467,311,142,34,1373,3647,954,27.35,72.65,19.0
W02000106,Powys 010,6502,600,577,702,529,679,1068,1025,829,426,67,1177,5325,2347,18.1,81.9,36.1
W02000107,Powys 011,9655,841,754,924,866,938,1499,1671,1418,618,126,1595,8060,3833,16.52,83.48,39.7
W02000108,Powys 012,7212,655,529,689,556,673,1106,1222,1185,471,126,1184,6028,3004,16.42,83.58,41.65
W02000109,Powys 013,5609,581,464,626,599,586,805,769,696,384,99,1045,4564,1948,18.63,81.37,34.73
W02000110,Powys 014,6691,579,595,663,618,745,1060,1116,865,366,84,1174,5517,2431,17.55,82.45,36.33
W02000111,Powys 015,8503,808,638,862,779,941,1348,1345,1152,519,111,1446,7057,3127,17.01,82.99,36.78
W02000113,Powys 017,8400,936,819,1177,940,947,995,1082,858,530,116,1755,6645,2586,20.89,79.11,30.79
W02000114,Powys 018,6963,581,595,579,478,738,1110,1234,1093,451,104,1176,5787,2882,16.89,83.11,41.39
W02000414,Powys 020,6033,581,472,536,473,724,1113,956,794,315,69,1053,4980,2134,17.45,82.55,35.37
W02000416,Powys 021,10105,977,828,1160,1011,1144,1538,1437,1201,658,151,1805,8300,3447,17.86,82.14,34.11
W02000284,Merthyr Tydfil 002,9613,1149,810,1528,1367,1156,1367,1044,810,327,55,1959,7654,2236,20.38,79.62,23.26
W02000285,Merthyr Tydfil 003,8692,956,798,1104,1176,1008,1255,1053,828,408,106,1754,6938,2395,20.18,79.82,27.55
W02000286,Merthyr Tydfil 004,7033,883,586,1071,969,775,1018,827,540,318,46,1469,5564,1731,20.89,79.11,24.61
W02000287,Merthyr Tydfil 005,8464,943,774,1259,1100,1087,1190,958,775,333,45,1717,6747,2111,20.29,79.71,24.94
W02000288,Merthyr Tydfil 006,8077,926,689,1181,983,870,1237,963,765,393,70,1615,6462,2191,20.0,80.0,27.13
W02000289,Merthyr Tydfil 007,8736,1063,735,1273,1228,951,1290,1067,782,299,48,1798,6938,2196,20.58,79.42,25.14
W02000415,Merthyr Tydfil 008,9711,1453,1092,1408,1364,1045,1233,992,747,324,53,2545,7166,2116,26.21,73.79,21.79
