Date,Scotland (NRS),NI (NISRA),Wales (ONS),England (ONS),Daily_Deaths,Total_Deaths,New_Cases,Total_Cases
2020-03-16,8,0,4,138,150,150,152,1543
2020-03-17,11,0,5,191,57,207,407,1950
2020-03-18,15,1,7,256,72,279,676,2626
2020-03-19,19,1,11,326,78,357,643,3269
2020-03-20,24,1,15,432,115,472,714,3983
2020-03-21,31,2,24,554,139,611,1035,5018
2020-03-22,37,3,28,725,182,793,665,5683
2020-03-23,44,7,35,912,205,998,967,6650
2020-03-24,56,10,46,1147,261,1259,1427,8077
2020-03-25,78,14,58,1443,334,1593,1452,9529
2020-03-26,101,18,70,1812,408,2001,2129,11658
2020-03-27,124,24,88,2223,458,2459,2890,14548
2020-03-28,161,33,109,2672,516,2975,2556,17104
2020-03-29,188,37,132,3201,583,3558,2502,19606
2020-03-30,239,43,153,3825,702,4260,2665,22271
2020-03-31,297,51,174,4562,824,5084,3250,25521
2020-04-01,362,58,198,5379,913,5997,4567,30088
2020-04-02,423,72,237,6267,1002,6999,4522,34610
2020-04-03,498,85,278,7186,1048,8047,4672,39282
2020-04-04,554,99,331,8198,1135,9182,4000,43282
2020-04-05,640,115,383,9256,1212,10394,6199,49481
2020-04-06,730,122,428,10270,1156,11550,4143,53624
2020-04-07,814,131,480,11404,1279,12829,3888,57512
2020-04-08,906,140,552,12676,1445,14274,5865,63377
2020-04-09,1014,165,613,13837,1355,15629,4675,68052
2020-04-10,1113,174,662,14990,1310,16939,5706,73758
2020-04-11,1208,189,711,16184,1353,18292,5234,78991
2020-04-12,1282,209,783,17375,1357,19649,5288,84279
2020-04-13,1361,225,839,18444,1220,20869,4342,88621
2020-04-14,1461,240,894,19519,1245,22114,5252,93873
2020-04-15,1555,261,954,20610,1266,23380,4605,98476
2020-04-16,1656,277,1008,21746,1307,24687,4618,103093
2020-04-17,1741,291,1069,22844,1258,25945,5599,108692
2020-04-18,1836,301,1122,23861,1175,27120,5526,114217
2020-04-19,1926,317,1171,24824,1118,28238,5850,120067
2020-04-20,2031,332,1218,25809,1152,29390,4676,124743
2020-04-21,2127,348,1272,26716,1073,30463,4301,129044
2020-04-22,2215,373,1320,27649,1094,31557,4451,133495
2020-04-23,2287,395,1370,28534,1029,32586,4583,138078
2020-04-24,2363,406,1412,29398,993,33579,5386,143464
2020-04-25,2442,426,1459,30159,907,34486,4913,148377
2020-04-26,2520,443,1495,30910,882,35368,4463,152840
2020-04-27,2605,465,1530,31626,858,36226,4310,157149
2020-04-28,2664,475,1560,32320,793,37019,3996,161145
2020-04-29,2733,490,1593,33014,811,37830,4076,165221
2020-04-30,2801,503,1632,33663,769,38599,6032,171253
2020-05-01,2868,525,1666,34316,776,39375,6201,177454
2020-05-02,2928,545,1700,34898,696,40071,4806,182260
2020-05-03,2989,563,1726,35451,658,40729,4339,186599
2020-05-04,3051,577,1764,36002,665,41394,3985,190584
2020-05-05,3118,584,1795,36536,639,42033,4406,194990
2020-05-06,3177,591,1832,37052,619,42652,6111,201101
2020-05-07,3238,598,1858,37578,620,43272,5614,206715
2020-05-08,3296,607,1876,38053,560,43832,4649,211364
2020-05-09,3346,616,1893,38512,535,44367,3896,215260
2020-05-10,3384,629,1912,38928,486,44853,3923,219183
2020-05-11,3429,635,1933,39281,425,45278,3877,223060
2020-05-12,3464,642,1952,39656,436,45714,3403,226463
2020-05-13,3517,648,1974,40025,450,46164,3242,229705
2020-05-14,3567,663,2001,40392,459,46623,3446,233151
2020-05-15,3601,672,2020,40747,417,47040,3560,236711
2020-05-16,3638,676,2045,41093,412,47452,3451,240161
2020-05-17,3672,686,2062,41404,372,47824,3562,243723
2020-05-18,3706,696,2081,41745,404,48228,2684,246406
2020-05-19,3737,705,2096,42051,361,48589,2412,248818
2020-05-20,3765,713,2109,42347,345,48934,2472,248293
2020-05-21,3799,719,2124,42629,337,49271,2615,250908
2020-05-22,3818,725,2143,42878,293,49564,3287,254195
2020-05-23,3833,729,2153,43128,279,49843,2959,257154
2020-05-24,3846,741,2174,43358,276,50119,2409,259559
2020-05-25,3868,744,2188,43591,272,50391,1625,261184
2020-05-26,3889,746,2204,43846,294,50685,2004,265227
2020-05-27,3911,753,2221,44071,271,50956,2013,267240
2020-05-28,3933,758,2240,44304,279,51235,1887,269127
2020-05-29,3952,763,2254,44518,252,51487,2095,271222
2020-05-30,3965,764,2271,44698,211,51698,2445,272826
2020-05-31,3976,767,2277,44868,190,51888,1936,274762
2020-06-01,3982,770,2288,45044,196,52084,1570,276332
2020-06-02,3996,777,2296,45240,225,52309,1653,277985
2020-06-03,4008,780,2305,45414,198,52507,1871,279856
2020-06-04,4012,783,2317,45577,182,52689,1805,281661
2020-06-05,4028,784,2325,45729,177,52866,1650,283311
2020-06-06,4036,788,2335,45847,140,53006,1557,284868
2020-06-07,4046,790,2347,45982,159,53165,1326,286194
2020-06-08,4054,791,2356,46120,156,53321,1205,287399
2020-06-09,4059,793,2359,46246,136,53457,1387,289140
2020-06-10,4071,796,2367,46384,161,53618,1003,290143
2020-06-11,4075,800,2372,46488,117,53735,1266,291409
2020-06-12,4079,805,2376,46604,129,53864,1541,292950
2020-06-13,4085,808,2382,46688,99,53963,1425,294375
2020-06-14,4092,810,2390,46804,133,54096,1514,295889
2020-06-15,4101,811,2395,46891,102,54198,1056,296857
2020-06-16,4109,812,2403,46992,118,54316,1279,298136
2020-06-17,4118,813,2406,47079,100,54416,1115,299251
2020-06-18,4127,814,2406,47155,86,54502,1218,300469
2020-06-19,4129,817,2413,47229,86,54588,1346,301815
2020-06-20,4136,818,2416,47299,81,54669,1295,303110
2020-06-21,4144,819,2420,47361,75,54744,1221,304331
2020-06-22,4150,820,2422,47429,77,54821,958,305289
2020-06-23,4153,821,2426,47506,85,54906,874,306210
2020-06-24,4156,824,2427,47583,84,54990,653,306862
2020-06-25,4158,825,2435,47658,86,55076,1118,307980
2020-06-26,4161,826,2438,47705,54,55130,1006,309360
